k,alpha,species,applied-region,Successes (# Pyroprints),Failures (# Pyroprints),NonDecisions (# Pyroprints),Total,Decision Accuracy(\%),Overall Accuracy(\%)
1,0.000,Chicken,16-23,22,29,0,51,43.137,43.137
1,0.000,Chicken,23-5,28,11,0,39,71.795,71.795
1,0.000,Sea Lion,16-23,1,1,0,2,50.000,50.000
1,0.000,Sea Lion,23-5,4,3,0,7,57.143,57.143
1,0.000,Hu and Cw,16-23,15,26,0,41,36.585,36.585
1,0.000,Hu and Cw,23-5,15,33,0,48,31.250,31.250
1,0.000,Sheep,16-23,78,64,0,142,54.930,54.930
1,0.000,Sheep,23-5,78,32,0,110,70.909,70.909
1,0.000,Hu and Dg,16-23,16,24,0,40,40.000,40.000
1,0.000,Hu and Dg,23-5,20,15,0,35,57.143,57.143
1,0.000,Common Loon,16-23,2,0,0,2,100.000,100.000
1,0.000,Common Loon,23-5,0,4,0,4,0.000,0.000
1,0.000,Red-Winged Blackbird,16-23,2,5,0,7,28.571,28.571
1,0.000,Red-Winged Blackbird,23-5,2,4,0,6,33.333,33.333
1,0.000,Cw,16-23,17,25,0,42,40.476,40.476
1,0.000,Cw,23-5,31,55,0,86,36.047,36.047
1,0.000,Cliff Sparrow,16-23,16,29,0,45,35.556,35.556
1,0.000,Cliff Sparrow,23-5,10,34,0,44,22.727,22.727
1,0.000,Pig,16-23,23,16,0,39,58.974,58.974
1,0.000,Pig,23-5,20,18,0,38,52.632,52.632
1,0.000,Barn Owl,16-23,0,0,0,0,NaN,NaN
1,0.000,Barn Owl,23-5,2,6,0,8,25.000,25.000
1,0.000,Wild Pig,16-23,5,8,0,13,38.462,38.462
1,0.000,Wild Pig,23-5,7,6,0,13,53.846,53.846
1,0.000,Pennington Creek Water,16-23,0,0,0,0,NaN,NaN
1,0.000,Pennington Creek Water,23-5,0,0,0,0,NaN,NaN
1,0.000,Guinni,16-23,0,0,0,0,NaN,NaN
1,0.000,Guinni,23-5,0,2,0,2,0.000,0.000
1,0.000,Racoon,16-23,2,3,0,5,40.000,40.000
1,0.000,Racoon,23-5,0,4,0,4,0.000,0.000
1,0.000,Hu,16-23,27,9,0,36,75.000,75.000
1,0.000,Hu,23-5,25,13,0,38,65.789,65.789
1,0.000,Cw and Dg,16-23,15,21,0,36,41.667,41.667
1,0.000,Cw and Dg,23-5,19,29,0,48,39.583,39.583
1,0.000,Red Wind Blackbird,16-23,0,0,0,0,NaN,NaN
1,0.000,Red Wind Blackbird,23-5,0,1,0,1,0.000,0.000
1,0.000,Tree Swallow,16-23,2,6,0,8,25.000,25.000
1,0.000,Tree Swallow,23-5,2,1,0,3,66.667,66.667
1,0.000,Turkey Vulture,16-23,0,2,0,2,0.000,0.000
1,0.000,Turkey Vulture,23-5,0,2,0,2,0.000,0.000
1,0.000,Dg,16-23,11,16,0,27,40.741,40.741
1,0.000,Dg,23-5,27,10,0,37,72.973,72.973
1,0.000,Western Kingbird,16-23,0,3,0,3,0.000,0.000
1,0.000,Western Kingbird,23-5,0,0,0,0,NaN,NaN
1,0.000,White Crowned Sparrow,16-23,13,5,0,18,72.222,72.222
1,0.000,White Crowned Sparrow,23-5,8,16,0,24,33.333,33.333
1,0.000,Eared Grebe,16-23,0,0,0,0,NaN,NaN
1,0.000,Eared Grebe,23-5,2,2,0,4,50.000,50.000
1,0.000,cougar,16-23,0,1,0,1,0.000,0.000
1,0.000,cougar,23-5,0,0,0,0,NaN,NaN
1,0.000,Ocean Water,16-23,0,0,0,0,NaN,NaN
1,0.000,Ocean Water,23-5,0,0,0,0,NaN,NaN
1,0.000,Red Tailed Hawk,16-23,2,0,0,2,100.000,100.000
1,0.000,Red Tailed Hawk,23-5,0,10,0,10,0.000,0.000
1,0.000,Dog,16-23,97,72,0,169,57.396,57.396
1,0.000,Dog,23-5,156,133,0,289,53.979,53.979
1,0.000,Human,16-23,1727,366,0,2093,82.513,82.513
1,0.000,Human,23-5,2171,273,0,2444,88.830,88.830
1,0.000,Wild Turkey,16-23,18,56,0,74,24.324,24.324
1,0.000,Wild Turkey,23-5,14,66,0,80,17.500,17.500
1,0.000,Clark Grebe,16-23,0,0,0,0,NaN,NaN
1,0.000,Clark Grebe,23-5,2,4,0,6,33.333,33.333
1,0.000,Seagull,16-23,0,0,0,0,NaN,NaN
1,0.000,Seagull,23-5,33,9,0,42,78.571,78.571
1,0.000,Surf Scoter,16-23,0,0,0,0,NaN,NaN
1,0.000,Surf Scoter,23-5,2,3,0,5,40.000,40.000
1,0.000,Pigeon,16-23,132,198,0,330,40.000,40.000
1,0.000,Pigeon,23-5,150,374,0,524,28.626,28.626
1,0.000,Pacific Ocean Water,16-23,0,0,0,0,NaN,NaN
1,0.000,Pacific Ocean Water,23-5,0,0,0,0,NaN,NaN
1,0.000,Cat,16-23,41,28,0,69,59.420,59.420
1,0.000,Cat,23-5,39,37,0,76,51.316,51.316
1,0.000,Horse,16-23,21,42,0,63,33.333,33.333
1,0.000,Horse,23-5,51,238,0,289,17.647,17.647
1,0.000,orangutan,16-23,0,0,0,0,NaN,NaN
1,0.000,orangutan,23-5,0,4,0,4,0.000,0.000
1,0.000,Bat,16-23,36,7,0,43,83.721,83.721
1,0.000,Bat,23-5,37,23,0,60,61.667,61.667
1,0.000,Deer,16-23,17,13,0,30,56.667,56.667
1,0.000,Deer,23-5,18,46,0,64,28.125,28.125
1,0.000,Great Horned Owl,16-23,0,2,0,2,0.000,0.000
1,0.000,Great Horned Owl,23-5,1,9,0,10,10.000,10.000
1,0.000,Freshwater Lagoon,16-23,0,0,0,0,NaN,NaN
1,0.000,Freshwater Lagoon,23-5,0,0,0,0,NaN,NaN
1,0.000,Unknown Avian,16-23,0,2,0,2,0.000,0.000
1,0.000,Unknown Avian,23-5,0,2,0,2,0.000,0.000
1,0.000,Human UTI,16-23,115,88,0,203,56.650,56.650
1,0.000,Human UTI,23-5,129,82,0,211,61.137,61.137
1,0.000,unknown,16-23,6,8,0,14,42.857,42.857
1,0.000,unknown,23-5,8,13,0,21,38.095,38.095
1,0.000,SLO Creek Water,16-23,0,0,0,0,NaN,NaN
1,0.000,SLO Creek Water,23-5,6,1,0,7,85.714,85.714
1,0.000,Pig/Swine,16-23,14,12,0,26,53.846,53.846
1,0.000,Pig/Swine,23-5,12,9,0,21,57.143,57.143
1,0.000,Klebsiella,16-23,0,0,0,0,NaN,NaN
1,0.000,Klebsiella,23-5,0,0,0,0,NaN,NaN
1,0.000,Hu Cw and Dg,16-23,12,17,0,29,41.379,41.379
1,0.000,Hu Cw and Dg,23-5,21,20,0,41,51.220,51.220
1,0.000,Ground Squirrel,16-23,114,78,0,192,59.375,59.375
1,0.000,Ground Squirrel,23-5,116,84,0,200,58.000,58.000
1,0.000,Opossum,16-23,4,1,0,5,80.000,80.000
1,0.000,Opossum,23-5,5,8,0,13,38.462,38.462
1,0.000,Cow,16-23,1573,864,0,2437,64.547,64.547
1,0.000,Cow,23-5,1545,1045,0,2590,59.653,59.653
1,0.000,Deer Mouse,16-23,0,5,0,5,0.000,0.000
1,0.000,Deer Mouse,23-5,0,0,0,0,NaN,NaN
1,0.000,OVERALL,16-23,4196,2152,0,6348,66.100,66.100
1,0.000,OVERALL,23-5,4816,2794,0,7610,63.285,63.285
1,0.500,Chicken,16-23,22,29,0,51,43.137,43.137
1,0.500,Chicken,23-5,28,11,0,39,71.795,71.795
1,0.500,Sea Lion,16-23,1,1,0,2,50.000,50.000
1,0.500,Sea Lion,23-5,4,3,0,7,57.143,57.143
1,0.500,Hu and Cw,16-23,15,26,0,41,36.585,36.585
1,0.500,Hu and Cw,23-5,15,33,0,48,31.250,31.250
1,0.500,Sheep,16-23,78,64,0,142,54.930,54.930
1,0.500,Sheep,23-5,78,32,0,110,70.909,70.909
1,0.500,Hu and Dg,16-23,16,24,0,40,40.000,40.000
1,0.500,Hu and Dg,23-5,20,15,0,35,57.143,57.143
1,0.500,Common Loon,16-23,2,0,0,2,100.000,100.000
1,0.500,Common Loon,23-5,0,4,0,4,0.000,0.000
1,0.500,Red-Winged Blackbird,16-23,2,5,0,7,28.571,28.571
1,0.500,Red-Winged Blackbird,23-5,2,4,0,6,33.333,33.333
1,0.500,Cw,16-23,17,25,0,42,40.476,40.476
1,0.500,Cw,23-5,31,55,0,86,36.047,36.047
1,0.500,Cliff Sparrow,16-23,16,29,0,45,35.556,35.556
1,0.500,Cliff Sparrow,23-5,10,34,0,44,22.727,22.727
1,0.500,Pig,16-23,23,16,0,39,58.974,58.974
1,0.500,Pig,23-5,20,18,0,38,52.632,52.632
1,0.500,Barn Owl,16-23,0,0,0,0,NaN,NaN
1,0.500,Barn Owl,23-5,2,6,0,8,25.000,25.000
1,0.500,Wild Pig,16-23,5,8,0,13,38.462,38.462
1,0.500,Wild Pig,23-5,7,6,0,13,53.846,53.846
1,0.500,Pennington Creek Water,16-23,0,0,0,0,NaN,NaN
1,0.500,Pennington Creek Water,23-5,0,0,0,0,NaN,NaN
1,0.500,Guinni,16-23,0,0,0,0,NaN,NaN
1,0.500,Guinni,23-5,0,2,0,2,0.000,0.000
1,0.500,Racoon,16-23,2,3,0,5,40.000,40.000
1,0.500,Racoon,23-5,0,4,0,4,0.000,0.000
1,0.500,Hu,16-23,27,9,0,36,75.000,75.000
1,0.500,Hu,23-5,25,13,0,38,65.789,65.789
1,0.500,Cw and Dg,16-23,15,21,0,36,41.667,41.667
1,0.500,Cw and Dg,23-5,19,29,0,48,39.583,39.583
1,0.500,Red Wind Blackbird,16-23,0,0,0,0,NaN,NaN
1,0.500,Red Wind Blackbird,23-5,0,1,0,1,0.000,0.000
1,0.500,Tree Swallow,16-23,2,6,0,8,25.000,25.000
1,0.500,Tree Swallow,23-5,2,1,0,3,66.667,66.667
1,0.500,Turkey Vulture,16-23,0,2,0,2,0.000,0.000
1,0.500,Turkey Vulture,23-5,0,2,0,2,0.000,0.000
1,0.500,Dg,16-23,11,16,0,27,40.741,40.741
1,0.500,Dg,23-5,27,10,0,37,72.973,72.973
1,0.500,Western Kingbird,16-23,0,3,0,3,0.000,0.000
1,0.500,Western Kingbird,23-5,0,0,0,0,NaN,NaN
1,0.500,White Crowned Sparrow,16-23,13,5,0,18,72.222,72.222
1,0.500,White Crowned Sparrow,23-5,8,16,0,24,33.333,33.333
1,0.500,Eared Grebe,16-23,0,0,0,0,NaN,NaN
1,0.500,Eared Grebe,23-5,2,2,0,4,50.000,50.000
1,0.500,cougar,16-23,0,1,0,1,0.000,0.000
1,0.500,cougar,23-5,0,0,0,0,NaN,NaN
1,0.500,Ocean Water,16-23,0,0,0,0,NaN,NaN
1,0.500,Ocean Water,23-5,0,0,0,0,NaN,NaN
1,0.500,Red Tailed Hawk,16-23,2,0,0,2,100.000,100.000
1,0.500,Red Tailed Hawk,23-5,0,10,0,10,0.000,0.000
1,0.500,Dog,16-23,97,72,0,169,57.396,57.396
1,0.500,Dog,23-5,156,133,0,289,53.979,53.979
1,0.500,Human,16-23,1727,366,0,2093,82.513,82.513
1,0.500,Human,23-5,2171,273,0,2444,88.830,88.830
1,0.500,Wild Turkey,16-23,18,56,0,74,24.324,24.324
1,0.500,Wild Turkey,23-5,14,66,0,80,17.500,17.500
1,0.500,Clark Grebe,16-23,0,0,0,0,NaN,NaN
1,0.500,Clark Grebe,23-5,2,4,0,6,33.333,33.333
1,0.500,Seagull,16-23,0,0,0,0,NaN,NaN
1,0.500,Seagull,23-5,33,9,0,42,78.571,78.571
1,0.500,Surf Scoter,16-23,0,0,0,0,NaN,NaN
1,0.500,Surf Scoter,23-5,2,3,0,5,40.000,40.000
1,0.500,Pigeon,16-23,132,198,0,330,40.000,40.000
1,0.500,Pigeon,23-5,150,374,0,524,28.626,28.626
1,0.500,Pacific Ocean Water,16-23,0,0,0,0,NaN,NaN
1,0.500,Pacific Ocean Water,23-5,0,0,0,0,NaN,NaN
1,0.500,Cat,16-23,41,28,0,69,59.420,59.420
1,0.500,Cat,23-5,39,37,0,76,51.316,51.316
1,0.500,Horse,16-23,21,42,0,63,33.333,33.333
1,0.500,Horse,23-5,51,238,0,289,17.647,17.647
1,0.500,orangutan,16-23,0,0,0,0,NaN,NaN
1,0.500,orangutan,23-5,0,4,0,4,0.000,0.000
1,0.500,Bat,16-23,36,7,0,43,83.721,83.721
1,0.500,Bat,23-5,37,23,0,60,61.667,61.667
1,0.500,Deer,16-23,17,13,0,30,56.667,56.667
1,0.500,Deer,23-5,18,46,0,64,28.125,28.125
1,0.500,Great Horned Owl,16-23,0,2,0,2,0.000,0.000
1,0.500,Great Horned Owl,23-5,1,9,0,10,10.000,10.000
1,0.500,Freshwater Lagoon,16-23,0,0,0,0,NaN,NaN
1,0.500,Freshwater Lagoon,23-5,0,0,0,0,NaN,NaN
1,0.500,Unknown Avian,16-23,0,2,0,2,0.000,0.000
1,0.500,Unknown Avian,23-5,0,2,0,2,0.000,0.000
1,0.500,Human UTI,16-23,115,88,0,203,56.650,56.650
1,0.500,Human UTI,23-5,129,82,0,211,61.137,61.137
1,0.500,unknown,16-23,6,8,0,14,42.857,42.857
1,0.500,unknown,23-5,8,13,0,21,38.095,38.095
1,0.500,SLO Creek Water,16-23,0,0,0,0,NaN,NaN
1,0.500,SLO Creek Water,23-5,6,1,0,7,85.714,85.714
1,0.500,Pig/Swine,16-23,14,12,0,26,53.846,53.846
1,0.500,Pig/Swine,23-5,12,9,0,21,57.143,57.143
1,0.500,Klebsiella,16-23,0,0,0,0,NaN,NaN
1,0.500,Klebsiella,23-5,0,0,0,0,NaN,NaN
1,0.500,Hu Cw and Dg,16-23,12,17,0,29,41.379,41.379
1,0.500,Hu Cw and Dg,23-5,21,20,0,41,51.220,51.220
1,0.500,Ground Squirrel,16-23,114,78,0,192,59.375,59.375
1,0.500,Ground Squirrel,23-5,116,84,0,200,58.000,58.000
1,0.500,Opossum,16-23,4,1,0,5,80.000,80.000
1,0.500,Opossum,23-5,5,8,0,13,38.462,38.462
1,0.500,Cow,16-23,1573,864,0,2437,64.547,64.547
1,0.500,Cow,23-5,1545,1045,0,2590,59.653,59.653
1,0.500,Deer Mouse,16-23,0,5,0,5,0.000,0.000
1,0.500,Deer Mouse,23-5,0,0,0,0,NaN,NaN
1,0.500,OVERALL,16-23,4196,2152,0,6348,66.100,66.100
1,0.500,OVERALL,23-5,4816,2794,0,7610,63.285,63.285
1,0.900,Chicken,16-23,22,29,0,51,43.137,43.137
1,0.900,Chicken,23-5,28,11,0,39,71.795,71.795
1,0.900,Sea Lion,16-23,1,1,0,2,50.000,50.000
1,0.900,Sea Lion,23-5,4,3,0,7,57.143,57.143
1,0.900,Hu and Cw,16-23,15,26,0,41,36.585,36.585
1,0.900,Hu and Cw,23-5,15,33,0,48,31.250,31.250
1,0.900,Sheep,16-23,78,64,0,142,54.930,54.930
1,0.900,Sheep,23-5,78,32,0,110,70.909,70.909
1,0.900,Hu and Dg,16-23,16,24,0,40,40.000,40.000
1,0.900,Hu and Dg,23-5,20,15,0,35,57.143,57.143
1,0.900,Common Loon,16-23,2,0,0,2,100.000,100.000
1,0.900,Common Loon,23-5,0,4,0,4,0.000,0.000
1,0.900,Red-Winged Blackbird,16-23,2,5,0,7,28.571,28.571
1,0.900,Red-Winged Blackbird,23-5,2,4,0,6,33.333,33.333
1,0.900,Cw,16-23,17,25,0,42,40.476,40.476
1,0.900,Cw,23-5,31,55,0,86,36.047,36.047
1,0.900,Cliff Sparrow,16-23,16,29,0,45,35.556,35.556
1,0.900,Cliff Sparrow,23-5,10,34,0,44,22.727,22.727
1,0.900,Pig,16-23,23,16,0,39,58.974,58.974
1,0.900,Pig,23-5,20,18,0,38,52.632,52.632
1,0.900,Barn Owl,16-23,0,0,0,0,NaN,NaN
1,0.900,Barn Owl,23-5,2,6,0,8,25.000,25.000
1,0.900,Wild Pig,16-23,5,8,0,13,38.462,38.462
1,0.900,Wild Pig,23-5,7,6,0,13,53.846,53.846
1,0.900,Pennington Creek Water,16-23,0,0,0,0,NaN,NaN
1,0.900,Pennington Creek Water,23-5,0,0,0,0,NaN,NaN
1,0.900,Guinni,16-23,0,0,0,0,NaN,NaN
1,0.900,Guinni,23-5,0,2,0,2,0.000,0.000
1,0.900,Racoon,16-23,2,3,0,5,40.000,40.000
1,0.900,Racoon,23-5,0,4,0,4,0.000,0.000
1,0.900,Hu,16-23,27,9,0,36,75.000,75.000
1,0.900,Hu,23-5,25,13,0,38,65.789,65.789
1,0.900,Cw and Dg,16-23,15,21,0,36,41.667,41.667
1,0.900,Cw and Dg,23-5,19,29,0,48,39.583,39.583
1,0.900,Red Wind Blackbird,16-23,0,0,0,0,NaN,NaN
1,0.900,Red Wind Blackbird,23-5,0,1,0,1,0.000,0.000
1,0.900,Tree Swallow,16-23,2,6,0,8,25.000,25.000
1,0.900,Tree Swallow,23-5,2,1,0,3,66.667,66.667
1,0.900,Turkey Vulture,16-23,0,2,0,2,0.000,0.000
1,0.900,Turkey Vulture,23-5,0,2,0,2,0.000,0.000
1,0.900,Dg,16-23,11,16,0,27,40.741,40.741
1,0.900,Dg,23-5,27,10,0,37,72.973,72.973
1,0.900,Western Kingbird,16-23,0,3,0,3,0.000,0.000
1,0.900,Western Kingbird,23-5,0,0,0,0,NaN,NaN
1,0.900,White Crowned Sparrow,16-23,13,5,0,18,72.222,72.222
1,0.900,White Crowned Sparrow,23-5,8,16,0,24,33.333,33.333
1,0.900,Eared Grebe,16-23,0,0,0,0,NaN,NaN
1,0.900,Eared Grebe,23-5,2,2,0,4,50.000,50.000
1,0.900,cougar,16-23,0,1,0,1,0.000,0.000
1,0.900,cougar,23-5,0,0,0,0,NaN,NaN
1,0.900,Ocean Water,16-23,0,0,0,0,NaN,NaN
1,0.900,Ocean Water,23-5,0,0,0,0,NaN,NaN
1,0.900,Red Tailed Hawk,16-23,2,0,0,2,100.000,100.000
1,0.900,Red Tailed Hawk,23-5,0,10,0,10,0.000,0.000
1,0.900,Dog,16-23,97,72,0,169,57.396,57.396
1,0.900,Dog,23-5,156,131,0,287,54.355,54.355
1,0.900,Human,16-23,1727,364,0,2091,82.592,82.592
1,0.900,Human,23-5,2171,271,0,2442,88.903,88.903
1,0.900,Wild Turkey,16-23,18,56,0,74,24.324,24.324
1,0.900,Wild Turkey,23-5,14,66,0,80,17.500,17.500
1,0.900,Clark Grebe,16-23,0,0,0,0,NaN,NaN
1,0.900,Clark Grebe,23-5,2,3,0,5,40.000,40.000
1,0.900,Seagull,16-23,0,0,0,0,NaN,NaN
1,0.900,Seagull,23-5,33,9,0,42,78.571,78.571
1,0.900,Surf Scoter,16-23,0,0,0,0,NaN,NaN
1,0.900,Surf Scoter,23-5,2,3,0,5,40.000,40.000
1,0.900,Pigeon,16-23,132,198,0,330,40.000,40.000
1,0.900,Pigeon,23-5,150,374,0,524,28.626,28.626
1,0.900,Pacific Ocean Water,16-23,0,0,0,0,NaN,NaN
1,0.900,Pacific Ocean Water,23-5,0,0,0,0,NaN,NaN
1,0.900,Cat,16-23,41,28,0,69,59.420,59.420
1,0.900,Cat,23-5,39,37,0,76,51.316,51.316
1,0.900,Horse,16-23,21,42,0,63,33.333,33.333
1,0.900,Horse,23-5,51,238,0,289,17.647,17.647
1,0.900,orangutan,16-23,0,0,0,0,NaN,NaN
1,0.900,orangutan,23-5,0,4,0,4,0.000,0.000
1,0.900,Bat,16-23,36,7,0,43,83.721,83.721
1,0.900,Bat,23-5,37,23,0,60,61.667,61.667
1,0.900,Deer,16-23,17,13,0,30,56.667,56.667
1,0.900,Deer,23-5,18,46,0,64,28.125,28.125
1,0.900,Great Horned Owl,16-23,0,2,0,2,0.000,0.000
1,0.900,Great Horned Owl,23-5,1,9,0,10,10.000,10.000
1,0.900,Freshwater Lagoon,16-23,0,0,0,0,NaN,NaN
1,0.900,Freshwater Lagoon,23-5,0,0,0,0,NaN,NaN
1,0.900,Unknown Avian,16-23,0,2,0,2,0.000,0.000
1,0.900,Unknown Avian,23-5,0,2,0,2,0.000,0.000
1,0.900,Human UTI,16-23,115,88,0,203,56.650,56.650
1,0.900,Human UTI,23-5,129,82,0,211,61.137,61.137
1,0.900,unknown,16-23,6,8,0,14,42.857,42.857
1,0.900,unknown,23-5,8,13,0,21,38.095,38.095
1,0.900,SLO Creek Water,16-23,0,0,0,0,NaN,NaN
1,0.900,SLO Creek Water,23-5,6,1,0,7,85.714,85.714
1,0.900,Pig/Swine,16-23,14,12,0,26,53.846,53.846
1,0.900,Pig/Swine,23-5,12,9,0,21,57.143,57.143
1,0.900,Klebsiella,16-23,0,0,0,0,NaN,NaN
1,0.900,Klebsiella,23-5,0,0,0,0,NaN,NaN
1,0.900,Hu Cw and Dg,16-23,12,17,0,29,41.379,41.379
1,0.900,Hu Cw and Dg,23-5,21,20,0,41,51.220,51.220
1,0.900,Ground Squirrel,16-23,114,78,0,192,59.375,59.375
1,0.900,Ground Squirrel,23-5,116,84,0,200,58.000,58.000
1,0.900,Opossum,16-23,4,1,0,5,80.000,80.000
1,0.900,Opossum,23-5,5,8,0,13,38.462,38.462
1,0.900,Cow,16-23,1573,862,0,2435,64.600,64.600
1,0.900,Cow,23-5,1545,1042,0,2587,59.722,59.722
1,0.900,Deer Mouse,16-23,0,5,0,5,0.000,0.000
1,0.900,Deer Mouse,23-5,0,0,0,0,NaN,NaN
1,0.900,OVERALL,16-23,4196,2148,0,6344,66.141,66.141
1,0.900,OVERALL,23-5,4816,2786,0,7602,63.352,63.352
1,0.950,Chicken,16-23,22,29,0,51,43.137,43.137
1,0.950,Chicken,23-5,28,11,0,39,71.795,71.795
1,0.950,Sea Lion,16-23,1,1,0,2,50.000,50.000
1,0.950,Sea Lion,23-5,4,3,0,7,57.143,57.143
1,0.950,Hu and Cw,16-23,15,26,0,41,36.585,36.585
1,0.950,Hu and Cw,23-5,15,33,0,48,31.250,31.250
1,0.950,Sheep,16-23,78,64,0,142,54.930,54.930
1,0.950,Sheep,23-5,78,32,0,110,70.909,70.909
1,0.950,Hu and Dg,16-23,16,24,0,40,40.000,40.000
1,0.950,Hu and Dg,23-5,20,15,0,35,57.143,57.143
1,0.950,Common Loon,16-23,2,0,0,2,100.000,100.000
1,0.950,Common Loon,23-5,0,4,0,4,0.000,0.000
1,0.950,Red-Winged Blackbird,16-23,2,5,0,7,28.571,28.571
1,0.950,Red-Winged Blackbird,23-5,2,4,0,6,33.333,33.333
1,0.950,Cw,16-23,17,25,0,42,40.476,40.476
1,0.950,Cw,23-5,31,55,0,86,36.047,36.047
1,0.950,Cliff Sparrow,16-23,16,29,0,45,35.556,35.556
1,0.950,Cliff Sparrow,23-5,10,34,0,44,22.727,22.727
1,0.950,Pig,16-23,23,16,0,39,58.974,58.974
1,0.950,Pig,23-5,20,18,0,38,52.632,52.632
1,0.950,Barn Owl,16-23,0,0,0,0,NaN,NaN
1,0.950,Barn Owl,23-5,2,6,0,8,25.000,25.000
1,0.950,Wild Pig,16-23,5,8,0,13,38.462,38.462
1,0.950,Wild Pig,23-5,7,5,0,12,58.333,58.333
1,0.950,Pennington Creek Water,16-23,0,0,0,0,NaN,NaN
1,0.950,Pennington Creek Water,23-5,0,0,0,0,NaN,NaN
1,0.950,Guinni,16-23,0,0,0,0,NaN,NaN
1,0.950,Guinni,23-5,0,2,0,2,0.000,0.000
1,0.950,Racoon,16-23,2,3,0,5,40.000,40.000
1,0.950,Racoon,23-5,0,4,0,4,0.000,0.000
1,0.950,Hu,16-23,27,9,0,36,75.000,75.000
1,0.950,Hu,23-5,25,13,0,38,65.789,65.789
1,0.950,Cw and Dg,16-23,15,21,0,36,41.667,41.667
1,0.950,Cw and Dg,23-5,18,29,0,47,38.298,38.298
1,0.950,Red Wind Blackbird,16-23,0,0,0,0,NaN,NaN
1,0.950,Red Wind Blackbird,23-5,0,1,0,1,0.000,0.000
1,0.950,Tree Swallow,16-23,2,6,0,8,25.000,25.000
1,0.950,Tree Swallow,23-5,2,1,0,3,66.667,66.667
1,0.950,Turkey Vulture,16-23,0,2,0,2,0.000,0.000
1,0.950,Turkey Vulture,23-5,0,2,0,2,0.000,0.000
1,0.950,Dg,16-23,11,16,0,27,40.741,40.741
1,0.950,Dg,23-5,27,10,0,37,72.973,72.973
1,0.950,Western Kingbird,16-23,0,3,0,3,0.000,0.000
1,0.950,Western Kingbird,23-5,0,0,0,0,NaN,NaN
1,0.950,White Crowned Sparrow,16-23,13,5,0,18,72.222,72.222
1,0.950,White Crowned Sparrow,23-5,8,16,0,24,33.333,33.333
1,0.950,Eared Grebe,16-23,0,0,0,0,NaN,NaN
1,0.950,Eared Grebe,23-5,2,2,0,4,50.000,50.000
1,0.950,cougar,16-23,0,1,0,1,0.000,0.000
1,0.950,cougar,23-5,0,0,0,0,NaN,NaN
1,0.950,Ocean Water,16-23,0,0,0,0,NaN,NaN
1,0.950,Ocean Water,23-5,0,0,0,0,NaN,NaN
1,0.950,Red Tailed Hawk,16-23,2,0,0,2,100.000,100.000
1,0.950,Red Tailed Hawk,23-5,0,10,0,10,0.000,0.000
1,0.950,Dog,16-23,97,72,0,169,57.396,57.396
1,0.950,Dog,23-5,156,131,0,287,54.355,54.355
1,0.950,Human,16-23,1727,362,0,2089,82.671,82.671
1,0.950,Human,23-5,2171,268,0,2439,89.012,89.012
1,0.950,Wild Turkey,16-23,18,56,0,74,24.324,24.324
1,0.950,Wild Turkey,23-5,14,66,0,80,17.500,17.500
1,0.950,Clark Grebe,16-23,0,0,0,0,NaN,NaN
1,0.950,Clark Grebe,23-5,2,3,0,5,40.000,40.000
1,0.950,Seagull,16-23,0,0,0,0,NaN,NaN
1,0.950,Seagull,23-5,33,8,0,41,80.488,80.488
1,0.950,Surf Scoter,16-23,0,0,0,0,NaN,NaN
1,0.950,Surf Scoter,23-5,2,0,0,2,100.000,100.000
1,0.950,Pigeon,16-23,132,198,0,330,40.000,40.000
1,0.950,Pigeon,23-5,150,374,0,524,28.626,28.626
1,0.950,Pacific Ocean Water,16-23,0,0,0,0,NaN,NaN
1,0.950,Pacific Ocean Water,23-5,0,0,0,0,NaN,NaN
1,0.950,Cat,16-23,41,28,0,69,59.420,59.420
1,0.950,Cat,23-5,39,37,0,76,51.316,51.316
1,0.950,Horse,16-23,21,42,0,63,33.333,33.333
1,0.950,Horse,23-5,51,238,0,289,17.647,17.647
1,0.950,orangutan,16-23,0,0,0,0,NaN,NaN
1,0.950,orangutan,23-5,0,4,0,4,0.000,0.000
1,0.950,Bat,16-23,36,7,0,43,83.721,83.721
1,0.950,Bat,23-5,37,20,0,57,64.912,64.912
1,0.950,Deer,16-23,17,13,0,30,56.667,56.667
1,0.950,Deer,23-5,18,46,0,64,28.125,28.125
1,0.950,Great Horned Owl,16-23,0,2,0,2,0.000,0.000
1,0.950,Great Horned Owl,23-5,1,9,0,10,10.000,10.000
1,0.950,Freshwater Lagoon,16-23,0,0,0,0,NaN,NaN
1,0.950,Freshwater Lagoon,23-5,0,0,0,0,NaN,NaN
1,0.950,Unknown Avian,16-23,0,2,0,2,0.000,0.000
1,0.950,Unknown Avian,23-5,0,2,0,2,0.000,0.000
1,0.950,Human UTI,16-23,115,88,0,203,56.650,56.650
1,0.950,Human UTI,23-5,128,82,0,210,60.952,60.952
1,0.950,unknown,16-23,6,8,0,14,42.857,42.857
1,0.950,unknown,23-5,8,13,0,21,38.095,38.095
1,0.950,SLO Creek Water,16-23,0,0,0,0,NaN,NaN
1,0.950,SLO Creek Water,23-5,6,1,0,7,85.714,85.714
1,0.950,Pig/Swine,16-23,14,12,0,26,53.846,53.846
1,0.950,Pig/Swine,23-5,12,8,0,20,60.000,60.000
1,0.950,Klebsiella,16-23,0,0,0,0,NaN,NaN
1,0.950,Klebsiella,23-5,0,0,0,0,NaN,NaN
1,0.950,Hu Cw and Dg,16-23,12,17,0,29,41.379,41.379
1,0.950,Hu Cw and Dg,23-5,21,20,0,41,51.220,51.220
1,0.950,Ground Squirrel,16-23,114,78,0,192,59.375,59.375
1,0.950,Ground Squirrel,23-5,116,84,0,200,58.000,58.000
1,0.950,Opossum,16-23,4,1,0,5,80.000,80.000
1,0.950,Opossum,23-5,5,8,0,13,38.462,38.462
1,0.950,Cow,16-23,1573,847,0,2420,65.000,65.000
1,0.950,Cow,23-5,1545,1042,0,2587,59.722,59.722
1,0.950,Deer Mouse,16-23,0,5,0,5,0.000,0.000
1,0.950,Deer Mouse,23-5,0,0,0,0,NaN,NaN
1,0.950,OVERALL,16-23,4196,2131,0,6327,66.319,66.319
1,0.950,OVERALL,23-5,4814,2774,0,7588,63.442,63.442
1,0.960,Chicken,16-23,22,29,0,51,43.137,43.137
1,0.960,Chicken,23-5,28,11,0,39,71.795,71.795
1,0.960,Sea Lion,16-23,1,1,0,2,50.000,50.000
1,0.960,Sea Lion,23-5,4,3,0,7,57.143,57.143
1,0.960,Hu and Cw,16-23,15,26,0,41,36.585,36.585
1,0.960,Hu and Cw,23-5,15,33,0,48,31.250,31.250
1,0.960,Sheep,16-23,78,64,0,142,54.930,54.930
1,0.960,Sheep,23-5,78,32,0,110,70.909,70.909
1,0.960,Hu and Dg,16-23,16,24,0,40,40.000,40.000
1,0.960,Hu and Dg,23-5,20,15,0,35,57.143,57.143
1,0.960,Common Loon,16-23,2,0,0,2,100.000,100.000
1,0.960,Common Loon,23-5,0,4,0,4,0.000,0.000
1,0.960,Red-Winged Blackbird,16-23,2,5,0,7,28.571,28.571
1,0.960,Red-Winged Blackbird,23-5,2,4,0,6,33.333,33.333
1,0.960,Cw,16-23,17,25,0,42,40.476,40.476
1,0.960,Cw,23-5,31,55,0,86,36.047,36.047
1,0.960,Cliff Sparrow,16-23,16,29,0,45,35.556,35.556
1,0.960,Cliff Sparrow,23-5,10,34,0,44,22.727,22.727
1,0.960,Pig,16-23,23,16,0,39,58.974,58.974
1,0.960,Pig,23-5,20,18,0,38,52.632,52.632
1,0.960,Barn Owl,16-23,0,0,0,0,NaN,NaN
1,0.960,Barn Owl,23-5,2,6,0,8,25.000,25.000
1,0.960,Wild Pig,16-23,5,8,0,13,38.462,38.462
1,0.960,Wild Pig,23-5,7,5,0,12,58.333,58.333
1,0.960,Pennington Creek Water,16-23,0,0,0,0,NaN,NaN
1,0.960,Pennington Creek Water,23-5,0,0,0,0,NaN,NaN
1,0.960,Guinni,16-23,0,0,0,0,NaN,NaN
1,0.960,Guinni,23-5,0,2,0,2,0.000,0.000
1,0.960,Racoon,16-23,2,3,0,5,40.000,40.000
1,0.960,Racoon,23-5,0,4,0,4,0.000,0.000
1,0.960,Hu,16-23,27,9,0,36,75.000,75.000
1,0.960,Hu,23-5,25,13,0,38,65.789,65.789
1,0.960,Cw and Dg,16-23,15,21,0,36,41.667,41.667
1,0.960,Cw and Dg,23-5,18,29,0,47,38.298,38.298
1,0.960,Red Wind Blackbird,16-23,0,0,0,0,NaN,NaN
1,0.960,Red Wind Blackbird,23-5,0,1,0,1,0.000,0.000
1,0.960,Tree Swallow,16-23,2,6,0,8,25.000,25.000
1,0.960,Tree Swallow,23-5,2,1,0,3,66.667,66.667
1,0.960,Turkey Vulture,16-23,0,2,0,2,0.000,0.000
1,0.960,Turkey Vulture,23-5,0,2,0,2,0.000,0.000
1,0.960,Dg,16-23,11,16,0,27,40.741,40.741
1,0.960,Dg,23-5,27,10,0,37,72.973,72.973
1,0.960,Western Kingbird,16-23,0,3,0,3,0.000,0.000
1,0.960,Western Kingbird,23-5,0,0,0,0,NaN,NaN
1,0.960,White Crowned Sparrow,16-23,13,5,0,18,72.222,72.222
1,0.960,White Crowned Sparrow,23-5,8,16,0,24,33.333,33.333
1,0.960,Eared Grebe,16-23,0,0,0,0,NaN,NaN
1,0.960,Eared Grebe,23-5,2,2,0,4,50.000,50.000
1,0.960,cougar,16-23,0,1,0,1,0.000,0.000
1,0.960,cougar,23-5,0,0,0,0,NaN,NaN
1,0.960,Ocean Water,16-23,0,0,0,0,NaN,NaN
1,0.960,Ocean Water,23-5,0,0,0,0,NaN,NaN
1,0.960,Red Tailed Hawk,16-23,2,0,0,2,100.000,100.000
1,0.960,Red Tailed Hawk,23-5,0,10,0,10,0.000,0.000
1,0.960,Dog,16-23,97,72,0,169,57.396,57.396
1,0.960,Dog,23-5,156,130,0,286,54.545,54.545
1,0.960,Human,16-23,1727,360,0,2087,82.750,82.750
1,0.960,Human,23-5,2171,262,0,2433,89.231,89.231
1,0.960,Wild Turkey,16-23,18,56,0,74,24.324,24.324
1,0.960,Wild Turkey,23-5,14,66,0,80,17.500,17.500
1,0.960,Clark Grebe,16-23,0,0,0,0,NaN,NaN
1,0.960,Clark Grebe,23-5,2,3,0,5,40.000,40.000
1,0.960,Seagull,16-23,0,0,0,0,NaN,NaN
1,0.960,Seagull,23-5,33,8,0,41,80.488,80.488
1,0.960,Surf Scoter,16-23,0,0,0,0,NaN,NaN
1,0.960,Surf Scoter,23-5,2,0,0,2,100.000,100.000
1,0.960,Pigeon,16-23,132,198,0,330,40.000,40.000
1,0.960,Pigeon,23-5,150,374,0,524,28.626,28.626
1,0.960,Pacific Ocean Water,16-23,0,0,0,0,NaN,NaN
1,0.960,Pacific Ocean Water,23-5,0,0,0,0,NaN,NaN
1,0.960,Cat,16-23,41,28,0,69,59.420,59.420
1,0.960,Cat,23-5,39,37,0,76,51.316,51.316
1,0.960,Horse,16-23,21,42,0,63,33.333,33.333
1,0.960,Horse,23-5,51,238,0,289,17.647,17.647
1,0.960,orangutan,16-23,0,0,0,0,NaN,NaN
1,0.960,orangutan,23-5,0,4,0,4,0.000,0.000
1,0.960,Bat,16-23,36,7,0,43,83.721,83.721
1,0.960,Bat,23-5,37,18,0,55,67.273,67.273
1,0.960,Deer,16-23,17,13,0,30,56.667,56.667
1,0.960,Deer,23-5,18,46,0,64,28.125,28.125
1,0.960,Great Horned Owl,16-23,0,2,0,2,0.000,0.000
1,0.960,Great Horned Owl,23-5,1,9,0,10,10.000,10.000
1,0.960,Freshwater Lagoon,16-23,0,0,0,0,NaN,NaN
1,0.960,Freshwater Lagoon,23-5,0,0,0,0,NaN,NaN
1,0.960,Unknown Avian,16-23,0,2,0,2,0.000,0.000
1,0.960,Unknown Avian,23-5,0,2,0,2,0.000,0.000
1,0.960,Human UTI,16-23,115,88,0,203,56.650,56.650
1,0.960,Human UTI,23-5,128,82,0,210,60.952,60.952
1,0.960,unknown,16-23,6,8,0,14,42.857,42.857
1,0.960,unknown,23-5,8,13,0,21,38.095,38.095
1,0.960,SLO Creek Water,16-23,0,0,0,0,NaN,NaN
1,0.960,SLO Creek Water,23-5,6,1,0,7,85.714,85.714
1,0.960,Pig/Swine,16-23,14,12,0,26,53.846,53.846
1,0.960,Pig/Swine,23-5,12,7,0,19,63.158,63.158
1,0.960,Klebsiella,16-23,0,0,0,0,NaN,NaN
1,0.960,Klebsiella,23-5,0,0,0,0,NaN,NaN
1,0.960,Hu Cw and Dg,16-23,12,17,0,29,41.379,41.379
1,0.960,Hu Cw and Dg,23-5,21,20,0,41,51.220,51.220
1,0.960,Ground Squirrel,16-23,114,78,0,192,59.375,59.375
1,0.960,Ground Squirrel,23-5,116,84,0,200,58.000,58.000
1,0.960,Opossum,16-23,4,1,0,5,80.000,80.000
1,0.960,Opossum,23-5,5,8,0,13,38.462,38.462
1,0.960,Cow,16-23,1571,840,0,2411,65.160,65.160
1,0.960,Cow,23-5,1545,1041,0,2586,59.745,59.745
1,0.960,Deer Mouse,16-23,0,5,0,5,0.000,0.000
1,0.960,Deer Mouse,23-5,0,0,0,0,NaN,NaN
1,0.960,OVERALL,16-23,4194,2122,0,6316,66.403,66.403
1,0.960,OVERALL,23-5,4814,2763,0,7577,63.534,63.534
1,0.970,Chicken,16-23,22,29,0,51,43.137,43.137
1,0.970,Chicken,23-5,28,11,0,39,71.795,71.795
1,0.970,Sea Lion,16-23,1,1,0,2,50.000,50.000
1,0.970,Sea Lion,23-5,4,3,0,7,57.143,57.143
1,0.970,Hu and Cw,16-23,15,26,0,41,36.585,36.585
1,0.970,Hu and Cw,23-5,15,33,0,48,31.250,31.250
1,0.970,Sheep,16-23,78,64,0,142,54.930,54.930
1,0.970,Sheep,23-5,78,32,0,110,70.909,70.909
1,0.970,Hu and Dg,16-23,16,24,0,40,40.000,40.000
1,0.970,Hu and Dg,23-5,20,15,0,35,57.143,57.143
1,0.970,Common Loon,16-23,2,0,0,2,100.000,100.000
1,0.970,Common Loon,23-5,0,4,0,4,0.000,0.000
1,0.970,Red-Winged Blackbird,16-23,2,5,0,7,28.571,28.571
1,0.970,Red-Winged Blackbird,23-5,2,4,0,6,33.333,33.333
1,0.970,Cw,16-23,17,25,0,42,40.476,40.476
1,0.970,Cw,23-5,31,55,0,86,36.047,36.047
1,0.970,Cliff Sparrow,16-23,16,29,0,45,35.556,35.556
1,0.970,Cliff Sparrow,23-5,10,34,0,44,22.727,22.727
1,0.970,Pig,16-23,23,16,0,39,58.974,58.974
1,0.970,Pig,23-5,20,18,0,38,52.632,52.632
1,0.970,Barn Owl,16-23,0,0,0,0,NaN,NaN
1,0.970,Barn Owl,23-5,2,6,0,8,25.000,25.000
1,0.970,Wild Pig,16-23,5,8,0,13,38.462,38.462
1,0.970,Wild Pig,23-5,7,5,0,12,58.333,58.333
1,0.970,Pennington Creek Water,16-23,0,0,0,0,NaN,NaN
1,0.970,Pennington Creek Water,23-5,0,0,0,0,NaN,NaN
1,0.970,Guinni,16-23,0,0,0,0,NaN,NaN
1,0.970,Guinni,23-5,0,2,0,2,0.000,0.000
1,0.970,Racoon,16-23,2,3,0,5,40.000,40.000
1,0.970,Racoon,23-5,0,4,0,4,0.000,0.000
1,0.970,Hu,16-23,27,9,0,36,75.000,75.000
1,0.970,Hu,23-5,25,13,0,38,65.789,65.789
1,0.970,Cw and Dg,16-23,15,21,0,36,41.667,41.667
1,0.970,Cw and Dg,23-5,18,29,0,47,38.298,38.298
1,0.970,Red Wind Blackbird,16-23,0,0,0,0,NaN,NaN
1,0.970,Red Wind Blackbird,23-5,0,1,0,1,0.000,0.000
1,0.970,Tree Swallow,16-23,2,6,0,8,25.000,25.000
1,0.970,Tree Swallow,23-5,2,1,0,3,66.667,66.667
1,0.970,Turkey Vulture,16-23,0,2,0,2,0.000,0.000
1,0.970,Turkey Vulture,23-5,0,2,0,2,0.000,0.000
1,0.970,Dg,16-23,11,16,0,27,40.741,40.741
1,0.970,Dg,23-5,27,10,0,37,72.973,72.973
1,0.970,Western Kingbird,16-23,0,3,0,3,0.000,0.000
1,0.970,Western Kingbird,23-5,0,0,0,0,NaN,NaN
1,0.970,White Crowned Sparrow,16-23,13,5,0,18,72.222,72.222
1,0.970,White Crowned Sparrow,23-5,8,16,0,24,33.333,33.333
1,0.970,Eared Grebe,16-23,0,0,0,0,NaN,NaN
1,0.970,Eared Grebe,23-5,2,2,0,4,50.000,50.000
1,0.970,cougar,16-23,0,1,0,1,0.000,0.000
1,0.970,cougar,23-5,0,0,0,0,NaN,NaN
1,0.970,Ocean Water,16-23,0,0,0,0,NaN,NaN
1,0.970,Ocean Water,23-5,0,0,0,0,NaN,NaN
1,0.970,Red Tailed Hawk,16-23,2,0,0,2,100.000,100.000
1,0.970,Red Tailed Hawk,23-5,0,10,0,10,0.000,0.000
1,0.970,Dog,16-23,97,72,0,169,57.396,57.396
1,0.970,Dog,23-5,156,129,0,285,54.737,54.737
1,0.970,Human,16-23,1727,358,0,2085,82.830,82.830
1,0.970,Human,23-5,2168,260,0,2428,89.292,89.292
1,0.970,Wild Turkey,16-23,18,56,0,74,24.324,24.324
1,0.970,Wild Turkey,23-5,14,66,0,80,17.500,17.500
1,0.970,Clark Grebe,16-23,0,0,0,0,NaN,NaN
1,0.970,Clark Grebe,23-5,2,3,0,5,40.000,40.000
1,0.970,Seagull,16-23,0,0,0,0,NaN,NaN
1,0.970,Seagull,23-5,33,8,0,41,80.488,80.488
1,0.970,Surf Scoter,16-23,0,0,0,0,NaN,NaN
1,0.970,Surf Scoter,23-5,2,0,0,2,100.000,100.000
1,0.970,Pigeon,16-23,131,198,0,329,39.818,39.818
1,0.970,Pigeon,23-5,150,374,0,524,28.626,28.626
1,0.970,Pacific Ocean Water,16-23,0,0,0,0,NaN,NaN
1,0.970,Pacific Ocean Water,23-5,0,0,0,0,NaN,NaN
1,0.970,Cat,16-23,41,28,0,69,59.420,59.420
1,0.970,Cat,23-5,39,37,0,76,51.316,51.316
1,0.970,Horse,16-23,21,42,0,63,33.333,33.333
1,0.970,Horse,23-5,51,238,0,289,17.647,17.647
1,0.970,orangutan,16-23,0,0,0,0,NaN,NaN
1,0.970,orangutan,23-5,0,4,0,4,0.000,0.000
1,0.970,Bat,16-23,36,7,0,43,83.721,83.721
1,0.970,Bat,23-5,37,18,0,55,67.273,67.273
1,0.970,Deer,16-23,17,13,0,30,56.667,56.667
1,0.970,Deer,23-5,18,46,0,64,28.125,28.125
1,0.970,Great Horned Owl,16-23,0,2,0,2,0.000,0.000
1,0.970,Great Horned Owl,23-5,1,9,0,10,10.000,10.000
1,0.970,Freshwater Lagoon,16-23,0,0,0,0,NaN,NaN
1,0.970,Freshwater Lagoon,23-5,0,0,0,0,NaN,NaN
1,0.970,Unknown Avian,16-23,0,2,0,2,0.000,0.000
1,0.970,Unknown Avian,23-5,0,2,0,2,0.000,0.000
1,0.970,Human UTI,16-23,115,88,0,203,56.650,56.650
1,0.970,Human UTI,23-5,126,81,0,207,60.870,60.870
1,0.970,unknown,16-23,6,8,0,14,42.857,42.857
1,0.970,unknown,23-5,8,13,0,21,38.095,38.095
1,0.970,SLO Creek Water,16-23,0,0,0,0,NaN,NaN
1,0.970,SLO Creek Water,23-5,6,1,0,7,85.714,85.714
1,0.970,Pig/Swine,16-23,14,12,0,26,53.846,53.846
1,0.970,Pig/Swine,23-5,12,7,0,19,63.158,63.158
1,0.970,Klebsiella,16-23,0,0,0,0,NaN,NaN
1,0.970,Klebsiella,23-5,0,0,0,0,NaN,NaN
1,0.970,Hu Cw and Dg,16-23,12,17,0,29,41.379,41.379
1,0.970,Hu Cw and Dg,23-5,21,20,0,41,51.220,51.220
1,0.970,Ground Squirrel,16-23,113,76,0,189,59.788,59.788
1,0.970,Ground Squirrel,23-5,116,81,0,197,58.883,58.883
1,0.970,Opossum,16-23,4,1,0,5,80.000,80.000
1,0.970,Opossum,23-5,5,8,0,13,38.462,38.462
1,0.970,Cow,16-23,1567,840,0,2407,65.102,65.102
1,0.970,Cow,23-5,1544,1033,0,2577,59.915,59.915
1,0.970,Deer Mouse,16-23,0,5,0,5,0.000,0.000
1,0.970,Deer Mouse,23-5,0,0,0,0,NaN,NaN
1,0.970,OVERALL,16-23,4188,2118,0,6306,66.413,66.413
1,0.970,OVERALL,23-5,4808,2748,0,7556,63.632,63.632
1,0.980,Chicken,16-23,22,29,0,51,43.137,43.137
1,0.980,Chicken,23-5,28,11,0,39,71.795,71.795
1,0.980,Sea Lion,16-23,1,1,0,2,50.000,50.000
1,0.980,Sea Lion,23-5,4,3,0,7,57.143,57.143
1,0.980,Hu and Cw,16-23,15,26,0,41,36.585,36.585
1,0.980,Hu and Cw,23-5,15,33,0,48,31.250,31.250
1,0.980,Sheep,16-23,78,63,0,141,55.319,55.319
1,0.980,Sheep,23-5,77,32,0,109,70.642,70.642
1,0.980,Hu and Dg,16-23,16,24,0,40,40.000,40.000
1,0.980,Hu and Dg,23-5,20,15,0,35,57.143,57.143
1,0.980,Common Loon,16-23,2,0,0,2,100.000,100.000
1,0.980,Common Loon,23-5,0,3,0,3,0.000,0.000
1,0.980,Red-Winged Blackbird,16-23,2,5,0,7,28.571,28.571
1,0.980,Red-Winged Blackbird,23-5,2,4,0,6,33.333,33.333
1,0.980,Cw,16-23,17,24,0,41,41.463,41.463
1,0.980,Cw,23-5,31,54,0,85,36.471,36.471
1,0.980,Cliff Sparrow,16-23,16,27,0,43,37.209,37.209
1,0.980,Cliff Sparrow,23-5,10,34,0,44,22.727,22.727
1,0.980,Pig,16-23,23,16,0,39,58.974,58.974
1,0.980,Pig,23-5,20,18,0,38,52.632,52.632
1,0.980,Barn Owl,16-23,0,0,0,0,NaN,NaN
1,0.980,Barn Owl,23-5,2,6,0,8,25.000,25.000
1,0.980,Wild Pig,16-23,5,8,0,13,38.462,38.462
1,0.980,Wild Pig,23-5,7,5,0,12,58.333,58.333
1,0.980,Pennington Creek Water,16-23,0,0,0,0,NaN,NaN
1,0.980,Pennington Creek Water,23-5,0,0,0,0,NaN,NaN
1,0.980,Guinni,16-23,0,0,0,0,NaN,NaN
1,0.980,Guinni,23-5,0,2,0,2,0.000,0.000
1,0.980,Racoon,16-23,2,3,0,5,40.000,40.000
1,0.980,Racoon,23-5,0,4,0,4,0.000,0.000
1,0.980,Hu,16-23,27,9,0,36,75.000,75.000
1,0.980,Hu,23-5,25,13,0,38,65.789,65.789
1,0.980,Cw and Dg,16-23,15,21,0,36,41.667,41.667
1,0.980,Cw and Dg,23-5,18,29,0,47,38.298,38.298
1,0.980,Red Wind Blackbird,16-23,0,0,0,0,NaN,NaN
1,0.980,Red Wind Blackbird,23-5,0,1,0,1,0.000,0.000
1,0.980,Tree Swallow,16-23,2,6,0,8,25.000,25.000
1,0.980,Tree Swallow,23-5,2,1,0,3,66.667,66.667
1,0.980,Turkey Vulture,16-23,0,2,0,2,0.000,0.000
1,0.980,Turkey Vulture,23-5,0,2,0,2,0.000,0.000
1,0.980,Dg,16-23,11,16,0,27,40.741,40.741
1,0.980,Dg,23-5,27,10,0,37,72.973,72.973
1,0.980,Western Kingbird,16-23,0,3,0,3,0.000,0.000
1,0.980,Western Kingbird,23-5,0,0,0,0,NaN,NaN
1,0.980,White Crowned Sparrow,16-23,13,5,0,18,72.222,72.222
1,0.980,White Crowned Sparrow,23-5,8,16,0,24,33.333,33.333
1,0.980,Eared Grebe,16-23,0,0,0,0,NaN,NaN
1,0.980,Eared Grebe,23-5,2,2,0,4,50.000,50.000
1,0.980,cougar,16-23,0,1,0,1,0.000,0.000
1,0.980,cougar,23-5,0,0,0,0,NaN,NaN
1,0.980,Ocean Water,16-23,0,0,0,0,NaN,NaN
1,0.980,Ocean Water,23-5,0,0,0,0,NaN,NaN
1,0.980,Red Tailed Hawk,16-23,2,0,0,2,100.000,100.000
1,0.980,Red Tailed Hawk,23-5,0,10,0,10,0.000,0.000
1,0.980,Dog,16-23,96,72,0,168,57.143,57.143
1,0.980,Dog,23-5,156,127,0,283,55.124,55.124
1,0.980,Human,16-23,1724,352,0,2076,83.044,83.044
1,0.980,Human,23-5,2163,258,0,2421,89.343,89.343
1,0.980,Wild Turkey,16-23,18,56,0,74,24.324,24.324
1,0.980,Wild Turkey,23-5,14,65,0,79,17.722,17.722
1,0.980,Clark Grebe,16-23,0,0,0,0,NaN,NaN
1,0.980,Clark Grebe,23-5,2,3,0,5,40.000,40.000
1,0.980,Seagull,16-23,0,0,0,0,NaN,NaN
1,0.980,Seagull,23-5,33,7,0,40,82.500,82.500
1,0.980,Surf Scoter,16-23,0,0,0,0,NaN,NaN
1,0.980,Surf Scoter,23-5,2,0,0,2,100.000,100.000
1,0.980,Pigeon,16-23,130,197,0,327,39.755,39.755
1,0.980,Pigeon,23-5,149,370,0,519,28.709,28.709
1,0.980,Pacific Ocean Water,16-23,0,0,0,0,NaN,NaN
1,0.980,Pacific Ocean Water,23-5,0,0,0,0,NaN,NaN
1,0.980,Cat,16-23,41,28,0,69,59.420,59.420
1,0.980,Cat,23-5,39,35,0,74,52.703,52.703
1,0.980,Horse,16-23,21,42,0,63,33.333,33.333
1,0.980,Horse,23-5,51,237,0,288,17.708,17.708
1,0.980,orangutan,16-23,0,0,0,0,NaN,NaN
1,0.980,orangutan,23-5,0,4,0,4,0.000,0.000
1,0.980,Bat,16-23,36,7,0,43,83.721,83.721
1,0.980,Bat,23-5,37,17,0,54,68.519,68.519
1,0.980,Deer,16-23,17,13,0,30,56.667,56.667
1,0.980,Deer,23-5,18,46,0,64,28.125,28.125
1,0.980,Great Horned Owl,16-23,0,2,0,2,0.000,0.000
1,0.980,Great Horned Owl,23-5,1,9,0,10,10.000,10.000
1,0.980,Freshwater Lagoon,16-23,0,0,0,0,NaN,NaN
1,0.980,Freshwater Lagoon,23-5,0,0,0,0,NaN,NaN
1,0.980,Unknown Avian,16-23,0,2,0,2,0.000,0.000
1,0.980,Unknown Avian,23-5,0,2,0,2,0.000,0.000
1,0.980,Human UTI,16-23,115,85,0,200,57.500,57.500
1,0.980,Human UTI,23-5,126,78,0,204,61.765,61.765
1,0.980,unknown,16-23,6,8,0,14,42.857,42.857
1,0.980,unknown,23-5,8,13,0,21,38.095,38.095
1,0.980,SLO Creek Water,16-23,0,0,0,0,NaN,NaN
1,0.980,SLO Creek Water,23-5,6,1,0,7,85.714,85.714
1,0.980,Pig/Swine,16-23,14,12,0,26,53.846,53.846
1,0.980,Pig/Swine,23-5,12,7,0,19,63.158,63.158
1,0.980,Klebsiella,16-23,0,0,0,0,NaN,NaN
1,0.980,Klebsiella,23-5,0,0,0,0,NaN,NaN
1,0.980,Hu Cw and Dg,16-23,12,17,0,29,41.379,41.379
1,0.980,Hu Cw and Dg,23-5,21,20,0,41,51.220,51.220
1,0.980,Ground Squirrel,16-23,113,76,0,189,59.788,59.788
1,0.980,Ground Squirrel,23-5,116,81,0,197,58.883,58.883
1,0.980,Opossum,16-23,4,1,0,5,80.000,80.000
1,0.980,Opossum,23-5,5,8,0,13,38.462,38.462
1,0.980,Cow,16-23,1564,832,0,2396,65.275,65.275
1,0.980,Cow,23-5,1534,1024,0,2558,59.969,59.969
1,0.980,Deer Mouse,16-23,0,5,0,5,0.000,0.000
1,0.980,Deer Mouse,23-5,0,0,0,0,NaN,NaN
1,0.980,OVERALL,16-23,4180,2096,0,6276,66.603,66.603
1,0.980,OVERALL,23-5,4791,2720,0,7511,63.786,63.786
1,0.990,Chicken,16-23,22,27,0,49,44.898,44.898
1,0.990,Chicken,23-5,28,10,0,38,73.684,73.684
1,0.990,Sea Lion,16-23,1,1,0,2,50.000,50.000
1,0.990,Sea Lion,23-5,4,3,0,7,57.143,57.143
1,0.990,Hu and Cw,16-23,15,26,0,41,36.585,36.585
1,0.990,Hu and Cw,23-5,15,31,0,46,32.609,32.609
1,0.990,Sheep,16-23,77,61,0,138,55.797,55.797
1,0.990,Sheep,23-5,77,32,0,109,70.642,70.642
1,0.990,Hu and Dg,16-23,16,24,0,40,40.000,40.000
1,0.990,Hu and Dg,23-5,20,15,0,35,57.143,57.143
1,0.990,Common Loon,16-23,2,0,0,2,100.000,100.000
1,0.990,Common Loon,23-5,0,3,0,3,0.000,0.000
1,0.990,Red-Winged Blackbird,16-23,2,4,0,6,33.333,33.333
1,0.990,Red-Winged Blackbird,23-5,2,4,0,6,33.333,33.333
1,0.990,Cw,16-23,17,24,0,41,41.463,41.463
1,0.990,Cw,23-5,31,52,0,83,37.349,37.349
1,0.990,Cliff Sparrow,16-23,16,27,0,43,37.209,37.209
1,0.990,Cliff Sparrow,23-5,10,34,0,44,22.727,22.727
1,0.990,Pig,16-23,23,16,0,39,58.974,58.974
1,0.990,Pig,23-5,20,18,0,38,52.632,52.632
1,0.990,Barn Owl,16-23,0,0,0,0,NaN,NaN
1,0.990,Barn Owl,23-5,2,5,0,7,28.571,28.571
1,0.990,Wild Pig,16-23,5,7,0,12,41.667,41.667
1,0.990,Wild Pig,23-5,7,5,0,12,58.333,58.333
1,0.990,Pennington Creek Water,16-23,0,0,0,0,NaN,NaN
1,0.990,Pennington Creek Water,23-5,0,0,0,0,NaN,NaN
1,0.990,Guinni,16-23,0,0,0,0,NaN,NaN
1,0.990,Guinni,23-5,0,1,0,1,0.000,0.000
1,0.990,Racoon,16-23,2,3,0,5,40.000,40.000
1,0.990,Racoon,23-5,0,4,0,4,0.000,0.000
1,0.990,Hu,16-23,27,9,0,36,75.000,75.000
1,0.990,Hu,23-5,25,11,0,36,69.444,69.444
1,0.990,Cw and Dg,16-23,15,21,0,36,41.667,41.667
1,0.990,Cw and Dg,23-5,18,24,0,42,42.857,42.857
1,0.990,Red Wind Blackbird,16-23,0,0,0,0,NaN,NaN
1,0.990,Red Wind Blackbird,23-5,0,1,0,1,0.000,0.000
1,0.990,Tree Swallow,16-23,2,6,0,8,25.000,25.000
1,0.990,Tree Swallow,23-5,2,1,0,3,66.667,66.667
1,0.990,Turkey Vulture,16-23,0,2,0,2,0.000,0.000
1,0.990,Turkey Vulture,23-5,0,2,0,2,0.000,0.000
1,0.990,Dg,16-23,11,16,0,27,40.741,40.741
1,0.990,Dg,23-5,27,10,0,37,72.973,72.973
1,0.990,Western Kingbird,16-23,0,3,0,3,0.000,0.000
1,0.990,Western Kingbird,23-5,0,0,0,0,NaN,NaN
1,0.990,White Crowned Sparrow,16-23,13,5,0,18,72.222,72.222
1,0.990,White Crowned Sparrow,23-5,8,16,0,24,33.333,33.333
1,0.990,Eared Grebe,16-23,0,0,0,0,NaN,NaN
1,0.990,Eared Grebe,23-5,2,2,0,4,50.000,50.000
1,0.990,cougar,16-23,0,1,0,1,0.000,0.000
1,0.990,cougar,23-5,0,0,0,0,NaN,NaN
1,0.990,Ocean Water,16-23,0,0,0,0,NaN,NaN
1,0.990,Ocean Water,23-5,0,0,0,0,NaN,NaN
1,0.990,Red Tailed Hawk,16-23,2,0,0,2,100.000,100.000
1,0.990,Red Tailed Hawk,23-5,0,10,0,10,0.000,0.000
1,0.990,Dog,16-23,96,70,0,166,57.831,57.831
1,0.990,Dog,23-5,155,120,0,275,56.364,56.364
1,0.990,Human,16-23,1706,337,0,2043,83.505,83.505
1,0.990,Human,23-5,2153,245,0,2398,89.783,89.783
1,0.990,Wild Turkey,16-23,18,52,0,70,25.714,25.714
1,0.990,Wild Turkey,23-5,12,54,0,66,18.182,18.182
1,0.990,Clark Grebe,16-23,0,0,0,0,NaN,NaN
1,0.990,Clark Grebe,23-5,2,3,0,5,40.000,40.000
1,0.990,Seagull,16-23,0,0,0,0,NaN,NaN
1,0.990,Seagull,23-5,33,7,0,40,82.500,82.500
1,0.990,Surf Scoter,16-23,0,0,0,0,NaN,NaN
1,0.990,Surf Scoter,23-5,2,0,0,2,100.000,100.000
1,0.990,Pigeon,16-23,128,185,0,313,40.895,40.895
1,0.990,Pigeon,23-5,147,346,0,493,29.817,29.817
1,0.990,Pacific Ocean Water,16-23,0,0,0,0,NaN,NaN
1,0.990,Pacific Ocean Water,23-5,0,0,0,0,NaN,NaN
1,0.990,Cat,16-23,41,26,0,67,61.194,61.194
1,0.990,Cat,23-5,39,32,0,71,54.930,54.930
1,0.990,Horse,16-23,21,39,0,60,35.000,35.000
1,0.990,Horse,23-5,50,229,0,279,17.921,17.921
1,0.990,orangutan,16-23,0,0,0,0,NaN,NaN
1,0.990,orangutan,23-5,0,4,0,4,0.000,0.000
1,0.990,Bat,16-23,36,7,0,43,83.721,83.721
1,0.990,Bat,23-5,37,17,0,54,68.519,68.519
1,0.990,Deer,16-23,17,13,0,30,56.667,56.667
1,0.990,Deer,23-5,18,45,0,63,28.571,28.571
1,0.990,Great Horned Owl,16-23,0,2,0,2,0.000,0.000
1,0.990,Great Horned Owl,23-5,1,9,0,10,10.000,10.000
1,0.990,Freshwater Lagoon,16-23,0,0,0,0,NaN,NaN
1,0.990,Freshwater Lagoon,23-5,0,0,0,0,NaN,NaN
1,0.990,Unknown Avian,16-23,0,2,0,2,0.000,0.000
1,0.990,Unknown Avian,23-5,0,2,0,2,0.000,0.000
1,0.990,Human UTI,16-23,115,81,0,196,58.673,58.673
1,0.990,Human UTI,23-5,126,63,0,189,66.667,66.667
1,0.990,unknown,16-23,6,8,0,14,42.857,42.857
1,0.990,unknown,23-5,8,13,0,21,38.095,38.095
1,0.990,SLO Creek Water,16-23,0,0,0,0,NaN,NaN
1,0.990,SLO Creek Water,23-5,6,1,0,7,85.714,85.714
1,0.990,Pig/Swine,16-23,13,9,0,22,59.091,59.091
1,0.990,Pig/Swine,23-5,12,7,0,19,63.158,63.158
1,0.990,Klebsiella,16-23,0,0,0,0,NaN,NaN
1,0.990,Klebsiella,23-5,0,0,0,0,NaN,NaN
1,0.990,Hu Cw and Dg,16-23,12,17,0,29,41.379,41.379
1,0.990,Hu Cw and Dg,23-5,21,20,0,41,51.220,51.220
1,0.990,Ground Squirrel,16-23,113,71,0,184,61.413,61.413
1,0.990,Ground Squirrel,23-5,114,73,0,187,60.963,60.963
1,0.990,Opossum,16-23,4,1,0,5,80.000,80.000
1,0.990,Opossum,23-5,5,8,0,13,38.462,38.462
1,0.990,Cow,16-23,1527,785,0,2312,66.047,66.047
1,0.990,Cow,23-5,1510,964,0,2474,61.035,61.035
1,0.990,Deer Mouse,16-23,0,5,0,5,0.000,0.000
1,0.990,Deer Mouse,23-5,0,0,0,0,NaN,NaN
1,0.990,OVERALL,16-23,4121,1993,0,6114,67.403,67.403
1,0.990,OVERALL,23-5,4749,2556,0,7305,65.010,65.010
1,1.000,Chicken,16-23,0,0,0,0,NaN,NaN
1,1.000,Chicken,23-5,0,0,0,0,NaN,NaN
1,1.000,Sea Lion,16-23,0,0,0,0,NaN,NaN
1,1.000,Sea Lion,23-5,0,0,0,0,NaN,NaN
1,1.000,Hu and Cw,16-23,0,0,0,0,NaN,NaN
1,1.000,Hu and Cw,23-5,0,0,0,0,NaN,NaN
1,1.000,Sheep,16-23,0,0,0,0,NaN,NaN
1,1.000,Sheep,23-5,0,0,0,0,NaN,NaN
1,1.000,Hu and Dg,16-23,0,0,0,0,NaN,NaN
1,1.000,Hu and Dg,23-5,0,0,0,0,NaN,NaN
1,1.000,Common Loon,16-23,0,0,0,0,NaN,NaN
1,1.000,Common Loon,23-5,0,0,0,0,NaN,NaN
1,1.000,Red-Winged Blackbird,16-23,0,0,0,0,NaN,NaN
1,1.000,Red-Winged Blackbird,23-5,0,0,0,0,NaN,NaN
1,1.000,Cw,16-23,0,0,0,0,NaN,NaN
1,1.000,Cw,23-5,0,0,0,0,NaN,NaN
1,1.000,Cliff Sparrow,16-23,0,0,0,0,NaN,NaN
1,1.000,Cliff Sparrow,23-5,0,0,0,0,NaN,NaN
1,1.000,Pig,16-23,0,0,0,0,NaN,NaN
1,1.000,Pig,23-5,0,0,0,0,NaN,NaN
1,1.000,Barn Owl,16-23,0,0,0,0,NaN,NaN
1,1.000,Barn Owl,23-5,0,0,0,0,NaN,NaN
1,1.000,Wild Pig,16-23,0,0,0,0,NaN,NaN
1,1.000,Wild Pig,23-5,0,0,0,0,NaN,NaN
1,1.000,Pennington Creek Water,16-23,0,0,0,0,NaN,NaN
1,1.000,Pennington Creek Water,23-5,0,0,0,0,NaN,NaN
1,1.000,Guinni,16-23,0,0,0,0,NaN,NaN
1,1.000,Guinni,23-5,0,0,0,0,NaN,NaN
1,1.000,Racoon,16-23,0,0,0,0,NaN,NaN
1,1.000,Racoon,23-5,0,0,0,0,NaN,NaN
1,1.000,Hu,16-23,0,0,0,0,NaN,NaN
1,1.000,Hu,23-5,0,0,0,0,NaN,NaN
1,1.000,Cw and Dg,16-23,0,0,0,0,NaN,NaN
1,1.000,Cw and Dg,23-5,0,0,0,0,NaN,NaN
1,1.000,Red Wind Blackbird,16-23,0,0,0,0,NaN,NaN
1,1.000,Red Wind Blackbird,23-5,0,0,0,0,NaN,NaN
1,1.000,Tree Swallow,16-23,0,0,0,0,NaN,NaN
1,1.000,Tree Swallow,23-5,0,0,0,0,NaN,NaN
1,1.000,Turkey Vulture,16-23,0,0,0,0,NaN,NaN
1,1.000,Turkey Vulture,23-5,0,0,0,0,NaN,NaN
1,1.000,Dg,16-23,0,0,0,0,NaN,NaN
1,1.000,Dg,23-5,0,0,0,0,NaN,NaN
1,1.000,Western Kingbird,16-23,0,0,0,0,NaN,NaN
1,1.000,Western Kingbird,23-5,0,0,0,0,NaN,NaN
1,1.000,White Crowned Sparrow,16-23,0,0,0,0,NaN,NaN
1,1.000,White Crowned Sparrow,23-5,0,0,0,0,NaN,NaN
1,1.000,Eared Grebe,16-23,0,0,0,0,NaN,NaN
1,1.000,Eared Grebe,23-5,0,0,0,0,NaN,NaN
1,1.000,cougar,16-23,0,0,0,0,NaN,NaN
1,1.000,cougar,23-5,0,0,0,0,NaN,NaN
1,1.000,Ocean Water,16-23,0,0,0,0,NaN,NaN
1,1.000,Ocean Water,23-5,0,0,0,0,NaN,NaN
1,1.000,Red Tailed Hawk,16-23,0,0,0,0,NaN,NaN
1,1.000,Red Tailed Hawk,23-5,0,0,0,0,NaN,NaN
1,1.000,Dog,16-23,0,0,0,0,NaN,NaN
1,1.000,Dog,23-5,0,0,0,0,NaN,NaN
1,1.000,Human,16-23,0,0,0,0,NaN,NaN
1,1.000,Human,23-5,0,0,0,0,NaN,NaN
1,1.000,Wild Turkey,16-23,0,0,0,0,NaN,NaN
1,1.000,Wild Turkey,23-5,0,0,0,0,NaN,NaN
1,1.000,Clark Grebe,16-23,0,0,0,0,NaN,NaN
1,1.000,Clark Grebe,23-5,0,0,0,0,NaN,NaN
1,1.000,Seagull,16-23,0,0,0,0,NaN,NaN
1,1.000,Seagull,23-5,0,0,0,0,NaN,NaN
1,1.000,Surf Scoter,16-23,0,0,0,0,NaN,NaN
1,1.000,Surf Scoter,23-5,0,0,0,0,NaN,NaN
1,1.000,Pigeon,16-23,0,0,0,0,NaN,NaN
1,1.000,Pigeon,23-5,0,0,0,0,NaN,NaN
1,1.000,Pacific Ocean Water,16-23,0,0,0,0,NaN,NaN
1,1.000,Pacific Ocean Water,23-5,0,0,0,0,NaN,NaN
1,1.000,Cat,16-23,0,0,0,0,NaN,NaN
1,1.000,Cat,23-5,0,0,0,0,NaN,NaN
1,1.000,Horse,16-23,0,0,0,0,NaN,NaN
1,1.000,Horse,23-5,0,0,0,0,NaN,NaN
1,1.000,orangutan,16-23,0,0,0,0,NaN,NaN
1,1.000,orangutan,23-5,0,0,0,0,NaN,NaN
1,1.000,Bat,16-23,0,0,0,0,NaN,NaN
1,1.000,Bat,23-5,0,0,0,0,NaN,NaN
1,1.000,Deer,16-23,0,0,0,0,NaN,NaN
1,1.000,Deer,23-5,0,0,0,0,NaN,NaN
1,1.000,Great Horned Owl,16-23,0,0,0,0,NaN,NaN
1,1.000,Great Horned Owl,23-5,0,0,0,0,NaN,NaN
1,1.000,Freshwater Lagoon,16-23,0,0,0,0,NaN,NaN
1,1.000,Freshwater Lagoon,23-5,0,0,0,0,NaN,NaN
1,1.000,Unknown Avian,16-23,0,0,0,0,NaN,NaN
1,1.000,Unknown Avian,23-5,0,0,0,0,NaN,NaN
1,1.000,Human UTI,16-23,0,0,0,0,NaN,NaN
1,1.000,Human UTI,23-5,0,0,0,0,NaN,NaN
1,1.000,unknown,16-23,0,0,0,0,NaN,NaN
1,1.000,unknown,23-5,0,0,0,0,NaN,NaN
1,1.000,SLO Creek Water,16-23,0,0,0,0,NaN,NaN
1,1.000,SLO Creek Water,23-5,0,0,0,0,NaN,NaN
1,1.000,Pig/Swine,16-23,0,0,0,0,NaN,NaN
1,1.000,Pig/Swine,23-5,0,0,0,0,NaN,NaN
1,1.000,Klebsiella,16-23,0,0,0,0,NaN,NaN
1,1.000,Klebsiella,23-5,0,0,0,0,NaN,NaN
1,1.000,Hu Cw and Dg,16-23,0,0,0,0,NaN,NaN
1,1.000,Hu Cw and Dg,23-5,0,0,0,0,NaN,NaN
1,1.000,Ground Squirrel,16-23,0,0,0,0,NaN,NaN
1,1.000,Ground Squirrel,23-5,0,0,0,0,NaN,NaN
1,1.000,Opossum,16-23,0,0,0,0,NaN,NaN
1,1.000,Opossum,23-5,0,0,0,0,NaN,NaN
1,1.000,Cow,16-23,0,0,0,0,NaN,NaN
1,1.000,Cow,23-5,0,0,0,0,NaN,NaN
1,1.000,Deer Mouse,16-23,0,0,0,0,NaN,NaN
1,1.000,Deer Mouse,23-5,0,0,0,0,NaN,NaN
1,1.000,OVERALL,16-23,0,0,0,0,NaN,NaN
1,1.000,OVERALL,23-5,0,0,0,0,NaN,NaN
2,0.000,Chicken,16-23,20,45,0,65,30.769,30.769
2,0.000,Chicken,23-5,27,27,0,54,50.000,50.000
2,0.000,Sea Lion,16-23,2,1,0,3,66.667,66.667
2,0.000,Sea Lion,23-5,4,5,0,9,44.444,44.444
2,0.000,Hu and Cw,16-23,24,37,0,61,39.344,39.344
2,0.000,Hu and Cw,23-5,15,49,0,64,23.438,23.438
2,0.000,Sheep,16-23,82,102,0,184,44.565,44.565
2,0.000,Sheep,23-5,76,59,0,135,56.296,56.296
2,0.000,Hu and Dg,16-23,8,23,0,31,25.806,25.806
2,0.000,Hu and Dg,23-5,18,15,0,33,54.545,54.545
2,0.000,Common Loon,16-23,0,0,0,0,NaN,NaN
2,0.000,Common Loon,23-5,0,6,0,6,0.000,0.000
2,0.000,Red-Winged Blackbird,16-23,2,6,0,8,25.000,25.000
2,0.000,Red-Winged Blackbird,23-5,1,8,0,9,11.111,11.111
2,0.000,Cw,16-23,14,20,0,34,41.176,41.176
2,0.000,Cw,23-5,37,55,0,92,40.217,40.217
2,0.000,Cliff Sparrow,16-23,20,46,0,66,30.303,30.303
2,0.000,Cliff Sparrow,23-5,12,56,0,68,17.647,17.647
2,0.000,Pig,16-23,19,24,0,43,44.186,44.186
2,0.000,Pig,23-5,19,25,0,44,43.182,43.182
2,0.000,Barn Owl,16-23,0,0,0,0,NaN,NaN
2,0.000,Barn Owl,23-5,0,3,0,3,0.000,0.000
2,0.000,Wild Pig,16-23,9,20,0,29,31.034,31.034
2,0.000,Wild Pig,23-5,11,10,0,21,52.381,52.381
2,0.000,Pennington Creek Water,16-23,0,0,0,0,NaN,NaN
2,0.000,Pennington Creek Water,23-5,0,0,0,0,NaN,NaN
2,0.000,Guinni,16-23,0,0,0,0,NaN,NaN
2,0.000,Guinni,23-5,0,2,0,2,0.000,0.000
2,0.000,Racoon,16-23,2,3,0,5,40.000,40.000
2,0.000,Racoon,23-5,0,7,0,7,0.000,0.000
2,0.000,Hu,16-23,15,7,0,22,68.182,68.182
2,0.000,Hu,23-5,21,5,0,26,80.769,80.769
2,0.000,Cw and Dg,16-23,5,6,0,11,45.455,45.455
2,0.000,Cw and Dg,23-5,14,8,0,22,63.636,63.636
2,0.000,Red Wind Blackbird,16-23,0,1,0,1,0.000,0.000
2,0.000,Red Wind Blackbird,23-5,0,2,0,2,0.000,0.000
2,0.000,Tree Swallow,16-23,2,7,0,9,22.222,22.222
2,0.000,Tree Swallow,23-5,0,6,0,6,0.000,0.000
2,0.000,Turkey Vulture,16-23,0,4,0,4,0.000,0.000
2,0.000,Turkey Vulture,23-5,0,4,0,4,0.000,0.000
2,0.000,Dg,16-23,13,21,0,34,38.235,38.235
2,0.000,Dg,23-5,29,20,0,49,59.184,59.184
2,0.000,Western Kingbird,16-23,0,3,0,3,0.000,0.000
2,0.000,Western Kingbird,23-5,0,2,0,2,0.000,0.000
2,0.000,White Crowned Sparrow,16-23,13,13,0,26,50.000,50.000
2,0.000,White Crowned Sparrow,23-5,8,27,0,35,22.857,22.857
2,0.000,Eared Grebe,16-23,0,0,0,0,NaN,NaN
2,0.000,Eared Grebe,23-5,3,12,0,15,20.000,20.000
2,0.000,cougar,16-23,0,1,0,1,0.000,0.000
2,0.000,cougar,23-5,0,0,0,0,NaN,NaN
2,0.000,Ocean Water,16-23,0,0,0,0,NaN,NaN
2,0.000,Ocean Water,23-5,0,0,0,0,NaN,NaN
2,0.000,Red Tailed Hawk,16-23,2,2,0,4,50.000,50.000
2,0.000,Red Tailed Hawk,23-5,0,14,0,14,0.000,0.000
2,0.000,Dog,16-23,89,107,0,196,45.408,45.408
2,0.000,Dog,23-5,135,175,0,310,43.548,43.548
2,0.000,Human,16-23,1725,553,0,2278,75.724,75.724
2,0.000,Human,23-5,2168,441,0,2609,83.097,83.097
2,0.000,Wild Turkey,16-23,15,85,0,100,15.000,15.000
2,0.000,Wild Turkey,23-5,17,87,0,104,16.346,16.346
2,0.000,Clark Grebe,16-23,0,0,0,0,NaN,NaN
2,0.000,Clark Grebe,23-5,0,3,0,3,0.000,0.000
2,0.000,Seagull,16-23,0,0,0,0,NaN,NaN
2,0.000,Seagull,23-5,22,11,0,33,66.667,66.667
2,0.000,Surf Scoter,16-23,0,0,0,0,NaN,NaN
2,0.000,Surf Scoter,23-5,0,4,0,4,0.000,0.000
2,0.000,Pigeon,16-23,118,224,0,342,34.503,34.503
2,0.000,Pigeon,23-5,139,438,0,577,24.090,24.090
2,0.000,Pacific Ocean Water,16-23,0,0,0,0,NaN,NaN
2,0.000,Pacific Ocean Water,23-5,0,0,0,0,NaN,NaN
2,0.000,Cat,16-23,46,43,0,89,51.685,51.685
2,0.000,Cat,23-5,43,68,0,111,38.739,38.739
2,0.000,Horse,16-23,23,76,0,99,23.232,23.232
2,0.000,Horse,23-5,54,358,0,412,13.107,13.107
2,0.000,orangutan,16-23,0,0,0,0,NaN,NaN
2,0.000,orangutan,23-5,0,0,0,0,NaN,NaN
2,0.000,Bat,16-23,36,11,0,47,76.596,76.596
2,0.000,Bat,23-5,37,20,0,57,64.912,64.912
2,0.000,Deer,16-23,15,29,0,44,34.091,34.091
2,0.000,Deer,23-5,18,69,0,87,20.690,20.690
2,0.000,Great Horned Owl,16-23,0,3,0,3,0.000,0.000
2,0.000,Great Horned Owl,23-5,1,14,0,15,6.667,6.667
2,0.000,Freshwater Lagoon,16-23,0,0,0,0,NaN,NaN
2,0.000,Freshwater Lagoon,23-5,0,0,0,0,NaN,NaN
2,0.000,Unknown Avian,16-23,0,0,0,0,NaN,NaN
2,0.000,Unknown Avian,23-5,0,2,0,2,0.000,0.000
2,0.000,Human UTI,16-23,97,96,0,193,50.259,50.259
2,0.000,Human UTI,23-5,114,85,0,199,57.286,57.286
2,0.000,unknown,16-23,1,16,0,17,5.882,5.882
2,0.000,unknown,23-5,5,17,0,22,22.727,22.727
2,0.000,SLO Creek Water,16-23,0,0,0,0,NaN,NaN
2,0.000,SLO Creek Water,23-5,8,1,0,9,88.889,88.889
2,0.000,Pig/Swine,16-23,12,21,0,33,36.364,36.364
2,0.000,Pig/Swine,23-5,7,9,0,16,43.750,43.750
2,0.000,Klebsiella,16-23,0,0,0,0,NaN,NaN
2,0.000,Klebsiella,23-5,0,0,0,0,NaN,NaN
2,0.000,Hu Cw and Dg,16-23,19,27,0,46,41.304,41.304
2,0.000,Hu Cw and Dg,23-5,35,33,0,68,51.471,51.471
2,0.000,Ground Squirrel,16-23,122,141,0,263,46.388,46.388
2,0.000,Ground Squirrel,23-5,116,157,0,273,42.491,42.491
2,0.000,Opossum,16-23,2,1,0,3,66.667,66.667
2,0.000,Opossum,23-5,2,9,0,11,18.182,18.182
2,0.000,Cow,16-23,1360,591,0,1951,69.708,69.708
2,0.000,Cow,23-5,1340,626,0,1966,68.159,68.159
2,0.000,Deer Mouse,16-23,0,0,0,0,NaN,NaN
2,0.000,Deer Mouse,23-5,0,0,0,0,NaN,NaN
2,0.000,OVERALL,16-23,3932,2416,0,6348,61.941,61.941
2,0.000,OVERALL,23-5,4556,3054,0,7610,59.869,59.869
2,0.500,Chicken,16-23,20,45,0,65,30.769,30.769
2,0.500,Chicken,23-5,27,27,0,54,50.000,50.000
2,0.500,Sea Lion,16-23,2,1,0,3,66.667,66.667
2,0.500,Sea Lion,23-5,4,5,0,9,44.444,44.444
2,0.500,Hu and Cw,16-23,24,37,0,61,39.344,39.344
2,0.500,Hu and Cw,23-5,15,49,0,64,23.438,23.438
2,0.500,Sheep,16-23,82,102,0,184,44.565,44.565
2,0.500,Sheep,23-5,76,59,0,135,56.296,56.296
2,0.500,Hu and Dg,16-23,8,23,0,31,25.806,25.806
2,0.500,Hu and Dg,23-5,18,15,0,33,54.545,54.545
2,0.500,Common Loon,16-23,0,0,0,0,NaN,NaN
2,0.500,Common Loon,23-5,0,6,0,6,0.000,0.000
2,0.500,Red-Winged Blackbird,16-23,2,6,0,8,25.000,25.000
2,0.500,Red-Winged Blackbird,23-5,1,8,0,9,11.111,11.111
2,0.500,Cw,16-23,14,20,0,34,41.176,41.176
2,0.500,Cw,23-5,37,55,0,92,40.217,40.217
2,0.500,Cliff Sparrow,16-23,20,46,0,66,30.303,30.303
2,0.500,Cliff Sparrow,23-5,12,56,0,68,17.647,17.647
2,0.500,Pig,16-23,19,24,0,43,44.186,44.186
2,0.500,Pig,23-5,19,25,0,44,43.182,43.182
2,0.500,Barn Owl,16-23,0,0,0,0,NaN,NaN
2,0.500,Barn Owl,23-5,0,3,0,3,0.000,0.000
2,0.500,Wild Pig,16-23,9,20,0,29,31.034,31.034
2,0.500,Wild Pig,23-5,11,10,0,21,52.381,52.381
2,0.500,Pennington Creek Water,16-23,0,0,0,0,NaN,NaN
2,0.500,Pennington Creek Water,23-5,0,0,0,0,NaN,NaN
2,0.500,Guinni,16-23,0,0,0,0,NaN,NaN
2,0.500,Guinni,23-5,0,2,0,2,0.000,0.000
2,0.500,Racoon,16-23,2,3,0,5,40.000,40.000
2,0.500,Racoon,23-5,0,7,0,7,0.000,0.000
2,0.500,Hu,16-23,15,7,0,22,68.182,68.182
2,0.500,Hu,23-5,21,5,0,26,80.769,80.769
2,0.500,Cw and Dg,16-23,5,6,0,11,45.455,45.455
2,0.500,Cw and Dg,23-5,14,8,0,22,63.636,63.636
2,0.500,Red Wind Blackbird,16-23,0,1,0,1,0.000,0.000
2,0.500,Red Wind Blackbird,23-5,0,2,0,2,0.000,0.000
2,0.500,Tree Swallow,16-23,2,7,0,9,22.222,22.222
2,0.500,Tree Swallow,23-5,0,6,0,6,0.000,0.000
2,0.500,Turkey Vulture,16-23,0,4,0,4,0.000,0.000
2,0.500,Turkey Vulture,23-5,0,4,0,4,0.000,0.000
2,0.500,Dg,16-23,13,21,0,34,38.235,38.235
2,0.500,Dg,23-5,29,20,0,49,59.184,59.184
2,0.500,Western Kingbird,16-23,0,3,0,3,0.000,0.000
2,0.500,Western Kingbird,23-5,0,2,0,2,0.000,0.000
2,0.500,White Crowned Sparrow,16-23,13,13,0,26,50.000,50.000
2,0.500,White Crowned Sparrow,23-5,8,27,0,35,22.857,22.857
2,0.500,Eared Grebe,16-23,0,0,0,0,NaN,NaN
2,0.500,Eared Grebe,23-5,3,12,0,15,20.000,20.000
2,0.500,cougar,16-23,0,1,0,1,0.000,0.000
2,0.500,cougar,23-5,0,0,0,0,NaN,NaN
2,0.500,Ocean Water,16-23,0,0,0,0,NaN,NaN
2,0.500,Ocean Water,23-5,0,0,0,0,NaN,NaN
2,0.500,Red Tailed Hawk,16-23,2,2,0,4,50.000,50.000
2,0.500,Red Tailed Hawk,23-5,0,14,0,14,0.000,0.000
2,0.500,Dog,16-23,89,107,0,196,45.408,45.408
2,0.500,Dog,23-5,135,175,0,310,43.548,43.548
2,0.500,Human,16-23,1725,553,0,2278,75.724,75.724
2,0.500,Human,23-5,2168,441,0,2609,83.097,83.097
2,0.500,Wild Turkey,16-23,15,85,0,100,15.000,15.000
2,0.500,Wild Turkey,23-5,17,87,0,104,16.346,16.346
2,0.500,Clark Grebe,16-23,0,0,0,0,NaN,NaN
2,0.500,Clark Grebe,23-5,0,3,0,3,0.000,0.000
2,0.500,Seagull,16-23,0,0,0,0,NaN,NaN
2,0.500,Seagull,23-5,22,11,0,33,66.667,66.667
2,0.500,Surf Scoter,16-23,0,0,0,0,NaN,NaN
2,0.500,Surf Scoter,23-5,0,4,0,4,0.000,0.000
2,0.500,Pigeon,16-23,118,224,0,342,34.503,34.503
2,0.500,Pigeon,23-5,139,438,0,577,24.090,24.090
2,0.500,Pacific Ocean Water,16-23,0,0,0,0,NaN,NaN
2,0.500,Pacific Ocean Water,23-5,0,0,0,0,NaN,NaN
2,0.500,Cat,16-23,46,43,0,89,51.685,51.685
2,0.500,Cat,23-5,43,68,0,111,38.739,38.739
2,0.500,Horse,16-23,23,76,0,99,23.232,23.232
2,0.500,Horse,23-5,54,358,0,412,13.107,13.107
2,0.500,orangutan,16-23,0,0,0,0,NaN,NaN
2,0.500,orangutan,23-5,0,0,0,0,NaN,NaN
2,0.500,Bat,16-23,36,11,0,47,76.596,76.596
2,0.500,Bat,23-5,37,20,0,57,64.912,64.912
2,0.500,Deer,16-23,15,29,0,44,34.091,34.091
2,0.500,Deer,23-5,18,69,0,87,20.690,20.690
2,0.500,Great Horned Owl,16-23,0,3,0,3,0.000,0.000
2,0.500,Great Horned Owl,23-5,1,14,0,15,6.667,6.667
2,0.500,Freshwater Lagoon,16-23,0,0,0,0,NaN,NaN
2,0.500,Freshwater Lagoon,23-5,0,0,0,0,NaN,NaN
2,0.500,Unknown Avian,16-23,0,0,0,0,NaN,NaN
2,0.500,Unknown Avian,23-5,0,2,0,2,0.000,0.000
2,0.500,Human UTI,16-23,97,96,0,193,50.259,50.259
2,0.500,Human UTI,23-5,114,85,0,199,57.286,57.286
2,0.500,unknown,16-23,1,16,0,17,5.882,5.882
2,0.500,unknown,23-5,5,17,0,22,22.727,22.727
2,0.500,SLO Creek Water,16-23,0,0,0,0,NaN,NaN
2,0.500,SLO Creek Water,23-5,8,1,0,9,88.889,88.889
2,0.500,Pig/Swine,16-23,12,21,0,33,36.364,36.364
2,0.500,Pig/Swine,23-5,7,9,0,16,43.750,43.750
2,0.500,Klebsiella,16-23,0,0,0,0,NaN,NaN
2,0.500,Klebsiella,23-5,0,0,0,0,NaN,NaN
2,0.500,Hu Cw and Dg,16-23,19,27,0,46,41.304,41.304
2,0.500,Hu Cw and Dg,23-5,35,33,0,68,51.471,51.471
2,0.500,Ground Squirrel,16-23,122,141,0,263,46.388,46.388
2,0.500,Ground Squirrel,23-5,116,157,0,273,42.491,42.491
2,0.500,Opossum,16-23,2,1,0,3,66.667,66.667
2,0.500,Opossum,23-5,2,9,0,11,18.182,18.182
2,0.500,Cow,16-23,1360,591,0,1951,69.708,69.708
2,0.500,Cow,23-5,1340,626,0,1966,68.159,68.159
2,0.500,Deer Mouse,16-23,0,0,0,0,NaN,NaN
2,0.500,Deer Mouse,23-5,0,0,0,0,NaN,NaN
2,0.500,OVERALL,16-23,3932,2416,0,6348,61.941,61.941
2,0.500,OVERALL,23-5,4556,3054,0,7610,59.869,59.869
2,0.900,Chicken,16-23,20,45,0,65,30.769,30.769
2,0.900,Chicken,23-5,27,27,0,54,50.000,50.000
2,0.900,Sea Lion,16-23,2,1,0,3,66.667,66.667
2,0.900,Sea Lion,23-5,4,5,0,9,44.444,44.444
2,0.900,Hu and Cw,16-23,24,37,0,61,39.344,39.344
2,0.900,Hu and Cw,23-5,15,49,0,64,23.438,23.438
2,0.900,Sheep,16-23,82,102,0,184,44.565,44.565
2,0.900,Sheep,23-5,76,59,0,135,56.296,56.296
2,0.900,Hu and Dg,16-23,8,23,0,31,25.806,25.806
2,0.900,Hu and Dg,23-5,18,15,0,33,54.545,54.545
2,0.900,Common Loon,16-23,0,0,0,0,NaN,NaN
2,0.900,Common Loon,23-5,0,6,0,6,0.000,0.000
2,0.900,Red-Winged Blackbird,16-23,2,6,0,8,25.000,25.000
2,0.900,Red-Winged Blackbird,23-5,1,8,0,9,11.111,11.111
2,0.900,Cw,16-23,14,20,0,34,41.176,41.176
2,0.900,Cw,23-5,37,55,0,92,40.217,40.217
2,0.900,Cliff Sparrow,16-23,20,46,0,66,30.303,30.303
2,0.900,Cliff Sparrow,23-5,12,56,0,68,17.647,17.647
2,0.900,Pig,16-23,19,24,0,43,44.186,44.186
2,0.900,Pig,23-5,19,25,0,44,43.182,43.182
2,0.900,Barn Owl,16-23,0,0,0,0,NaN,NaN
2,0.900,Barn Owl,23-5,0,3,0,3,0.000,0.000
2,0.900,Wild Pig,16-23,9,20,0,29,31.034,31.034
2,0.900,Wild Pig,23-5,11,10,0,21,52.381,52.381
2,0.900,Pennington Creek Water,16-23,0,0,0,0,NaN,NaN
2,0.900,Pennington Creek Water,23-5,0,0,0,0,NaN,NaN
2,0.900,Guinni,16-23,0,0,0,0,NaN,NaN
2,0.900,Guinni,23-5,0,2,0,2,0.000,0.000
2,0.900,Racoon,16-23,2,3,0,5,40.000,40.000
2,0.900,Racoon,23-5,0,7,0,7,0.000,0.000
2,0.900,Hu,16-23,15,7,0,22,68.182,68.182
2,0.900,Hu,23-5,21,5,0,26,80.769,80.769
2,0.900,Cw and Dg,16-23,5,6,0,11,45.455,45.455
2,0.900,Cw and Dg,23-5,14,8,0,22,63.636,63.636
2,0.900,Red Wind Blackbird,16-23,0,1,0,1,0.000,0.000
2,0.900,Red Wind Blackbird,23-5,0,2,0,2,0.000,0.000
2,0.900,Tree Swallow,16-23,2,7,0,9,22.222,22.222
2,0.900,Tree Swallow,23-5,0,6,0,6,0.000,0.000
2,0.900,Turkey Vulture,16-23,0,4,0,4,0.000,0.000
2,0.900,Turkey Vulture,23-5,0,4,0,4,0.000,0.000
2,0.900,Dg,16-23,13,21,0,34,38.235,38.235
2,0.900,Dg,23-5,29,20,0,49,59.184,59.184
2,0.900,Western Kingbird,16-23,0,3,0,3,0.000,0.000
2,0.900,Western Kingbird,23-5,0,2,0,2,0.000,0.000
2,0.900,White Crowned Sparrow,16-23,13,13,0,26,50.000,50.000
2,0.900,White Crowned Sparrow,23-5,8,27,0,35,22.857,22.857
2,0.900,Eared Grebe,16-23,0,0,0,0,NaN,NaN
2,0.900,Eared Grebe,23-5,3,12,0,15,20.000,20.000
2,0.900,cougar,16-23,0,1,0,1,0.000,0.000
2,0.900,cougar,23-5,0,0,0,0,NaN,NaN
2,0.900,Ocean Water,16-23,0,0,0,0,NaN,NaN
2,0.900,Ocean Water,23-5,0,0,0,0,NaN,NaN
2,0.900,Red Tailed Hawk,16-23,2,2,0,4,50.000,50.000
2,0.900,Red Tailed Hawk,23-5,0,14,0,14,0.000,0.000
2,0.900,Dog,16-23,89,107,0,196,45.408,45.408
2,0.900,Dog,23-5,135,173,0,308,43.831,43.831
2,0.900,Human,16-23,1725,549,0,2274,75.858,75.858
2,0.900,Human,23-5,2168,436,0,2604,83.257,83.257
2,0.900,Wild Turkey,16-23,15,85,0,100,15.000,15.000
2,0.900,Wild Turkey,23-5,17,87,0,104,16.346,16.346
2,0.900,Clark Grebe,16-23,0,0,0,0,NaN,NaN
2,0.900,Clark Grebe,23-5,0,3,0,3,0.000,0.000
2,0.900,Seagull,16-23,0,0,0,0,NaN,NaN
2,0.900,Seagull,23-5,22,11,0,33,66.667,66.667
2,0.900,Surf Scoter,16-23,0,0,0,0,NaN,NaN
2,0.900,Surf Scoter,23-5,0,4,0,4,0.000,0.000
2,0.900,Pigeon,16-23,118,224,0,342,34.503,34.503
2,0.900,Pigeon,23-5,139,438,0,577,24.090,24.090
2,0.900,Pacific Ocean Water,16-23,0,0,0,0,NaN,NaN
2,0.900,Pacific Ocean Water,23-5,0,0,0,0,NaN,NaN
2,0.900,Cat,16-23,46,43,0,89,51.685,51.685
2,0.900,Cat,23-5,43,68,0,111,38.739,38.739
2,0.900,Horse,16-23,23,76,0,99,23.232,23.232
2,0.900,Horse,23-5,54,358,0,412,13.107,13.107
2,0.900,orangutan,16-23,0,0,0,0,NaN,NaN
2,0.900,orangutan,23-5,0,0,0,0,NaN,NaN
2,0.900,Bat,16-23,36,11,0,47,76.596,76.596
2,0.900,Bat,23-5,37,20,0,57,64.912,64.912
2,0.900,Deer,16-23,15,29,0,44,34.091,34.091
2,0.900,Deer,23-5,18,69,0,87,20.690,20.690
2,0.900,Great Horned Owl,16-23,0,3,0,3,0.000,0.000
2,0.900,Great Horned Owl,23-5,1,14,0,15,6.667,6.667
2,0.900,Freshwater Lagoon,16-23,0,0,0,0,NaN,NaN
2,0.900,Freshwater Lagoon,23-5,0,0,0,0,NaN,NaN
2,0.900,Unknown Avian,16-23,0,0,0,0,NaN,NaN
2,0.900,Unknown Avian,23-5,0,2,0,2,0.000,0.000
2,0.900,Human UTI,16-23,97,96,0,193,50.259,50.259
2,0.900,Human UTI,23-5,114,85,0,199,57.286,57.286
2,0.900,unknown,16-23,1,16,0,17,5.882,5.882
2,0.900,unknown,23-5,5,17,0,22,22.727,22.727
2,0.900,SLO Creek Water,16-23,0,0,0,0,NaN,NaN
2,0.900,SLO Creek Water,23-5,8,1,0,9,88.889,88.889
2,0.900,Pig/Swine,16-23,12,21,0,33,36.364,36.364
2,0.900,Pig/Swine,23-5,7,9,0,16,43.750,43.750
2,0.900,Klebsiella,16-23,0,0,0,0,NaN,NaN
2,0.900,Klebsiella,23-5,0,0,0,0,NaN,NaN
2,0.900,Hu Cw and Dg,16-23,19,27,0,46,41.304,41.304
2,0.900,Hu Cw and Dg,23-5,35,33,0,68,51.471,51.471
2,0.900,Ground Squirrel,16-23,122,141,0,263,46.388,46.388
2,0.900,Ground Squirrel,23-5,116,157,0,273,42.491,42.491
2,0.900,Opossum,16-23,2,1,0,3,66.667,66.667
2,0.900,Opossum,23-5,2,9,0,11,18.182,18.182
2,0.900,Cow,16-23,1360,591,0,1951,69.708,69.708
2,0.900,Cow,23-5,1340,625,0,1965,68.193,68.193
2,0.900,Deer Mouse,16-23,0,0,0,0,NaN,NaN
2,0.900,Deer Mouse,23-5,0,0,0,0,NaN,NaN
2,0.900,OVERALL,16-23,3932,2412,0,6344,61.980,61.980
2,0.900,OVERALL,23-5,4556,3046,0,7602,59.932,59.932
2,0.950,Chicken,16-23,20,45,0,65,30.769,30.769
2,0.950,Chicken,23-5,27,27,0,54,50.000,50.000
2,0.950,Sea Lion,16-23,2,1,0,3,66.667,66.667
2,0.950,Sea Lion,23-5,4,5,0,9,44.444,44.444
2,0.950,Hu and Cw,16-23,24,37,0,61,39.344,39.344
2,0.950,Hu and Cw,23-5,15,49,0,64,23.438,23.438
2,0.950,Sheep,16-23,82,102,0,184,44.565,44.565
2,0.950,Sheep,23-5,76,59,0,135,56.296,56.296
2,0.950,Hu and Dg,16-23,8,23,0,31,25.806,25.806
2,0.950,Hu and Dg,23-5,18,15,0,33,54.545,54.545
2,0.950,Common Loon,16-23,0,0,0,0,NaN,NaN
2,0.950,Common Loon,23-5,0,6,0,6,0.000,0.000
2,0.950,Red-Winged Blackbird,16-23,2,6,0,8,25.000,25.000
2,0.950,Red-Winged Blackbird,23-5,1,8,0,9,11.111,11.111
2,0.950,Cw,16-23,14,20,0,34,41.176,41.176
2,0.950,Cw,23-5,37,55,0,92,40.217,40.217
2,0.950,Cliff Sparrow,16-23,20,46,0,66,30.303,30.303
2,0.950,Cliff Sparrow,23-5,12,56,0,68,17.647,17.647
2,0.950,Pig,16-23,19,24,0,43,44.186,44.186
2,0.950,Pig,23-5,19,25,0,44,43.182,43.182
2,0.950,Barn Owl,16-23,0,0,0,0,NaN,NaN
2,0.950,Barn Owl,23-5,0,3,0,3,0.000,0.000
2,0.950,Wild Pig,16-23,9,20,0,29,31.034,31.034
2,0.950,Wild Pig,23-5,11,9,0,20,55.000,55.000
2,0.950,Pennington Creek Water,16-23,0,0,0,0,NaN,NaN
2,0.950,Pennington Creek Water,23-5,0,0,0,0,NaN,NaN
2,0.950,Guinni,16-23,0,0,0,0,NaN,NaN
2,0.950,Guinni,23-5,0,2,0,2,0.000,0.000
2,0.950,Racoon,16-23,2,3,0,5,40.000,40.000
2,0.950,Racoon,23-5,0,7,0,7,0.000,0.000
2,0.950,Hu,16-23,15,7,0,22,68.182,68.182
2,0.950,Hu,23-5,21,5,0,26,80.769,80.769
2,0.950,Cw and Dg,16-23,5,6,0,11,45.455,45.455
2,0.950,Cw and Dg,23-5,14,8,0,22,63.636,63.636
2,0.950,Red Wind Blackbird,16-23,0,1,0,1,0.000,0.000
2,0.950,Red Wind Blackbird,23-5,0,2,0,2,0.000,0.000
2,0.950,Tree Swallow,16-23,2,7,0,9,22.222,22.222
2,0.950,Tree Swallow,23-5,0,6,0,6,0.000,0.000
2,0.950,Turkey Vulture,16-23,0,4,0,4,0.000,0.000
2,0.950,Turkey Vulture,23-5,0,4,0,4,0.000,0.000
2,0.950,Dg,16-23,13,21,0,34,38.235,38.235
2,0.950,Dg,23-5,29,20,0,49,59.184,59.184
2,0.950,Western Kingbird,16-23,0,3,0,3,0.000,0.000
2,0.950,Western Kingbird,23-5,0,2,0,2,0.000,0.000
2,0.950,White Crowned Sparrow,16-23,13,13,0,26,50.000,50.000
2,0.950,White Crowned Sparrow,23-5,8,27,0,35,22.857,22.857
2,0.950,Eared Grebe,16-23,0,0,0,0,NaN,NaN
2,0.950,Eared Grebe,23-5,3,12,0,15,20.000,20.000
2,0.950,cougar,16-23,0,1,0,1,0.000,0.000
2,0.950,cougar,23-5,0,0,0,0,NaN,NaN
2,0.950,Ocean Water,16-23,0,0,0,0,NaN,NaN
2,0.950,Ocean Water,23-5,0,0,0,0,NaN,NaN
2,0.950,Red Tailed Hawk,16-23,2,2,0,4,50.000,50.000
2,0.950,Red Tailed Hawk,23-5,0,14,0,14,0.000,0.000
2,0.950,Dog,16-23,89,107,0,196,45.408,45.408
2,0.950,Dog,23-5,135,173,0,308,43.831,43.831
2,0.950,Human,16-23,1725,547,0,2272,75.924,75.924
2,0.950,Human,23-5,2169,430,0,2599,83.455,83.455
2,0.950,Wild Turkey,16-23,15,85,0,100,15.000,15.000
2,0.950,Wild Turkey,23-5,17,87,0,104,16.346,16.346
2,0.950,Clark Grebe,16-23,0,0,0,0,NaN,NaN
2,0.950,Clark Grebe,23-5,0,3,0,3,0.000,0.000
2,0.950,Seagull,16-23,0,0,0,0,NaN,NaN
2,0.950,Seagull,23-5,22,10,0,32,68.750,68.750
2,0.950,Surf Scoter,16-23,0,0,0,0,NaN,NaN
2,0.950,Surf Scoter,23-5,0,2,0,2,0.000,0.000
2,0.950,Pigeon,16-23,118,223,0,341,34.604,34.604
2,0.950,Pigeon,23-5,139,438,0,577,24.090,24.090
2,0.950,Pacific Ocean Water,16-23,0,0,0,0,NaN,NaN
2,0.950,Pacific Ocean Water,23-5,0,0,0,0,NaN,NaN
2,0.950,Cat,16-23,46,43,0,89,51.685,51.685
2,0.950,Cat,23-5,43,68,0,111,38.739,38.739
2,0.950,Horse,16-23,23,76,0,99,23.232,23.232
2,0.950,Horse,23-5,54,358,0,412,13.107,13.107
2,0.950,orangutan,16-23,0,0,0,0,NaN,NaN
2,0.950,orangutan,23-5,0,0,0,0,NaN,NaN
2,0.950,Bat,16-23,36,11,0,47,76.596,76.596
2,0.950,Bat,23-5,37,20,0,57,64.912,64.912
2,0.950,Deer,16-23,15,29,0,44,34.091,34.091
2,0.950,Deer,23-5,18,69,0,87,20.690,20.690
2,0.950,Great Horned Owl,16-23,0,3,0,3,0.000,0.000
2,0.950,Great Horned Owl,23-5,1,14,0,15,6.667,6.667
2,0.950,Freshwater Lagoon,16-23,0,0,0,0,NaN,NaN
2,0.950,Freshwater Lagoon,23-5,0,0,0,0,NaN,NaN
2,0.950,Unknown Avian,16-23,0,0,0,0,NaN,NaN
2,0.950,Unknown Avian,23-5,0,2,0,2,0.000,0.000
2,0.950,Human UTI,16-23,97,96,0,193,50.259,50.259
2,0.950,Human UTI,23-5,113,85,0,198,57.071,57.071
2,0.950,unknown,16-23,1,16,0,17,5.882,5.882
2,0.950,unknown,23-5,5,17,0,22,22.727,22.727
2,0.950,SLO Creek Water,16-23,0,0,0,0,NaN,NaN
2,0.950,SLO Creek Water,23-5,8,1,0,9,88.889,88.889
2,0.950,Pig/Swine,16-23,12,21,0,33,36.364,36.364
2,0.950,Pig/Swine,23-5,7,9,0,16,43.750,43.750
2,0.950,Klebsiella,16-23,0,0,0,0,NaN,NaN
2,0.950,Klebsiella,23-5,0,0,0,0,NaN,NaN
2,0.950,Hu Cw and Dg,16-23,19,27,0,46,41.304,41.304
2,0.950,Hu Cw and Dg,23-5,35,33,0,68,51.471,51.471
2,0.950,Ground Squirrel,16-23,122,141,0,263,46.388,46.388
2,0.950,Ground Squirrel,23-5,116,154,0,270,42.963,42.963
2,0.950,Opossum,16-23,2,1,0,3,66.667,66.667
2,0.950,Opossum,23-5,2,9,0,11,18.182,18.182
2,0.950,Cow,16-23,1360,577,0,1937,70.212,70.212
2,0.950,Cow,23-5,1339,625,0,1964,68.177,68.177
2,0.950,Deer Mouse,16-23,0,0,0,0,NaN,NaN
2,0.950,Deer Mouse,23-5,0,0,0,0,NaN,NaN
2,0.950,OVERALL,16-23,3932,2395,0,6327,62.146,62.146
2,0.950,OVERALL,23-5,4555,3033,0,7588,60.029,60.029
2,0.960,Chicken,16-23,20,45,0,65,30.769,30.769
2,0.960,Chicken,23-5,27,27,0,54,50.000,50.000
2,0.960,Sea Lion,16-23,2,1,0,3,66.667,66.667
2,0.960,Sea Lion,23-5,4,5,0,9,44.444,44.444
2,0.960,Hu and Cw,16-23,24,37,0,61,39.344,39.344
2,0.960,Hu and Cw,23-5,15,49,0,64,23.438,23.438
2,0.960,Sheep,16-23,82,102,0,184,44.565,44.565
2,0.960,Sheep,23-5,76,58,0,134,56.716,56.716
2,0.960,Hu and Dg,16-23,8,23,0,31,25.806,25.806
2,0.960,Hu and Dg,23-5,18,15,0,33,54.545,54.545
2,0.960,Common Loon,16-23,0,0,0,0,NaN,NaN
2,0.960,Common Loon,23-5,0,6,0,6,0.000,0.000
2,0.960,Red-Winged Blackbird,16-23,2,6,0,8,25.000,25.000
2,0.960,Red-Winged Blackbird,23-5,1,8,0,9,11.111,11.111
2,0.960,Cw,16-23,14,20,0,34,41.176,41.176
2,0.960,Cw,23-5,37,55,0,92,40.217,40.217
2,0.960,Cliff Sparrow,16-23,20,46,0,66,30.303,30.303
2,0.960,Cliff Sparrow,23-5,12,56,0,68,17.647,17.647
2,0.960,Pig,16-23,19,24,0,43,44.186,44.186
2,0.960,Pig,23-5,19,25,0,44,43.182,43.182
2,0.960,Barn Owl,16-23,0,0,0,0,NaN,NaN
2,0.960,Barn Owl,23-5,0,3,0,3,0.000,0.000
2,0.960,Wild Pig,16-23,9,20,0,29,31.034,31.034
2,0.960,Wild Pig,23-5,11,9,0,20,55.000,55.000
2,0.960,Pennington Creek Water,16-23,0,0,0,0,NaN,NaN
2,0.960,Pennington Creek Water,23-5,0,0,0,0,NaN,NaN
2,0.960,Guinni,16-23,0,0,0,0,NaN,NaN
2,0.960,Guinni,23-5,0,2,0,2,0.000,0.000
2,0.960,Racoon,16-23,2,3,0,5,40.000,40.000
2,0.960,Racoon,23-5,0,7,0,7,0.000,0.000
2,0.960,Hu,16-23,15,7,0,22,68.182,68.182
2,0.960,Hu,23-5,21,5,0,26,80.769,80.769
2,0.960,Cw and Dg,16-23,5,6,0,11,45.455,45.455
2,0.960,Cw and Dg,23-5,14,8,0,22,63.636,63.636
2,0.960,Red Wind Blackbird,16-23,0,1,0,1,0.000,0.000
2,0.960,Red Wind Blackbird,23-5,0,2,0,2,0.000,0.000
2,0.960,Tree Swallow,16-23,2,7,0,9,22.222,22.222
2,0.960,Tree Swallow,23-5,0,6,0,6,0.000,0.000
2,0.960,Turkey Vulture,16-23,0,4,0,4,0.000,0.000
2,0.960,Turkey Vulture,23-5,0,4,0,4,0.000,0.000
2,0.960,Dg,16-23,13,21,0,34,38.235,38.235
2,0.960,Dg,23-5,29,20,0,49,59.184,59.184
2,0.960,Western Kingbird,16-23,0,3,0,3,0.000,0.000
2,0.960,Western Kingbird,23-5,0,2,0,2,0.000,0.000
2,0.960,White Crowned Sparrow,16-23,13,13,0,26,50.000,50.000
2,0.960,White Crowned Sparrow,23-5,8,27,0,35,22.857,22.857
2,0.960,Eared Grebe,16-23,0,0,0,0,NaN,NaN
2,0.960,Eared Grebe,23-5,3,12,0,15,20.000,20.000
2,0.960,cougar,16-23,0,1,0,1,0.000,0.000
2,0.960,cougar,23-5,0,0,0,0,NaN,NaN
2,0.960,Ocean Water,16-23,0,0,0,0,NaN,NaN
2,0.960,Ocean Water,23-5,0,0,0,0,NaN,NaN
2,0.960,Red Tailed Hawk,16-23,2,2,0,4,50.000,50.000
2,0.960,Red Tailed Hawk,23-5,0,14,0,14,0.000,0.000
2,0.960,Dog,16-23,89,107,0,196,45.408,45.408
2,0.960,Dog,23-5,135,171,0,306,44.118,44.118
2,0.960,Human,16-23,1725,545,0,2270,75.991,75.991
2,0.960,Human,23-5,2170,422,0,2592,83.719,83.719
2,0.960,Wild Turkey,16-23,15,85,0,100,15.000,15.000
2,0.960,Wild Turkey,23-5,17,87,0,104,16.346,16.346
2,0.960,Clark Grebe,16-23,0,0,0,0,NaN,NaN
2,0.960,Clark Grebe,23-5,0,3,0,3,0.000,0.000
2,0.960,Seagull,16-23,0,0,0,0,NaN,NaN
2,0.960,Seagull,23-5,22,10,0,32,68.750,68.750
2,0.960,Surf Scoter,16-23,0,0,0,0,NaN,NaN
2,0.960,Surf Scoter,23-5,0,2,0,2,0.000,0.000
2,0.960,Pigeon,16-23,118,223,0,341,34.604,34.604
2,0.960,Pigeon,23-5,139,438,0,577,24.090,24.090
2,0.960,Pacific Ocean Water,16-23,0,0,0,0,NaN,NaN
2,0.960,Pacific Ocean Water,23-5,0,0,0,0,NaN,NaN
2,0.960,Cat,16-23,46,43,0,89,51.685,51.685
2,0.960,Cat,23-5,43,68,0,111,38.739,38.739
2,0.960,Horse,16-23,23,76,0,99,23.232,23.232
2,0.960,Horse,23-5,54,358,0,412,13.107,13.107
2,0.960,orangutan,16-23,0,0,0,0,NaN,NaN
2,0.960,orangutan,23-5,0,0,0,0,NaN,NaN
2,0.960,Bat,16-23,36,11,0,47,76.596,76.596
2,0.960,Bat,23-5,37,20,0,57,64.912,64.912
2,0.960,Deer,16-23,15,29,0,44,34.091,34.091
2,0.960,Deer,23-5,18,69,0,87,20.690,20.690
2,0.960,Great Horned Owl,16-23,0,3,0,3,0.000,0.000
2,0.960,Great Horned Owl,23-5,1,14,0,15,6.667,6.667
2,0.960,Freshwater Lagoon,16-23,0,0,0,0,NaN,NaN
2,0.960,Freshwater Lagoon,23-5,0,0,0,0,NaN,NaN
2,0.960,Unknown Avian,16-23,0,0,0,0,NaN,NaN
2,0.960,Unknown Avian,23-5,0,2,0,2,0.000,0.000
2,0.960,Human UTI,16-23,97,96,0,193,50.259,50.259
2,0.960,Human UTI,23-5,113,85,0,198,57.071,57.071
2,0.960,unknown,16-23,1,16,0,17,5.882,5.882
2,0.960,unknown,23-5,5,17,0,22,22.727,22.727
2,0.960,SLO Creek Water,16-23,0,0,0,0,NaN,NaN
2,0.960,SLO Creek Water,23-5,8,1,0,9,88.889,88.889
2,0.960,Pig/Swine,16-23,12,21,0,33,36.364,36.364
2,0.960,Pig/Swine,23-5,7,9,0,16,43.750,43.750
2,0.960,Klebsiella,16-23,0,0,0,0,NaN,NaN
2,0.960,Klebsiella,23-5,0,0,0,0,NaN,NaN
2,0.960,Hu Cw and Dg,16-23,19,27,0,46,41.304,41.304
2,0.960,Hu Cw and Dg,23-5,35,33,0,68,51.471,51.471
2,0.960,Ground Squirrel,16-23,122,141,0,263,46.388,46.388
2,0.960,Ground Squirrel,23-5,116,153,0,269,43.123,43.123
2,0.960,Opossum,16-23,2,1,0,3,66.667,66.667
2,0.960,Opossum,23-5,2,9,0,11,18.182,18.182
2,0.960,Cow,16-23,1358,570,0,1928,70.436,70.436
2,0.960,Cow,23-5,1339,625,0,1964,68.177,68.177
2,0.960,Deer Mouse,16-23,0,0,0,0,NaN,NaN
2,0.960,Deer Mouse,23-5,0,0,0,0,NaN,NaN
2,0.960,OVERALL,16-23,3930,2386,0,6316,62.223,62.223
2,0.960,OVERALL,23-5,4556,3021,0,7577,60.129,60.129
2,0.970,Chicken,16-23,20,45,0,65,30.769,30.769
2,0.970,Chicken,23-5,27,27,0,54,50.000,50.000
2,0.970,Sea Lion,16-23,2,1,0,3,66.667,66.667
2,0.970,Sea Lion,23-5,4,5,0,9,44.444,44.444
2,0.970,Hu and Cw,16-23,24,37,0,61,39.344,39.344
2,0.970,Hu and Cw,23-5,15,49,0,64,23.438,23.438
2,0.970,Sheep,16-23,82,102,0,184,44.565,44.565
2,0.970,Sheep,23-5,76,57,0,133,57.143,57.143
2,0.970,Hu and Dg,16-23,8,23,0,31,25.806,25.806
2,0.970,Hu and Dg,23-5,18,15,0,33,54.545,54.545
2,0.970,Common Loon,16-23,0,0,0,0,NaN,NaN
2,0.970,Common Loon,23-5,0,6,0,6,0.000,0.000
2,0.970,Red-Winged Blackbird,16-23,2,6,0,8,25.000,25.000
2,0.970,Red-Winged Blackbird,23-5,1,8,0,9,11.111,11.111
2,0.970,Cw,16-23,14,20,0,34,41.176,41.176
2,0.970,Cw,23-5,37,55,0,92,40.217,40.217
2,0.970,Cliff Sparrow,16-23,20,46,0,66,30.303,30.303
2,0.970,Cliff Sparrow,23-5,12,56,0,68,17.647,17.647
2,0.970,Pig,16-23,19,24,0,43,44.186,44.186
2,0.970,Pig,23-5,19,25,0,44,43.182,43.182
2,0.970,Barn Owl,16-23,0,0,0,0,NaN,NaN
2,0.970,Barn Owl,23-5,0,3,0,3,0.000,0.000
2,0.970,Wild Pig,16-23,9,20,0,29,31.034,31.034
2,0.970,Wild Pig,23-5,10,9,0,19,52.632,52.632
2,0.970,Pennington Creek Water,16-23,0,0,0,0,NaN,NaN
2,0.970,Pennington Creek Water,23-5,0,0,0,0,NaN,NaN
2,0.970,Guinni,16-23,0,0,0,0,NaN,NaN
2,0.970,Guinni,23-5,0,2,0,2,0.000,0.000
2,0.970,Racoon,16-23,2,3,0,5,40.000,40.000
2,0.970,Racoon,23-5,0,7,0,7,0.000,0.000
2,0.970,Hu,16-23,15,7,0,22,68.182,68.182
2,0.970,Hu,23-5,21,5,0,26,80.769,80.769
2,0.970,Cw and Dg,16-23,5,6,0,11,45.455,45.455
2,0.970,Cw and Dg,23-5,14,8,0,22,63.636,63.636
2,0.970,Red Wind Blackbird,16-23,0,1,0,1,0.000,0.000
2,0.970,Red Wind Blackbird,23-5,0,2,0,2,0.000,0.000
2,0.970,Tree Swallow,16-23,2,7,0,9,22.222,22.222
2,0.970,Tree Swallow,23-5,0,6,0,6,0.000,0.000
2,0.970,Turkey Vulture,16-23,0,4,0,4,0.000,0.000
2,0.970,Turkey Vulture,23-5,0,4,0,4,0.000,0.000
2,0.970,Dg,16-23,13,21,0,34,38.235,38.235
2,0.970,Dg,23-5,29,19,0,48,60.417,60.417
2,0.970,Western Kingbird,16-23,0,3,0,3,0.000,0.000
2,0.970,Western Kingbird,23-5,0,2,0,2,0.000,0.000
2,0.970,White Crowned Sparrow,16-23,13,13,0,26,50.000,50.000
2,0.970,White Crowned Sparrow,23-5,8,27,0,35,22.857,22.857
2,0.970,Eared Grebe,16-23,0,0,0,0,NaN,NaN
2,0.970,Eared Grebe,23-5,3,12,0,15,20.000,20.000
2,0.970,cougar,16-23,0,1,0,1,0.000,0.000
2,0.970,cougar,23-5,0,0,0,0,NaN,NaN
2,0.970,Ocean Water,16-23,0,0,0,0,NaN,NaN
2,0.970,Ocean Water,23-5,0,0,0,0,NaN,NaN
2,0.970,Red Tailed Hawk,16-23,2,2,0,4,50.000,50.000
2,0.970,Red Tailed Hawk,23-5,0,14,0,14,0.000,0.000
2,0.970,Dog,16-23,89,107,0,196,45.408,45.408
2,0.970,Dog,23-5,135,170,0,305,44.262,44.262
2,0.970,Human,16-23,1725,541,0,2266,76.125,76.125
2,0.970,Human,23-5,2166,421,0,2587,83.726,83.726
2,0.970,Wild Turkey,16-23,15,85,0,100,15.000,15.000
2,0.970,Wild Turkey,23-5,17,83,0,100,17.000,17.000
2,0.970,Clark Grebe,16-23,0,0,0,0,NaN,NaN
2,0.970,Clark Grebe,23-5,0,3,0,3,0.000,0.000
2,0.970,Seagull,16-23,0,0,0,0,NaN,NaN
2,0.970,Seagull,23-5,22,10,0,32,68.750,68.750
2,0.970,Surf Scoter,16-23,0,0,0,0,NaN,NaN
2,0.970,Surf Scoter,23-5,0,2,0,2,0.000,0.000
2,0.970,Pigeon,16-23,116,223,0,339,34.218,34.218
2,0.970,Pigeon,23-5,139,438,0,577,24.090,24.090
2,0.970,Pacific Ocean Water,16-23,0,0,0,0,NaN,NaN
2,0.970,Pacific Ocean Water,23-5,0,0,0,0,NaN,NaN
2,0.970,Cat,16-23,46,42,0,88,52.273,52.273
2,0.970,Cat,23-5,43,68,0,111,38.739,38.739
2,0.970,Horse,16-23,23,76,0,99,23.232,23.232
2,0.970,Horse,23-5,54,358,0,412,13.107,13.107
2,0.970,orangutan,16-23,0,0,0,0,NaN,NaN
2,0.970,orangutan,23-5,0,0,0,0,NaN,NaN
2,0.970,Bat,16-23,36,11,0,47,76.596,76.596
2,0.970,Bat,23-5,37,20,0,57,64.912,64.912
2,0.970,Deer,16-23,15,29,0,44,34.091,34.091
2,0.970,Deer,23-5,18,69,0,87,20.690,20.690
2,0.970,Great Horned Owl,16-23,0,3,0,3,0.000,0.000
2,0.970,Great Horned Owl,23-5,1,14,0,15,6.667,6.667
2,0.970,Freshwater Lagoon,16-23,0,0,0,0,NaN,NaN
2,0.970,Freshwater Lagoon,23-5,0,0,0,0,NaN,NaN
2,0.970,Unknown Avian,16-23,0,0,0,0,NaN,NaN
2,0.970,Unknown Avian,23-5,0,2,0,2,0.000,0.000
2,0.970,Human UTI,16-23,98,96,0,194,50.515,50.515
2,0.970,Human UTI,23-5,111,86,0,197,56.345,56.345
2,0.970,unknown,16-23,1,16,0,17,5.882,5.882
2,0.970,unknown,23-5,5,17,0,22,22.727,22.727
2,0.970,SLO Creek Water,16-23,0,0,0,0,NaN,NaN
2,0.970,SLO Creek Water,23-5,8,1,0,9,88.889,88.889
2,0.970,Pig/Swine,16-23,12,21,0,33,36.364,36.364
2,0.970,Pig/Swine,23-5,7,9,0,16,43.750,43.750
2,0.970,Klebsiella,16-23,0,0,0,0,NaN,NaN
2,0.970,Klebsiella,23-5,0,0,0,0,NaN,NaN
2,0.970,Hu Cw and Dg,16-23,19,27,0,46,41.304,41.304
2,0.970,Hu Cw and Dg,23-5,35,33,0,68,51.471,51.471
2,0.970,Ground Squirrel,16-23,121,139,0,260,46.538,46.538
2,0.970,Ground Squirrel,23-5,116,151,0,267,43.446,43.446
2,0.970,Opossum,16-23,2,1,0,3,66.667,66.667
2,0.970,Opossum,23-5,2,9,0,11,18.182,18.182
2,0.970,Cow,16-23,1355,572,0,1927,70.317,70.317
2,0.970,Cow,23-5,1338,621,0,1959,68.300,68.300
2,0.970,Deer Mouse,16-23,0,0,0,0,NaN,NaN
2,0.970,Deer Mouse,23-5,0,0,0,0,NaN,NaN
2,0.970,OVERALL,16-23,3925,2381,0,6306,62.242,62.242
2,0.970,OVERALL,23-5,4548,3008,0,7556,60.191,60.191
2,0.980,Chicken,16-23,20,45,0,65,30.769,30.769
2,0.980,Chicken,23-5,27,27,0,54,50.000,50.000
2,0.980,Sea Lion,16-23,2,1,0,3,66.667,66.667
2,0.980,Sea Lion,23-5,4,5,0,9,44.444,44.444
2,0.980,Hu and Cw,16-23,24,37,0,61,39.344,39.344
2,0.980,Hu and Cw,23-5,15,49,0,64,23.438,23.438
2,0.980,Sheep,16-23,82,100,0,182,45.055,45.055
2,0.980,Sheep,23-5,75,56,0,131,57.252,57.252
2,0.980,Hu and Dg,16-23,8,23,0,31,25.806,25.806
2,0.980,Hu and Dg,23-5,18,15,0,33,54.545,54.545
2,0.980,Common Loon,16-23,0,0,0,0,NaN,NaN
2,0.980,Common Loon,23-5,0,5,0,5,0.000,0.000
2,0.980,Red-Winged Blackbird,16-23,2,6,0,8,25.000,25.000
2,0.980,Red-Winged Blackbird,23-5,1,8,0,9,11.111,11.111
2,0.980,Cw,16-23,14,19,0,33,42.424,42.424
2,0.980,Cw,23-5,37,54,0,91,40.659,40.659
2,0.980,Cliff Sparrow,16-23,20,44,0,64,31.250,31.250
2,0.980,Cliff Sparrow,23-5,12,56,0,68,17.647,17.647
2,0.980,Pig,16-23,19,24,0,43,44.186,44.186
2,0.980,Pig,23-5,19,25,0,44,43.182,43.182
2,0.980,Barn Owl,16-23,0,0,0,0,NaN,NaN
2,0.980,Barn Owl,23-5,0,3,0,3,0.000,0.000
2,0.980,Wild Pig,16-23,9,20,0,29,31.034,31.034
2,0.980,Wild Pig,23-5,10,9,0,19,52.632,52.632
2,0.980,Pennington Creek Water,16-23,0,0,0,0,NaN,NaN
2,0.980,Pennington Creek Water,23-5,0,0,0,0,NaN,NaN
2,0.980,Guinni,16-23,0,0,0,0,NaN,NaN
2,0.980,Guinni,23-5,0,2,0,2,0.000,0.000
2,0.980,Racoon,16-23,2,3,0,5,40.000,40.000
2,0.980,Racoon,23-5,0,7,0,7,0.000,0.000
2,0.980,Hu,16-23,15,7,0,22,68.182,68.182
2,0.980,Hu,23-5,21,5,0,26,80.769,80.769
2,0.980,Cw and Dg,16-23,5,6,0,11,45.455,45.455
2,0.980,Cw and Dg,23-5,14,8,0,22,63.636,63.636
2,0.980,Red Wind Blackbird,16-23,0,1,0,1,0.000,0.000
2,0.980,Red Wind Blackbird,23-5,0,2,0,2,0.000,0.000
2,0.980,Tree Swallow,16-23,2,7,0,9,22.222,22.222
2,0.980,Tree Swallow,23-5,0,6,0,6,0.000,0.000
2,0.980,Turkey Vulture,16-23,0,4,0,4,0.000,0.000
2,0.980,Turkey Vulture,23-5,0,4,0,4,0.000,0.000
2,0.980,Dg,16-23,13,21,0,34,38.235,38.235
2,0.980,Dg,23-5,29,19,0,48,60.417,60.417
2,0.980,Western Kingbird,16-23,0,3,0,3,0.000,0.000
2,0.980,Western Kingbird,23-5,0,2,0,2,0.000,0.000
2,0.980,White Crowned Sparrow,16-23,13,13,0,26,50.000,50.000
2,0.980,White Crowned Sparrow,23-5,8,27,0,35,22.857,22.857
2,0.980,Eared Grebe,16-23,0,0,0,0,NaN,NaN
2,0.980,Eared Grebe,23-5,3,12,0,15,20.000,20.000
2,0.980,cougar,16-23,0,1,0,1,0.000,0.000
2,0.980,cougar,23-5,0,0,0,0,NaN,NaN
2,0.980,Ocean Water,16-23,0,0,0,0,NaN,NaN
2,0.980,Ocean Water,23-5,0,0,0,0,NaN,NaN
2,0.980,Red Tailed Hawk,16-23,2,2,0,4,50.000,50.000
2,0.980,Red Tailed Hawk,23-5,0,13,0,13,0.000,0.000
2,0.980,Dog,16-23,88,107,0,195,45.128,45.128
2,0.980,Dog,23-5,135,168,0,303,44.554,44.554
2,0.980,Human,16-23,1722,533,0,2255,76.364,76.364
2,0.980,Human,23-5,2161,413,0,2574,83.955,83.955
2,0.980,Wild Turkey,16-23,15,85,0,100,15.000,15.000
2,0.980,Wild Turkey,23-5,17,83,0,100,17.000,17.000
2,0.980,Clark Grebe,16-23,0,0,0,0,NaN,NaN
2,0.980,Clark Grebe,23-5,0,3,0,3,0.000,0.000
2,0.980,Seagull,16-23,0,0,0,0,NaN,NaN
2,0.980,Seagull,23-5,24,8,0,32,75.000,75.000
2,0.980,Surf Scoter,16-23,0,0,0,0,NaN,NaN
2,0.980,Surf Scoter,23-5,2,0,0,2,100.000,100.000
2,0.980,Pigeon,16-23,116,221,0,337,34.421,34.421
2,0.980,Pigeon,23-5,138,433,0,571,24.168,24.168
2,0.980,Pacific Ocean Water,16-23,0,0,0,0,NaN,NaN
2,0.980,Pacific Ocean Water,23-5,0,0,0,0,NaN,NaN
2,0.980,Cat,16-23,46,42,0,88,52.273,52.273
2,0.980,Cat,23-5,43,66,0,109,39.450,39.450
2,0.980,Horse,16-23,23,76,0,99,23.232,23.232
2,0.980,Horse,23-5,54,354,0,408,13.235,13.235
2,0.980,orangutan,16-23,0,0,0,0,NaN,NaN
2,0.980,orangutan,23-5,0,0,0,0,NaN,NaN
2,0.980,Bat,16-23,36,11,0,47,76.596,76.596
2,0.980,Bat,23-5,37,20,0,57,64.912,64.912
2,0.980,Deer,16-23,15,29,0,44,34.091,34.091
2,0.980,Deer,23-5,18,69,0,87,20.690,20.690
2,0.980,Great Horned Owl,16-23,0,3,0,3,0.000,0.000
2,0.980,Great Horned Owl,23-5,1,14,0,15,6.667,6.667
2,0.980,Freshwater Lagoon,16-23,0,0,0,0,NaN,NaN
2,0.980,Freshwater Lagoon,23-5,0,0,0,0,NaN,NaN
2,0.980,Unknown Avian,16-23,0,0,0,0,NaN,NaN
2,0.980,Unknown Avian,23-5,0,2,0,2,0.000,0.000
2,0.980,Human UTI,16-23,98,94,0,192,51.042,51.042
2,0.980,Human UTI,23-5,111,83,0,194,57.216,57.216
2,0.980,unknown,16-23,1,16,0,17,5.882,5.882
2,0.980,unknown,23-5,5,17,0,22,22.727,22.727
2,0.980,SLO Creek Water,16-23,0,0,0,0,NaN,NaN
2,0.980,SLO Creek Water,23-5,8,1,0,9,88.889,88.889
2,0.980,Pig/Swine,16-23,12,20,0,32,37.500,37.500
2,0.980,Pig/Swine,23-5,7,9,0,16,43.750,43.750
2,0.980,Klebsiella,16-23,0,0,0,0,NaN,NaN
2,0.980,Klebsiella,23-5,0,0,0,0,NaN,NaN
2,0.980,Hu Cw and Dg,16-23,19,27,0,46,41.304,41.304
2,0.980,Hu Cw and Dg,23-5,35,33,0,68,51.471,51.471
2,0.980,Ground Squirrel,16-23,119,139,0,258,46.124,46.124
2,0.980,Ground Squirrel,23-5,117,148,0,265,44.151,44.151
2,0.980,Opossum,16-23,2,1,0,3,66.667,66.667
2,0.980,Opossum,23-5,2,9,0,11,18.182,18.182
2,0.980,Cow,16-23,1354,567,0,1921,70.484,70.484
2,0.980,Cow,23-5,1333,618,0,1951,68.324,68.324
2,0.980,Deer Mouse,16-23,0,0,0,0,NaN,NaN
2,0.980,Deer Mouse,23-5,0,0,0,0,NaN,NaN
2,0.980,OVERALL,16-23,3918,2358,0,6276,62.428,62.428
2,0.980,OVERALL,23-5,4541,2970,0,7511,60.458,60.458
2,0.990,Chicken,16-23,20,42,0,62,32.258,32.258
2,0.990,Chicken,23-5,27,25,0,52,51.923,51.923
2,0.990,Sea Lion,16-23,2,1,0,3,66.667,66.667
2,0.990,Sea Lion,23-5,4,5,0,9,44.444,44.444
2,0.990,Hu and Cw,16-23,23,37,0,60,38.333,38.333
2,0.990,Hu and Cw,23-5,15,46,0,61,24.590,24.590
2,0.990,Sheep,16-23,81,95,0,176,46.023,46.023
2,0.990,Sheep,23-5,75,56,0,131,57.252,57.252
2,0.990,Hu and Dg,16-23,8,23,0,31,25.806,25.806
2,0.990,Hu and Dg,23-5,18,14,0,32,56.250,56.250
2,0.990,Common Loon,16-23,0,0,0,0,NaN,NaN
2,0.990,Common Loon,23-5,0,5,0,5,0.000,0.000
2,0.990,Red-Winged Blackbird,16-23,2,5,0,7,28.571,28.571
2,0.990,Red-Winged Blackbird,23-5,1,8,0,9,11.111,11.111
2,0.990,Cw,16-23,14,19,0,33,42.424,42.424
2,0.990,Cw,23-5,37,51,0,88,42.045,42.045
2,0.990,Cliff Sparrow,16-23,20,42,0,62,32.258,32.258
2,0.990,Cliff Sparrow,23-5,12,56,0,68,17.647,17.647
2,0.990,Pig,16-23,19,23,0,42,45.238,45.238
2,0.990,Pig,23-5,19,25,0,44,43.182,43.182
2,0.990,Barn Owl,16-23,0,0,0,0,NaN,NaN
2,0.990,Barn Owl,23-5,0,2,0,2,0.000,0.000
2,0.990,Wild Pig,16-23,9,19,0,28,32.143,32.143
2,0.990,Wild Pig,23-5,10,9,0,19,52.632,52.632
2,0.990,Pennington Creek Water,16-23,0,0,0,0,NaN,NaN
2,0.990,Pennington Creek Water,23-5,0,0,0,0,NaN,NaN
2,0.990,Guinni,16-23,0,0,0,0,NaN,NaN
2,0.990,Guinni,23-5,0,1,0,1,0.000,0.000
2,0.990,Racoon,16-23,2,3,0,5,40.000,40.000
2,0.990,Racoon,23-5,0,6,0,6,0.000,0.000
2,0.990,Hu,16-23,15,6,0,21,71.429,71.429
2,0.990,Hu,23-5,21,4,0,25,84.000,84.000
2,0.990,Cw and Dg,16-23,5,6,0,11,45.455,45.455
2,0.990,Cw and Dg,23-5,14,8,0,22,63.636,63.636
2,0.990,Red Wind Blackbird,16-23,0,1,0,1,0.000,0.000
2,0.990,Red Wind Blackbird,23-5,0,2,0,2,0.000,0.000
2,0.990,Tree Swallow,16-23,2,7,0,9,22.222,22.222
2,0.990,Tree Swallow,23-5,0,6,0,6,0.000,0.000
2,0.990,Turkey Vulture,16-23,0,4,0,4,0.000,0.000
2,0.990,Turkey Vulture,23-5,0,4,0,4,0.000,0.000
2,0.990,Dg,16-23,13,21,0,34,38.235,38.235
2,0.990,Dg,23-5,29,19,0,48,60.417,60.417
2,0.990,Western Kingbird,16-23,0,3,0,3,0.000,0.000
2,0.990,Western Kingbird,23-5,0,2,0,2,0.000,0.000
2,0.990,White Crowned Sparrow,16-23,13,12,0,25,52.000,52.000
2,0.990,White Crowned Sparrow,23-5,8,26,0,34,23.529,23.529
2,0.990,Eared Grebe,16-23,0,0,0,0,NaN,NaN
2,0.990,Eared Grebe,23-5,3,11,0,14,21.429,21.429
2,0.990,cougar,16-23,0,1,0,1,0.000,0.000
2,0.990,cougar,23-5,0,0,0,0,NaN,NaN
2,0.990,Ocean Water,16-23,0,0,0,0,NaN,NaN
2,0.990,Ocean Water,23-5,0,0,0,0,NaN,NaN
2,0.990,Red Tailed Hawk,16-23,2,2,0,4,50.000,50.000
2,0.990,Red Tailed Hawk,23-5,0,13,0,13,0.000,0.000
2,0.990,Dog,16-23,88,101,0,189,46.561,46.561
2,0.990,Dog,23-5,134,161,0,295,45.424,45.424
2,0.990,Human,16-23,1705,505,0,2210,77.149,77.149
2,0.990,Human,23-5,2150,398,0,2548,84.380,84.380
2,0.990,Wild Turkey,16-23,16,74,0,90,17.778,17.778
2,0.990,Wild Turkey,23-5,14,62,0,76,18.421,18.421
2,0.990,Clark Grebe,16-23,0,0,0,0,NaN,NaN
2,0.990,Clark Grebe,23-5,2,4,0,6,33.333,33.333
2,0.990,Seagull,16-23,0,0,0,0,NaN,NaN
2,0.990,Seagull,23-5,24,8,0,32,75.000,75.000
2,0.990,Surf Scoter,16-23,0,0,0,0,NaN,NaN
2,0.990,Surf Scoter,23-5,2,0,0,2,100.000,100.000
2,0.990,Pigeon,16-23,115,210,0,325,35.385,35.385
2,0.990,Pigeon,23-5,139,402,0,541,25.693,25.693
2,0.990,Pacific Ocean Water,16-23,0,0,0,0,NaN,NaN
2,0.990,Pacific Ocean Water,23-5,0,0,0,0,NaN,NaN
2,0.990,Cat,16-23,46,39,0,85,54.118,54.118
2,0.990,Cat,23-5,42,63,0,105,40.000,40.000
2,0.990,Horse,16-23,23,73,0,96,23.958,23.958
2,0.990,Horse,23-5,53,341,0,394,13.452,13.452
2,0.990,orangutan,16-23,0,0,0,0,NaN,NaN
2,0.990,orangutan,23-5,0,0,0,0,NaN,NaN
2,0.990,Bat,16-23,36,11,0,47,76.596,76.596
2,0.990,Bat,23-5,37,19,0,56,66.071,66.071
2,0.990,Deer,16-23,15,29,0,44,34.091,34.091
2,0.990,Deer,23-5,18,68,0,86,20.930,20.930
2,0.990,Great Horned Owl,16-23,0,3,0,3,0.000,0.000
2,0.990,Great Horned Owl,23-5,1,14,0,15,6.667,6.667
2,0.990,Freshwater Lagoon,16-23,0,0,0,0,NaN,NaN
2,0.990,Freshwater Lagoon,23-5,0,0,0,0,NaN,NaN
2,0.990,Unknown Avian,16-23,0,0,0,0,NaN,NaN
2,0.990,Unknown Avian,23-5,0,2,0,2,0.000,0.000
2,0.990,Human UTI,16-23,99,87,0,186,53.226,53.226
2,0.990,Human UTI,23-5,111,68,0,179,62.011,62.011
2,0.990,unknown,16-23,1,16,0,17,5.882,5.882
2,0.990,unknown,23-5,5,15,0,20,25.000,25.000
2,0.990,SLO Creek Water,16-23,0,0,0,0,NaN,NaN
2,0.990,SLO Creek Water,23-5,8,1,0,9,88.889,88.889
2,0.990,Pig/Swine,16-23,11,18,0,29,37.931,37.931
2,0.990,Pig/Swine,23-5,7,8,0,15,46.667,46.667
2,0.990,Klebsiella,16-23,0,0,0,0,NaN,NaN
2,0.990,Klebsiella,23-5,0,0,0,0,NaN,NaN
2,0.990,Hu Cw and Dg,16-23,19,27,0,46,41.304,41.304
2,0.990,Hu Cw and Dg,23-5,35,31,0,66,53.030,53.030
2,0.990,Ground Squirrel,16-23,118,131,0,249,47.390,47.390
2,0.990,Ground Squirrel,23-5,115,135,0,250,46.000,46.000
2,0.990,Opossum,16-23,2,1,0,3,66.667,66.667
2,0.990,Opossum,23-5,4,9,0,13,30.769,30.769
2,0.990,Cow,16-23,1338,535,0,1873,71.436,71.436
2,0.990,Cow,23-5,1316,582,0,1898,69.336,69.336
2,0.990,Deer Mouse,16-23,0,0,0,0,NaN,NaN
2,0.990,Deer Mouse,23-5,0,0,0,0,NaN,NaN
2,0.990,OVERALL,16-23,3882,2232,0,6114,63.494,63.494
2,0.990,OVERALL,23-5,4510,2795,0,7305,61.739,61.739
2,1.000,Chicken,16-23,0,0,0,0,NaN,NaN
2,1.000,Chicken,23-5,0,0,0,0,NaN,NaN
2,1.000,Sea Lion,16-23,0,0,0,0,NaN,NaN
2,1.000,Sea Lion,23-5,0,0,0,0,NaN,NaN
2,1.000,Hu and Cw,16-23,0,0,0,0,NaN,NaN
2,1.000,Hu and Cw,23-5,0,0,0,0,NaN,NaN
2,1.000,Sheep,16-23,0,0,0,0,NaN,NaN
2,1.000,Sheep,23-5,0,0,0,0,NaN,NaN
2,1.000,Hu and Dg,16-23,0,0,0,0,NaN,NaN
2,1.000,Hu and Dg,23-5,0,0,0,0,NaN,NaN
2,1.000,Common Loon,16-23,0,0,0,0,NaN,NaN
2,1.000,Common Loon,23-5,0,0,0,0,NaN,NaN
2,1.000,Red-Winged Blackbird,16-23,0,0,0,0,NaN,NaN
2,1.000,Red-Winged Blackbird,23-5,0,0,0,0,NaN,NaN
2,1.000,Cw,16-23,0,0,0,0,NaN,NaN
2,1.000,Cw,23-5,0,0,0,0,NaN,NaN
2,1.000,Cliff Sparrow,16-23,0,0,0,0,NaN,NaN
2,1.000,Cliff Sparrow,23-5,0,0,0,0,NaN,NaN
2,1.000,Pig,16-23,0,0,0,0,NaN,NaN
2,1.000,Pig,23-5,0,0,0,0,NaN,NaN
2,1.000,Barn Owl,16-23,0,0,0,0,NaN,NaN
2,1.000,Barn Owl,23-5,0,0,0,0,NaN,NaN
2,1.000,Wild Pig,16-23,0,0,0,0,NaN,NaN
2,1.000,Wild Pig,23-5,0,0,0,0,NaN,NaN
2,1.000,Pennington Creek Water,16-23,0,0,0,0,NaN,NaN
2,1.000,Pennington Creek Water,23-5,0,0,0,0,NaN,NaN
2,1.000,Guinni,16-23,0,0,0,0,NaN,NaN
2,1.000,Guinni,23-5,0,0,0,0,NaN,NaN
2,1.000,Racoon,16-23,0,0,0,0,NaN,NaN
2,1.000,Racoon,23-5,0,0,0,0,NaN,NaN
2,1.000,Hu,16-23,0,0,0,0,NaN,NaN
2,1.000,Hu,23-5,0,0,0,0,NaN,NaN
2,1.000,Cw and Dg,16-23,0,0,0,0,NaN,NaN
2,1.000,Cw and Dg,23-5,0,0,0,0,NaN,NaN
2,1.000,Red Wind Blackbird,16-23,0,0,0,0,NaN,NaN
2,1.000,Red Wind Blackbird,23-5,0,0,0,0,NaN,NaN
2,1.000,Tree Swallow,16-23,0,0,0,0,NaN,NaN
2,1.000,Tree Swallow,23-5,0,0,0,0,NaN,NaN
2,1.000,Turkey Vulture,16-23,0,0,0,0,NaN,NaN
2,1.000,Turkey Vulture,23-5,0,0,0,0,NaN,NaN
2,1.000,Dg,16-23,0,0,0,0,NaN,NaN
2,1.000,Dg,23-5,0,0,0,0,NaN,NaN
2,1.000,Western Kingbird,16-23,0,0,0,0,NaN,NaN
2,1.000,Western Kingbird,23-5,0,0,0,0,NaN,NaN
2,1.000,White Crowned Sparrow,16-23,0,0,0,0,NaN,NaN
2,1.000,White Crowned Sparrow,23-5,0,0,0,0,NaN,NaN
2,1.000,Eared Grebe,16-23,0,0,0,0,NaN,NaN
2,1.000,Eared Grebe,23-5,0,0,0,0,NaN,NaN
2,1.000,cougar,16-23,0,0,0,0,NaN,NaN
2,1.000,cougar,23-5,0,0,0,0,NaN,NaN
2,1.000,Ocean Water,16-23,0,0,0,0,NaN,NaN
2,1.000,Ocean Water,23-5,0,0,0,0,NaN,NaN
2,1.000,Red Tailed Hawk,16-23,0,0,0,0,NaN,NaN
2,1.000,Red Tailed Hawk,23-5,0,0,0,0,NaN,NaN
2,1.000,Dog,16-23,0,0,0,0,NaN,NaN
2,1.000,Dog,23-5,0,0,0,0,NaN,NaN
2,1.000,Human,16-23,0,0,0,0,NaN,NaN
2,1.000,Human,23-5,0,0,0,0,NaN,NaN
2,1.000,Wild Turkey,16-23,0,0,0,0,NaN,NaN
2,1.000,Wild Turkey,23-5,0,0,0,0,NaN,NaN
2,1.000,Clark Grebe,16-23,0,0,0,0,NaN,NaN
2,1.000,Clark Grebe,23-5,0,0,0,0,NaN,NaN
2,1.000,Seagull,16-23,0,0,0,0,NaN,NaN
2,1.000,Seagull,23-5,0,0,0,0,NaN,NaN
2,1.000,Surf Scoter,16-23,0,0,0,0,NaN,NaN
2,1.000,Surf Scoter,23-5,0,0,0,0,NaN,NaN
2,1.000,Pigeon,16-23,0,0,0,0,NaN,NaN
2,1.000,Pigeon,23-5,0,0,0,0,NaN,NaN
2,1.000,Pacific Ocean Water,16-23,0,0,0,0,NaN,NaN
2,1.000,Pacific Ocean Water,23-5,0,0,0,0,NaN,NaN
2,1.000,Cat,16-23,0,0,0,0,NaN,NaN
2,1.000,Cat,23-5,0,0,0,0,NaN,NaN
2,1.000,Horse,16-23,0,0,0,0,NaN,NaN
2,1.000,Horse,23-5,0,0,0,0,NaN,NaN
2,1.000,orangutan,16-23,0,0,0,0,NaN,NaN
2,1.000,orangutan,23-5,0,0,0,0,NaN,NaN
2,1.000,Bat,16-23,0,0,0,0,NaN,NaN
2,1.000,Bat,23-5,0,0,0,0,NaN,NaN
2,1.000,Deer,16-23,0,0,0,0,NaN,NaN
2,1.000,Deer,23-5,0,0,0,0,NaN,NaN
2,1.000,Great Horned Owl,16-23,0,0,0,0,NaN,NaN
2,1.000,Great Horned Owl,23-5,0,0,0,0,NaN,NaN
2,1.000,Freshwater Lagoon,16-23,0,0,0,0,NaN,NaN
2,1.000,Freshwater Lagoon,23-5,0,0,0,0,NaN,NaN
2,1.000,Unknown Avian,16-23,0,0,0,0,NaN,NaN
2,1.000,Unknown Avian,23-5,0,0,0,0,NaN,NaN
2,1.000,Human UTI,16-23,0,0,0,0,NaN,NaN
2,1.000,Human UTI,23-5,0,0,0,0,NaN,NaN
2,1.000,unknown,16-23,0,0,0,0,NaN,NaN
2,1.000,unknown,23-5,0,0,0,0,NaN,NaN
2,1.000,SLO Creek Water,16-23,0,0,0,0,NaN,NaN
2,1.000,SLO Creek Water,23-5,0,0,0,0,NaN,NaN
2,1.000,Pig/Swine,16-23,0,0,0,0,NaN,NaN
2,1.000,Pig/Swine,23-5,0,0,0,0,NaN,NaN
2,1.000,Klebsiella,16-23,0,0,0,0,NaN,NaN
2,1.000,Klebsiella,23-5,0,0,0,0,NaN,NaN
2,1.000,Hu Cw and Dg,16-23,0,0,0,0,NaN,NaN
2,1.000,Hu Cw and Dg,23-5,0,0,0,0,NaN,NaN
2,1.000,Ground Squirrel,16-23,0,0,0,0,NaN,NaN
2,1.000,Ground Squirrel,23-5,0,0,0,0,NaN,NaN
2,1.000,Opossum,16-23,0,0,0,0,NaN,NaN
2,1.000,Opossum,23-5,0,0,0,0,NaN,NaN
2,1.000,Cow,16-23,0,0,0,0,NaN,NaN
2,1.000,Cow,23-5,0,0,0,0,NaN,NaN
2,1.000,Deer Mouse,16-23,0,0,0,0,NaN,NaN
2,1.000,Deer Mouse,23-5,0,0,0,0,NaN,NaN
2,1.000,OVERALL,16-23,0,0,0,0,NaN,NaN
2,1.000,OVERALL,23-5,0,0,0,0,NaN,NaN
3,0.000,Chicken,16-23,9,28,0,37,24.324,24.324
3,0.000,Chicken,23-5,17,17,0,34,50.000,50.000
3,0.000,Sea Lion,16-23,1,1,0,2,50.000,50.000
3,0.000,Sea Lion,23-5,4,5,0,9,44.444,44.444
3,0.000,Hu and Cw,16-23,14,25,0,39,35.897,35.897
3,0.000,Hu and Cw,23-5,18,40,0,58,31.034,31.034
3,0.000,Sheep,16-23,68,73,0,141,48.227,48.227
3,0.000,Sheep,23-5,72,42,0,114,63.158,63.158
3,0.000,Hu and Dg,16-23,11,18,0,29,37.931,37.931
3,0.000,Hu and Dg,23-5,18,7,0,25,72.000,72.000
3,0.000,Common Loon,16-23,0,2,0,2,0.000,0.000
3,0.000,Common Loon,23-5,0,4,0,4,0.000,0.000
3,0.000,Red-Winged Blackbird,16-23,0,8,0,8,0.000,0.000
3,0.000,Red-Winged Blackbird,23-5,0,3,0,3,0.000,0.000
3,0.000,Cw,16-23,11,14,0,25,44.000,44.000
3,0.000,Cw,23-5,20,31,0,51,39.216,39.216
3,0.000,Cliff Sparrow,16-23,12,41,0,53,22.642,22.642
3,0.000,Cliff Sparrow,23-5,3,42,0,45,6.667,6.667
3,0.000,Pig,16-23,13,22,0,35,37.143,37.143
3,0.000,Pig,23-5,8,13,0,21,38.095,38.095
3,0.000,Barn Owl,16-23,0,0,0,0,NaN,NaN
3,0.000,Barn Owl,23-5,0,5,0,5,0.000,0.000
3,0.000,Wild Pig,16-23,7,13,0,20,35.000,35.000
3,0.000,Wild Pig,23-5,10,9,0,19,52.632,52.632
3,0.000,Pennington Creek Water,16-23,0,0,0,0,NaN,NaN
3,0.000,Pennington Creek Water,23-5,0,0,0,0,NaN,NaN
3,0.000,Guinni,16-23,0,0,0,0,NaN,NaN
3,0.000,Guinni,23-5,0,2,0,2,0.000,0.000
3,0.000,Racoon,16-23,2,3,0,5,40.000,40.000
3,0.000,Racoon,23-5,0,2,0,2,0.000,0.000
3,0.000,Hu,16-23,20,9,0,29,68.966,68.966
3,0.000,Hu,23-5,20,8,0,28,71.429,71.429
3,0.000,Cw and Dg,16-23,12,17,0,29,41.379,41.379
3,0.000,Cw and Dg,23-5,19,18,0,37,51.351,51.351
3,0.000,Red Wind Blackbird,16-23,0,2,0,2,0.000,0.000
3,0.000,Red Wind Blackbird,23-5,0,3,0,3,0.000,0.000
3,0.000,Tree Swallow,16-23,0,2,0,2,0.000,0.000
3,0.000,Tree Swallow,23-5,0,7,0,7,0.000,0.000
3,0.000,Turkey Vulture,16-23,0,1,0,1,0.000,0.000
3,0.000,Turkey Vulture,23-5,0,2,0,2,0.000,0.000
3,0.000,Dg,16-23,9,14,0,23,39.130,39.130
3,0.000,Dg,23-5,29,24,0,53,54.717,54.717
3,0.000,Western Kingbird,16-23,0,1,0,1,0.000,0.000
3,0.000,Western Kingbird,23-5,0,1,0,1,0.000,0.000
3,0.000,White Crowned Sparrow,16-23,12,10,0,22,54.545,54.545
3,0.000,White Crowned Sparrow,23-5,5,27,0,32,15.625,15.625
3,0.000,Eared Grebe,16-23,0,0,0,0,NaN,NaN
3,0.000,Eared Grebe,23-5,4,14,0,18,22.222,22.222
3,0.000,cougar,16-23,0,0,0,0,NaN,NaN
3,0.000,cougar,23-5,0,0,0,0,NaN,NaN
3,0.000,Ocean Water,16-23,0,0,0,0,NaN,NaN
3,0.000,Ocean Water,23-5,0,0,0,0,NaN,NaN
3,0.000,Red Tailed Hawk,16-23,0,2,0,2,0.000,0.000
3,0.000,Red Tailed Hawk,23-5,0,18,0,18,0.000,0.000
3,0.000,Dog,16-23,77,99,0,176,43.750,43.750
3,0.000,Dog,23-5,130,149,0,279,46.595,46.595
3,0.000,Human,16-23,1705,520,0,2225,76.629,76.629
3,0.000,Human,23-5,2172,427,0,2599,83.571,83.571
3,0.000,Wild Turkey,16-23,10,33,0,43,23.256,23.256
3,0.000,Wild Turkey,23-5,6,50,0,56,10.714,10.714
3,0.000,Clark Grebe,16-23,0,0,0,0,NaN,NaN
3,0.000,Clark Grebe,23-5,0,2,0,2,0.000,0.000
3,0.000,Seagull,16-23,0,0,0,0,NaN,NaN
3,0.000,Seagull,23-5,26,6,0,32,81.250,81.250
3,0.000,Surf Scoter,16-23,0,0,0,0,NaN,NaN
3,0.000,Surf Scoter,23-5,0,4,0,4,0.000,0.000
3,0.000,Pigeon,16-23,101,150,0,251,40.239,40.239
3,0.000,Pigeon,23-5,116,280,0,396,29.293,29.293
3,0.000,Pacific Ocean Water,16-23,0,0,0,0,NaN,NaN
3,0.000,Pacific Ocean Water,23-5,0,0,0,0,NaN,NaN
3,0.000,Cat,16-23,30,42,0,72,41.667,41.667
3,0.000,Cat,23-5,33,48,0,81,40.741,40.741
3,0.000,Horse,16-23,21,54,0,75,28.000,28.000
3,0.000,Horse,23-5,41,300,0,341,12.023,12.023
3,0.000,orangutan,16-23,0,0,0,0,NaN,NaN
3,0.000,orangutan,23-5,0,0,0,0,NaN,NaN
3,0.000,Bat,16-23,36,11,0,47,76.596,76.596
3,0.000,Bat,23-5,37,19,0,56,66.071,66.071
3,0.000,Deer,16-23,15,20,0,35,42.857,42.857
3,0.000,Deer,23-5,17,51,0,68,25.000,25.000
3,0.000,Great Horned Owl,16-23,0,4,0,4,0.000,0.000
3,0.000,Great Horned Owl,23-5,1,17,0,18,5.556,5.556
3,0.000,Freshwater Lagoon,16-23,0,0,0,0,NaN,NaN
3,0.000,Freshwater Lagoon,23-5,0,0,0,0,NaN,NaN
3,0.000,Unknown Avian,16-23,0,0,0,0,NaN,NaN
3,0.000,Unknown Avian,23-5,0,0,0,0,NaN,NaN
3,0.000,Human UTI,16-23,92,91,0,183,50.273,50.273
3,0.000,Human UTI,23-5,110,97,0,207,53.140,53.140
3,0.000,unknown,16-23,0,5,0,5,0.000,0.000
3,0.000,unknown,23-5,3,13,0,16,18.750,18.750
3,0.000,SLO Creek Water,16-23,0,0,0,0,NaN,NaN
3,0.000,SLO Creek Water,23-5,1,0,0,1,100.000,100.000
3,0.000,Pig/Swine,16-23,16,9,0,25,64.000,64.000
3,0.000,Pig/Swine,23-5,10,6,0,16,62.500,62.500
3,0.000,Klebsiella,16-23,0,0,0,0,NaN,NaN
3,0.000,Klebsiella,23-5,0,0,0,0,NaN,NaN
3,0.000,Hu Cw and Dg,16-23,11,33,0,44,25.000,25.000
3,0.000,Hu Cw and Dg,23-5,28,33,0,61,45.902,45.902
3,0.000,Ground Squirrel,16-23,112,99,0,211,53.081,53.081
3,0.000,Ground Squirrel,23-5,101,127,0,228,44.298,44.298
3,0.000,Opossum,16-23,0,1,0,1,0.000,0.000
3,0.000,Opossum,23-5,0,9,0,9,0.000,0.000
3,0.000,Cow,16-23,1544,900,0,2444,63.175,63.175
3,0.000,Cow,23-5,1494,1055,0,2549,58.611,58.611
3,0.000,Deer Mouse,16-23,0,0,0,0,NaN,NaN
3,0.000,Deer Mouse,23-5,0,0,0,0,NaN,NaN
3,0.000,OVERALL,16-23,3971,2377,0,6348,62.555,62.555
3,0.000,OVERALL,23-5,4573,3037,0,7610,60.092,60.092
3,0.500,Chicken,16-23,9,28,0,37,24.324,24.324
3,0.500,Chicken,23-5,17,17,0,34,50.000,50.000
3,0.500,Sea Lion,16-23,1,1,0,2,50.000,50.000
3,0.500,Sea Lion,23-5,4,5,0,9,44.444,44.444
3,0.500,Hu and Cw,16-23,14,25,0,39,35.897,35.897
3,0.500,Hu and Cw,23-5,18,40,0,58,31.034,31.034
3,0.500,Sheep,16-23,68,73,0,141,48.227,48.227
3,0.500,Sheep,23-5,72,42,0,114,63.158,63.158
3,0.500,Hu and Dg,16-23,11,18,0,29,37.931,37.931
3,0.500,Hu and Dg,23-5,18,7,0,25,72.000,72.000
3,0.500,Common Loon,16-23,0,2,0,2,0.000,0.000
3,0.500,Common Loon,23-5,0,4,0,4,0.000,0.000
3,0.500,Red-Winged Blackbird,16-23,0,8,0,8,0.000,0.000
3,0.500,Red-Winged Blackbird,23-5,0,3,0,3,0.000,0.000
3,0.500,Cw,16-23,11,14,0,25,44.000,44.000
3,0.500,Cw,23-5,20,31,0,51,39.216,39.216
3,0.500,Cliff Sparrow,16-23,12,41,0,53,22.642,22.642
3,0.500,Cliff Sparrow,23-5,3,42,0,45,6.667,6.667
3,0.500,Pig,16-23,13,22,0,35,37.143,37.143
3,0.500,Pig,23-5,8,13,0,21,38.095,38.095
3,0.500,Barn Owl,16-23,0,0,0,0,NaN,NaN
3,0.500,Barn Owl,23-5,0,5,0,5,0.000,0.000
3,0.500,Wild Pig,16-23,7,13,0,20,35.000,35.000
3,0.500,Wild Pig,23-5,10,9,0,19,52.632,52.632
3,0.500,Pennington Creek Water,16-23,0,0,0,0,NaN,NaN
3,0.500,Pennington Creek Water,23-5,0,0,0,0,NaN,NaN
3,0.500,Guinni,16-23,0,0,0,0,NaN,NaN
3,0.500,Guinni,23-5,0,2,0,2,0.000,0.000
3,0.500,Racoon,16-23,2,3,0,5,40.000,40.000
3,0.500,Racoon,23-5,0,2,0,2,0.000,0.000
3,0.500,Hu,16-23,20,9,0,29,68.966,68.966
3,0.500,Hu,23-5,20,8,0,28,71.429,71.429
3,0.500,Cw and Dg,16-23,12,17,0,29,41.379,41.379
3,0.500,Cw and Dg,23-5,19,18,0,37,51.351,51.351
3,0.500,Red Wind Blackbird,16-23,0,2,0,2,0.000,0.000
3,0.500,Red Wind Blackbird,23-5,0,3,0,3,0.000,0.000
3,0.500,Tree Swallow,16-23,0,2,0,2,0.000,0.000
3,0.500,Tree Swallow,23-5,0,7,0,7,0.000,0.000
3,0.500,Turkey Vulture,16-23,0,1,0,1,0.000,0.000
3,0.500,Turkey Vulture,23-5,0,2,0,2,0.000,0.000
3,0.500,Dg,16-23,9,14,0,23,39.130,39.130
3,0.500,Dg,23-5,29,24,0,53,54.717,54.717
3,0.500,Western Kingbird,16-23,0,1,0,1,0.000,0.000
3,0.500,Western Kingbird,23-5,0,1,0,1,0.000,0.000
3,0.500,White Crowned Sparrow,16-23,12,10,0,22,54.545,54.545
3,0.500,White Crowned Sparrow,23-5,5,27,0,32,15.625,15.625
3,0.500,Eared Grebe,16-23,0,0,0,0,NaN,NaN
3,0.500,Eared Grebe,23-5,4,14,0,18,22.222,22.222
3,0.500,cougar,16-23,0,0,0,0,NaN,NaN
3,0.500,cougar,23-5,0,0,0,0,NaN,NaN
3,0.500,Ocean Water,16-23,0,0,0,0,NaN,NaN
3,0.500,Ocean Water,23-5,0,0,0,0,NaN,NaN
3,0.500,Red Tailed Hawk,16-23,0,2,0,2,0.000,0.000
3,0.500,Red Tailed Hawk,23-5,0,18,0,18,0.000,0.000
3,0.500,Dog,16-23,77,99,0,176,43.750,43.750
3,0.500,Dog,23-5,130,149,0,279,46.595,46.595
3,0.500,Human,16-23,1705,520,0,2225,76.629,76.629
3,0.500,Human,23-5,2172,427,0,2599,83.571,83.571
3,0.500,Wild Turkey,16-23,10,33,0,43,23.256,23.256
3,0.500,Wild Turkey,23-5,6,50,0,56,10.714,10.714
3,0.500,Clark Grebe,16-23,0,0,0,0,NaN,NaN
3,0.500,Clark Grebe,23-5,0,2,0,2,0.000,0.000
3,0.500,Seagull,16-23,0,0,0,0,NaN,NaN
3,0.500,Seagull,23-5,26,6,0,32,81.250,81.250
3,0.500,Surf Scoter,16-23,0,0,0,0,NaN,NaN
3,0.500,Surf Scoter,23-5,0,4,0,4,0.000,0.000
3,0.500,Pigeon,16-23,101,150,0,251,40.239,40.239
3,0.500,Pigeon,23-5,116,280,0,396,29.293,29.293
3,0.500,Pacific Ocean Water,16-23,0,0,0,0,NaN,NaN
3,0.500,Pacific Ocean Water,23-5,0,0,0,0,NaN,NaN
3,0.500,Cat,16-23,30,42,0,72,41.667,41.667
3,0.500,Cat,23-5,33,48,0,81,40.741,40.741
3,0.500,Horse,16-23,21,54,0,75,28.000,28.000
3,0.500,Horse,23-5,41,300,0,341,12.023,12.023
3,0.500,orangutan,16-23,0,0,0,0,NaN,NaN
3,0.500,orangutan,23-5,0,0,0,0,NaN,NaN
3,0.500,Bat,16-23,36,11,0,47,76.596,76.596
3,0.500,Bat,23-5,37,19,0,56,66.071,66.071
3,0.500,Deer,16-23,15,20,0,35,42.857,42.857
3,0.500,Deer,23-5,17,51,0,68,25.000,25.000
3,0.500,Great Horned Owl,16-23,0,4,0,4,0.000,0.000
3,0.500,Great Horned Owl,23-5,1,17,0,18,5.556,5.556
3,0.500,Freshwater Lagoon,16-23,0,0,0,0,NaN,NaN
3,0.500,Freshwater Lagoon,23-5,0,0,0,0,NaN,NaN
3,0.500,Unknown Avian,16-23,0,0,0,0,NaN,NaN
3,0.500,Unknown Avian,23-5,0,0,0,0,NaN,NaN
3,0.500,Human UTI,16-23,92,91,0,183,50.273,50.273
3,0.500,Human UTI,23-5,110,97,0,207,53.140,53.140
3,0.500,unknown,16-23,0,5,0,5,0.000,0.000
3,0.500,unknown,23-5,3,13,0,16,18.750,18.750
3,0.500,SLO Creek Water,16-23,0,0,0,0,NaN,NaN
3,0.500,SLO Creek Water,23-5,1,0,0,1,100.000,100.000
3,0.500,Pig/Swine,16-23,16,9,0,25,64.000,64.000
3,0.500,Pig/Swine,23-5,10,6,0,16,62.500,62.500
3,0.500,Klebsiella,16-23,0,0,0,0,NaN,NaN
3,0.500,Klebsiella,23-5,0,0,0,0,NaN,NaN
3,0.500,Hu Cw and Dg,16-23,11,33,0,44,25.000,25.000
3,0.500,Hu Cw and Dg,23-5,28,33,0,61,45.902,45.902
3,0.500,Ground Squirrel,16-23,112,99,0,211,53.081,53.081
3,0.500,Ground Squirrel,23-5,101,127,0,228,44.298,44.298
3,0.500,Opossum,16-23,0,1,0,1,0.000,0.000
3,0.500,Opossum,23-5,0,9,0,9,0.000,0.000
3,0.500,Cow,16-23,1544,900,0,2444,63.175,63.175
3,0.500,Cow,23-5,1494,1055,0,2549,58.611,58.611
3,0.500,Deer Mouse,16-23,0,0,0,0,NaN,NaN
3,0.500,Deer Mouse,23-5,0,0,0,0,NaN,NaN
3,0.500,OVERALL,16-23,3971,2377,0,6348,62.555,62.555
3,0.500,OVERALL,23-5,4573,3037,0,7610,60.092,60.092
3,0.900,Chicken,16-23,9,28,0,37,24.324,24.324
3,0.900,Chicken,23-5,17,17,0,34,50.000,50.000
3,0.900,Sea Lion,16-23,1,1,0,2,50.000,50.000
3,0.900,Sea Lion,23-5,4,5,0,9,44.444,44.444
3,0.900,Hu and Cw,16-23,14,25,0,39,35.897,35.897
3,0.900,Hu and Cw,23-5,18,40,0,58,31.034,31.034
3,0.900,Sheep,16-23,68,73,0,141,48.227,48.227
3,0.900,Sheep,23-5,72,42,0,114,63.158,63.158
3,0.900,Hu and Dg,16-23,11,18,0,29,37.931,37.931
3,0.900,Hu and Dg,23-5,18,7,0,25,72.000,72.000
3,0.900,Common Loon,16-23,0,2,0,2,0.000,0.000
3,0.900,Common Loon,23-5,0,4,0,4,0.000,0.000
3,0.900,Red-Winged Blackbird,16-23,0,8,0,8,0.000,0.000
3,0.900,Red-Winged Blackbird,23-5,0,3,0,3,0.000,0.000
3,0.900,Cw,16-23,11,14,0,25,44.000,44.000
3,0.900,Cw,23-5,20,31,0,51,39.216,39.216
3,0.900,Cliff Sparrow,16-23,12,41,0,53,22.642,22.642
3,0.900,Cliff Sparrow,23-5,3,42,0,45,6.667,6.667
3,0.900,Pig,16-23,13,22,0,35,37.143,37.143
3,0.900,Pig,23-5,8,13,0,21,38.095,38.095
3,0.900,Barn Owl,16-23,0,0,0,0,NaN,NaN
3,0.900,Barn Owl,23-5,0,5,0,5,0.000,0.000
3,0.900,Wild Pig,16-23,7,13,0,20,35.000,35.000
3,0.900,Wild Pig,23-5,10,9,0,19,52.632,52.632
3,0.900,Pennington Creek Water,16-23,0,0,0,0,NaN,NaN
3,0.900,Pennington Creek Water,23-5,0,0,0,0,NaN,NaN
3,0.900,Guinni,16-23,0,0,0,0,NaN,NaN
3,0.900,Guinni,23-5,0,2,0,2,0.000,0.000
3,0.900,Racoon,16-23,2,3,0,5,40.000,40.000
3,0.900,Racoon,23-5,0,2,0,2,0.000,0.000
3,0.900,Hu,16-23,20,9,0,29,68.966,68.966
3,0.900,Hu,23-5,20,8,0,28,71.429,71.429
3,0.900,Cw and Dg,16-23,12,17,0,29,41.379,41.379
3,0.900,Cw and Dg,23-5,19,18,0,37,51.351,51.351
3,0.900,Red Wind Blackbird,16-23,0,2,0,2,0.000,0.000
3,0.900,Red Wind Blackbird,23-5,0,3,0,3,0.000,0.000
3,0.900,Tree Swallow,16-23,0,2,0,2,0.000,0.000
3,0.900,Tree Swallow,23-5,0,7,0,7,0.000,0.000
3,0.900,Turkey Vulture,16-23,0,1,0,1,0.000,0.000
3,0.900,Turkey Vulture,23-5,0,2,0,2,0.000,0.000
3,0.900,Dg,16-23,9,14,0,23,39.130,39.130
3,0.900,Dg,23-5,29,24,0,53,54.717,54.717
3,0.900,Western Kingbird,16-23,0,1,0,1,0.000,0.000
3,0.900,Western Kingbird,23-5,0,1,0,1,0.000,0.000
3,0.900,White Crowned Sparrow,16-23,12,10,0,22,54.545,54.545
3,0.900,White Crowned Sparrow,23-5,5,27,0,32,15.625,15.625
3,0.900,Eared Grebe,16-23,0,0,0,0,NaN,NaN
3,0.900,Eared Grebe,23-5,4,14,0,18,22.222,22.222
3,0.900,cougar,16-23,0,0,0,0,NaN,NaN
3,0.900,cougar,23-5,0,0,0,0,NaN,NaN
3,0.900,Ocean Water,16-23,0,0,0,0,NaN,NaN
3,0.900,Ocean Water,23-5,0,0,0,0,NaN,NaN
3,0.900,Red Tailed Hawk,16-23,0,2,0,2,0.000,0.000
3,0.900,Red Tailed Hawk,23-5,0,18,0,18,0.000,0.000
3,0.900,Dog,16-23,77,99,0,176,43.750,43.750
3,0.900,Dog,23-5,130,147,0,277,46.931,46.931
3,0.900,Human,16-23,1705,516,0,2221,76.767,76.767
3,0.900,Human,23-5,2172,423,0,2595,83.699,83.699
3,0.900,Wild Turkey,16-23,10,33,0,43,23.256,23.256
3,0.900,Wild Turkey,23-5,6,50,0,56,10.714,10.714
3,0.900,Clark Grebe,16-23,0,0,0,0,NaN,NaN
3,0.900,Clark Grebe,23-5,0,2,0,2,0.000,0.000
3,0.900,Seagull,16-23,0,0,0,0,NaN,NaN
3,0.900,Seagull,23-5,26,6,0,32,81.250,81.250
3,0.900,Surf Scoter,16-23,0,0,0,0,NaN,NaN
3,0.900,Surf Scoter,23-5,0,4,0,4,0.000,0.000
3,0.900,Pigeon,16-23,101,150,0,251,40.239,40.239
3,0.900,Pigeon,23-5,116,280,0,396,29.293,29.293
3,0.900,Pacific Ocean Water,16-23,0,0,0,0,NaN,NaN
3,0.900,Pacific Ocean Water,23-5,0,0,0,0,NaN,NaN
3,0.900,Cat,16-23,30,42,0,72,41.667,41.667
3,0.900,Cat,23-5,33,48,0,81,40.741,40.741
3,0.900,Horse,16-23,21,54,0,75,28.000,28.000
3,0.900,Horse,23-5,41,300,0,341,12.023,12.023
3,0.900,orangutan,16-23,0,0,0,0,NaN,NaN
3,0.900,orangutan,23-5,0,0,0,0,NaN,NaN
3,0.900,Bat,16-23,36,11,0,47,76.596,76.596
3,0.900,Bat,23-5,37,19,0,56,66.071,66.071
3,0.900,Deer,16-23,15,20,0,35,42.857,42.857
3,0.900,Deer,23-5,17,51,0,68,25.000,25.000
3,0.900,Great Horned Owl,16-23,0,4,0,4,0.000,0.000
3,0.900,Great Horned Owl,23-5,1,17,0,18,5.556,5.556
3,0.900,Freshwater Lagoon,16-23,0,0,0,0,NaN,NaN
3,0.900,Freshwater Lagoon,23-5,0,0,0,0,NaN,NaN
3,0.900,Unknown Avian,16-23,0,0,0,0,NaN,NaN
3,0.900,Unknown Avian,23-5,0,0,0,0,NaN,NaN
3,0.900,Human UTI,16-23,92,91,0,183,50.273,50.273
3,0.900,Human UTI,23-5,110,97,0,207,53.140,53.140
3,0.900,unknown,16-23,0,5,0,5,0.000,0.000
3,0.900,unknown,23-5,3,13,0,16,18.750,18.750
3,0.900,SLO Creek Water,16-23,0,0,0,0,NaN,NaN
3,0.900,SLO Creek Water,23-5,1,0,0,1,100.000,100.000
3,0.900,Pig/Swine,16-23,16,9,0,25,64.000,64.000
3,0.900,Pig/Swine,23-5,10,6,0,16,62.500,62.500
3,0.900,Klebsiella,16-23,0,0,0,0,NaN,NaN
3,0.900,Klebsiella,23-5,0,0,0,0,NaN,NaN
3,0.900,Hu Cw and Dg,16-23,11,33,0,44,25.000,25.000
3,0.900,Hu Cw and Dg,23-5,28,33,0,61,45.902,45.902
3,0.900,Ground Squirrel,16-23,112,99,0,211,53.081,53.081
3,0.900,Ground Squirrel,23-5,101,127,0,228,44.298,44.298
3,0.900,Opossum,16-23,0,1,0,1,0.000,0.000
3,0.900,Opossum,23-5,0,9,0,9,0.000,0.000
3,0.900,Cow,16-23,1544,900,0,2444,63.175,63.175
3,0.900,Cow,23-5,1494,1053,0,2547,58.657,58.657
3,0.900,Deer Mouse,16-23,0,0,0,0,NaN,NaN
3,0.900,Deer Mouse,23-5,0,0,0,0,NaN,NaN
3,0.900,OVERALL,16-23,3971,2373,0,6344,62.595,62.595
3,0.900,OVERALL,23-5,4573,3029,0,7602,60.155,60.155
3,0.950,Chicken,16-23,9,28,0,37,24.324,24.324
3,0.950,Chicken,23-5,17,17,0,34,50.000,50.000
3,0.950,Sea Lion,16-23,1,1,0,2,50.000,50.000
3,0.950,Sea Lion,23-5,4,5,0,9,44.444,44.444
3,0.950,Hu and Cw,16-23,14,25,0,39,35.897,35.897
3,0.950,Hu and Cw,23-5,18,40,0,58,31.034,31.034
3,0.950,Sheep,16-23,68,73,0,141,48.227,48.227
3,0.950,Sheep,23-5,72,42,0,114,63.158,63.158
3,0.950,Hu and Dg,16-23,11,18,0,29,37.931,37.931
3,0.950,Hu and Dg,23-5,18,7,0,25,72.000,72.000
3,0.950,Common Loon,16-23,0,2,0,2,0.000,0.000
3,0.950,Common Loon,23-5,0,4,0,4,0.000,0.000
3,0.950,Red-Winged Blackbird,16-23,0,8,0,8,0.000,0.000
3,0.950,Red-Winged Blackbird,23-5,0,3,0,3,0.000,0.000
3,0.950,Cw,16-23,11,14,0,25,44.000,44.000
3,0.950,Cw,23-5,20,31,0,51,39.216,39.216
3,0.950,Cliff Sparrow,16-23,12,41,0,53,22.642,22.642
3,0.950,Cliff Sparrow,23-5,3,42,0,45,6.667,6.667
3,0.950,Pig,16-23,13,22,0,35,37.143,37.143
3,0.950,Pig,23-5,8,13,0,21,38.095,38.095
3,0.950,Barn Owl,16-23,0,0,0,0,NaN,NaN
3,0.950,Barn Owl,23-5,0,5,0,5,0.000,0.000
3,0.950,Wild Pig,16-23,7,13,0,20,35.000,35.000
3,0.950,Wild Pig,23-5,10,8,0,18,55.556,55.556
3,0.950,Pennington Creek Water,16-23,0,0,0,0,NaN,NaN
3,0.950,Pennington Creek Water,23-5,0,0,0,0,NaN,NaN
3,0.950,Guinni,16-23,0,0,0,0,NaN,NaN
3,0.950,Guinni,23-5,0,2,0,2,0.000,0.000
3,0.950,Racoon,16-23,2,3,0,5,40.000,40.000
3,0.950,Racoon,23-5,0,2,0,2,0.000,0.000
3,0.950,Hu,16-23,20,9,0,29,68.966,68.966
3,0.950,Hu,23-5,20,8,0,28,71.429,71.429
3,0.950,Cw and Dg,16-23,12,17,0,29,41.379,41.379
3,0.950,Cw and Dg,23-5,19,18,0,37,51.351,51.351
3,0.950,Red Wind Blackbird,16-23,0,2,0,2,0.000,0.000
3,0.950,Red Wind Blackbird,23-5,0,3,0,3,0.000,0.000
3,0.950,Tree Swallow,16-23,0,2,0,2,0.000,0.000
3,0.950,Tree Swallow,23-5,0,7,0,7,0.000,0.000
3,0.950,Turkey Vulture,16-23,0,1,0,1,0.000,0.000
3,0.950,Turkey Vulture,23-5,0,2,0,2,0.000,0.000
3,0.950,Dg,16-23,9,14,0,23,39.130,39.130
3,0.950,Dg,23-5,29,24,0,53,54.717,54.717
3,0.950,Western Kingbird,16-23,0,1,0,1,0.000,0.000
3,0.950,Western Kingbird,23-5,0,1,0,1,0.000,0.000
3,0.950,White Crowned Sparrow,16-23,12,10,0,22,54.545,54.545
3,0.950,White Crowned Sparrow,23-5,5,27,0,32,15.625,15.625
3,0.950,Eared Grebe,16-23,0,0,0,0,NaN,NaN
3,0.950,Eared Grebe,23-5,4,14,0,18,22.222,22.222
3,0.950,cougar,16-23,0,0,0,0,NaN,NaN
3,0.950,cougar,23-5,0,0,0,0,NaN,NaN
3,0.950,Ocean Water,16-23,0,0,0,0,NaN,NaN
3,0.950,Ocean Water,23-5,0,0,0,0,NaN,NaN
3,0.950,Red Tailed Hawk,16-23,0,2,0,2,0.000,0.000
3,0.950,Red Tailed Hawk,23-5,0,18,0,18,0.000,0.000
3,0.950,Dog,16-23,77,99,0,176,43.750,43.750
3,0.950,Dog,23-5,130,147,0,277,46.931,46.931
3,0.950,Human,16-23,1705,515,0,2220,76.802,76.802
3,0.950,Human,23-5,2172,417,0,2589,83.893,83.893
3,0.950,Wild Turkey,16-23,10,33,0,43,23.256,23.256
3,0.950,Wild Turkey,23-5,6,50,0,56,10.714,10.714
3,0.950,Clark Grebe,16-23,0,0,0,0,NaN,NaN
3,0.950,Clark Grebe,23-5,0,2,0,2,0.000,0.000
3,0.950,Seagull,16-23,0,0,0,0,NaN,NaN
3,0.950,Seagull,23-5,26,5,0,31,83.871,83.871
3,0.950,Surf Scoter,16-23,0,0,0,0,NaN,NaN
3,0.950,Surf Scoter,23-5,0,2,0,2,0.000,0.000
3,0.950,Pigeon,16-23,101,150,0,251,40.239,40.239
3,0.950,Pigeon,23-5,116,280,0,396,29.293,29.293
3,0.950,Pacific Ocean Water,16-23,0,0,0,0,NaN,NaN
3,0.950,Pacific Ocean Water,23-5,0,0,0,0,NaN,NaN
3,0.950,Cat,16-23,30,42,0,72,41.667,41.667
3,0.950,Cat,23-5,33,48,0,81,40.741,40.741
3,0.950,Horse,16-23,21,54,0,75,28.000,28.000
3,0.950,Horse,23-5,41,300,0,341,12.023,12.023
3,0.950,orangutan,16-23,0,0,0,0,NaN,NaN
3,0.950,orangutan,23-5,0,0,0,0,NaN,NaN
3,0.950,Bat,16-23,36,11,0,47,76.596,76.596
3,0.950,Bat,23-5,37,19,0,56,66.071,66.071
3,0.950,Deer,16-23,15,20,0,35,42.857,42.857
3,0.950,Deer,23-5,17,51,0,68,25.000,25.000
3,0.950,Great Horned Owl,16-23,0,4,0,4,0.000,0.000
3,0.950,Great Horned Owl,23-5,1,17,0,18,5.556,5.556
3,0.950,Freshwater Lagoon,16-23,0,0,0,0,NaN,NaN
3,0.950,Freshwater Lagoon,23-5,0,0,0,0,NaN,NaN
3,0.950,Unknown Avian,16-23,0,0,0,0,NaN,NaN
3,0.950,Unknown Avian,23-5,0,0,0,0,NaN,NaN
3,0.950,Human UTI,16-23,92,91,0,183,50.273,50.273
3,0.950,Human UTI,23-5,109,97,0,206,52.913,52.913
3,0.950,unknown,16-23,0,5,0,5,0.000,0.000
3,0.950,unknown,23-5,3,13,0,16,18.750,18.750
3,0.950,SLO Creek Water,16-23,0,0,0,0,NaN,NaN
3,0.950,SLO Creek Water,23-5,1,0,0,1,100.000,100.000
3,0.950,Pig/Swine,16-23,16,9,0,25,64.000,64.000
3,0.950,Pig/Swine,23-5,10,6,0,16,62.500,62.500
3,0.950,Klebsiella,16-23,0,0,0,0,NaN,NaN
3,0.950,Klebsiella,23-5,0,0,0,0,NaN,NaN
3,0.950,Hu Cw and Dg,16-23,11,33,0,44,25.000,25.000
3,0.950,Hu Cw and Dg,23-5,28,33,0,61,45.902,45.902
3,0.950,Ground Squirrel,16-23,112,99,0,211,53.081,53.081
3,0.950,Ground Squirrel,23-5,101,125,0,226,44.690,44.690
3,0.950,Opossum,16-23,0,1,0,1,0.000,0.000
3,0.950,Opossum,23-5,0,9,0,9,0.000,0.000
3,0.950,Cow,16-23,1544,884,0,2428,63.591,63.591
3,0.950,Cow,23-5,1493,1053,0,2546,58.641,58.641
3,0.950,Deer Mouse,16-23,0,0,0,0,NaN,NaN
3,0.950,Deer Mouse,23-5,0,0,0,0,NaN,NaN
3,0.950,OVERALL,16-23,3971,2356,0,6327,62.763,62.763
3,0.950,OVERALL,23-5,4571,3017,0,7588,60.240,60.240
3,0.960,Chicken,16-23,9,28,0,37,24.324,24.324
3,0.960,Chicken,23-5,17,17,0,34,50.000,50.000
3,0.960,Sea Lion,16-23,1,1,0,2,50.000,50.000
3,0.960,Sea Lion,23-5,4,5,0,9,44.444,44.444
3,0.960,Hu and Cw,16-23,14,25,0,39,35.897,35.897
3,0.960,Hu and Cw,23-5,18,40,0,58,31.034,31.034
3,0.960,Sheep,16-23,68,73,0,141,48.227,48.227
3,0.960,Sheep,23-5,72,41,0,113,63.717,63.717
3,0.960,Hu and Dg,16-23,11,18,0,29,37.931,37.931
3,0.960,Hu and Dg,23-5,18,7,0,25,72.000,72.000
3,0.960,Common Loon,16-23,0,2,0,2,0.000,0.000
3,0.960,Common Loon,23-5,0,4,0,4,0.000,0.000
3,0.960,Red-Winged Blackbird,16-23,0,8,0,8,0.000,0.000
3,0.960,Red-Winged Blackbird,23-5,0,3,0,3,0.000,0.000
3,0.960,Cw,16-23,11,14,0,25,44.000,44.000
3,0.960,Cw,23-5,20,31,0,51,39.216,39.216
3,0.960,Cliff Sparrow,16-23,12,41,0,53,22.642,22.642
3,0.960,Cliff Sparrow,23-5,3,42,0,45,6.667,6.667
3,0.960,Pig,16-23,13,22,0,35,37.143,37.143
3,0.960,Pig,23-5,8,13,0,21,38.095,38.095
3,0.960,Barn Owl,16-23,0,0,0,0,NaN,NaN
3,0.960,Barn Owl,23-5,0,5,0,5,0.000,0.000
3,0.960,Wild Pig,16-23,7,13,0,20,35.000,35.000
3,0.960,Wild Pig,23-5,10,8,0,18,55.556,55.556
3,0.960,Pennington Creek Water,16-23,0,0,0,0,NaN,NaN
3,0.960,Pennington Creek Water,23-5,0,0,0,0,NaN,NaN
3,0.960,Guinni,16-23,0,0,0,0,NaN,NaN
3,0.960,Guinni,23-5,0,2,0,2,0.000,0.000
3,0.960,Racoon,16-23,2,3,0,5,40.000,40.000
3,0.960,Racoon,23-5,0,2,0,2,0.000,0.000
3,0.960,Hu,16-23,20,9,0,29,68.966,68.966
3,0.960,Hu,23-5,20,8,0,28,71.429,71.429
3,0.960,Cw and Dg,16-23,12,17,0,29,41.379,41.379
3,0.960,Cw and Dg,23-5,19,18,0,37,51.351,51.351
3,0.960,Red Wind Blackbird,16-23,0,2,0,2,0.000,0.000
3,0.960,Red Wind Blackbird,23-5,0,3,0,3,0.000,0.000
3,0.960,Tree Swallow,16-23,0,2,0,2,0.000,0.000
3,0.960,Tree Swallow,23-5,0,7,0,7,0.000,0.000
3,0.960,Turkey Vulture,16-23,0,1,0,1,0.000,0.000
3,0.960,Turkey Vulture,23-5,0,2,0,2,0.000,0.000
3,0.960,Dg,16-23,9,14,0,23,39.130,39.130
3,0.960,Dg,23-5,29,24,0,53,54.717,54.717
3,0.960,Western Kingbird,16-23,0,1,0,1,0.000,0.000
3,0.960,Western Kingbird,23-5,0,1,0,1,0.000,0.000
3,0.960,White Crowned Sparrow,16-23,12,10,0,22,54.545,54.545
3,0.960,White Crowned Sparrow,23-5,5,27,0,32,15.625,15.625
3,0.960,Eared Grebe,16-23,0,0,0,0,NaN,NaN
3,0.960,Eared Grebe,23-5,4,14,0,18,22.222,22.222
3,0.960,cougar,16-23,0,0,0,0,NaN,NaN
3,0.960,cougar,23-5,0,0,0,0,NaN,NaN
3,0.960,Ocean Water,16-23,0,0,0,0,NaN,NaN
3,0.960,Ocean Water,23-5,0,0,0,0,NaN,NaN
3,0.960,Red Tailed Hawk,16-23,0,2,0,2,0.000,0.000
3,0.960,Red Tailed Hawk,23-5,0,18,0,18,0.000,0.000
3,0.960,Dog,16-23,77,99,0,176,43.750,43.750
3,0.960,Dog,23-5,130,145,0,275,47.273,47.273
3,0.960,Human,16-23,1705,514,0,2219,76.836,76.836
3,0.960,Human,23-5,2178,408,0,2586,84.223,84.223
3,0.960,Wild Turkey,16-23,10,33,0,43,23.256,23.256
3,0.960,Wild Turkey,23-5,6,51,0,57,10.526,10.526
3,0.960,Clark Grebe,16-23,0,0,0,0,NaN,NaN
3,0.960,Clark Grebe,23-5,0,2,0,2,0.000,0.000
3,0.960,Seagull,16-23,0,0,0,0,NaN,NaN
3,0.960,Seagull,23-5,26,5,0,31,83.871,83.871
3,0.960,Surf Scoter,16-23,0,0,0,0,NaN,NaN
3,0.960,Surf Scoter,23-5,0,2,0,2,0.000,0.000
3,0.960,Pigeon,16-23,101,150,0,251,40.239,40.239
3,0.960,Pigeon,23-5,117,280,0,397,29.471,29.471
3,0.960,Pacific Ocean Water,16-23,0,0,0,0,NaN,NaN
3,0.960,Pacific Ocean Water,23-5,0,0,0,0,NaN,NaN
3,0.960,Cat,16-23,30,42,0,72,41.667,41.667
3,0.960,Cat,23-5,33,48,0,81,40.741,40.741
3,0.960,Horse,16-23,21,54,0,75,28.000,28.000
3,0.960,Horse,23-5,41,300,0,341,12.023,12.023
3,0.960,orangutan,16-23,0,0,0,0,NaN,NaN
3,0.960,orangutan,23-5,0,0,0,0,NaN,NaN
3,0.960,Bat,16-23,36,11,0,47,76.596,76.596
3,0.960,Bat,23-5,37,19,0,56,66.071,66.071
3,0.960,Deer,16-23,15,20,0,35,42.857,42.857
3,0.960,Deer,23-5,17,51,0,68,25.000,25.000
3,0.960,Great Horned Owl,16-23,0,4,0,4,0.000,0.000
3,0.960,Great Horned Owl,23-5,1,17,0,18,5.556,5.556
3,0.960,Freshwater Lagoon,16-23,0,0,0,0,NaN,NaN
3,0.960,Freshwater Lagoon,23-5,0,0,0,0,NaN,NaN
3,0.960,Unknown Avian,16-23,0,0,0,0,NaN,NaN
3,0.960,Unknown Avian,23-5,0,0,0,0,NaN,NaN
3,0.960,Human UTI,16-23,92,91,0,183,50.273,50.273
3,0.960,Human UTI,23-5,109,97,0,206,52.913,52.913
3,0.960,unknown,16-23,0,5,0,5,0.000,0.000
3,0.960,unknown,23-5,3,13,0,16,18.750,18.750
3,0.960,SLO Creek Water,16-23,0,0,0,0,NaN,NaN
3,0.960,SLO Creek Water,23-5,1,0,0,1,100.000,100.000
3,0.960,Pig/Swine,16-23,16,9,0,25,64.000,64.000
3,0.960,Pig/Swine,23-5,10,6,0,16,62.500,62.500
3,0.960,Klebsiella,16-23,0,0,0,0,NaN,NaN
3,0.960,Klebsiella,23-5,0,0,0,0,NaN,NaN
3,0.960,Hu Cw and Dg,16-23,11,33,0,44,25.000,25.000
3,0.960,Hu Cw and Dg,23-5,28,33,0,61,45.902,45.902
3,0.960,Ground Squirrel,16-23,112,99,0,211,53.081,53.081
3,0.960,Ground Squirrel,23-5,101,125,0,226,44.690,44.690
3,0.960,Opossum,16-23,0,1,0,1,0.000,0.000
3,0.960,Opossum,23-5,0,9,0,9,0.000,0.000
3,0.960,Cow,16-23,1542,876,0,2418,63.772,63.772
3,0.960,Cow,23-5,1493,1046,0,2539,58.803,58.803
3,0.960,Deer Mouse,16-23,0,0,0,0,NaN,NaN
3,0.960,Deer Mouse,23-5,0,0,0,0,NaN,NaN
3,0.960,OVERALL,16-23,3969,2347,0,6316,62.840,62.840
3,0.960,OVERALL,23-5,4578,2999,0,7577,60.420,60.420
3,0.970,Chicken,16-23,9,28,0,37,24.324,24.324
3,0.970,Chicken,23-5,17,17,0,34,50.000,50.000
3,0.970,Sea Lion,16-23,1,1,0,2,50.000,50.000
3,0.970,Sea Lion,23-5,4,5,0,9,44.444,44.444
3,0.970,Hu and Cw,16-23,14,25,0,39,35.897,35.897
3,0.970,Hu and Cw,23-5,18,40,0,58,31.034,31.034
3,0.970,Sheep,16-23,68,73,0,141,48.227,48.227
3,0.970,Sheep,23-5,72,40,0,112,64.286,64.286
3,0.970,Hu and Dg,16-23,11,18,0,29,37.931,37.931
3,0.970,Hu and Dg,23-5,18,7,0,25,72.000,72.000
3,0.970,Common Loon,16-23,0,2,0,2,0.000,0.000
3,0.970,Common Loon,23-5,0,4,0,4,0.000,0.000
3,0.970,Red-Winged Blackbird,16-23,0,8,0,8,0.000,0.000
3,0.970,Red-Winged Blackbird,23-5,0,3,0,3,0.000,0.000
3,0.970,Cw,16-23,11,15,0,26,42.308,42.308
3,0.970,Cw,23-5,20,31,0,51,39.216,39.216
3,0.970,Cliff Sparrow,16-23,12,41,0,53,22.642,22.642
3,0.970,Cliff Sparrow,23-5,3,42,0,45,6.667,6.667
3,0.970,Pig,16-23,13,22,0,35,37.143,37.143
3,0.970,Pig,23-5,8,13,0,21,38.095,38.095
3,0.970,Barn Owl,16-23,0,0,0,0,NaN,NaN
3,0.970,Barn Owl,23-5,0,5,0,5,0.000,0.000
3,0.970,Wild Pig,16-23,7,13,0,20,35.000,35.000
3,0.970,Wild Pig,23-5,9,8,0,17,52.941,52.941
3,0.970,Pennington Creek Water,16-23,0,0,0,0,NaN,NaN
3,0.970,Pennington Creek Water,23-5,0,0,0,0,NaN,NaN
3,0.970,Guinni,16-23,0,0,0,0,NaN,NaN
3,0.970,Guinni,23-5,0,2,0,2,0.000,0.000
3,0.970,Racoon,16-23,2,3,0,5,40.000,40.000
3,0.970,Racoon,23-5,0,2,0,2,0.000,0.000
3,0.970,Hu,16-23,20,9,0,29,68.966,68.966
3,0.970,Hu,23-5,20,8,0,28,71.429,71.429
3,0.970,Cw and Dg,16-23,12,17,0,29,41.379,41.379
3,0.970,Cw and Dg,23-5,19,18,0,37,51.351,51.351
3,0.970,Red Wind Blackbird,16-23,0,2,0,2,0.000,0.000
3,0.970,Red Wind Blackbird,23-5,0,3,0,3,0.000,0.000
3,0.970,Tree Swallow,16-23,0,2,0,2,0.000,0.000
3,0.970,Tree Swallow,23-5,0,7,0,7,0.000,0.000
3,0.970,Turkey Vulture,16-23,0,1,0,1,0.000,0.000
3,0.970,Turkey Vulture,23-5,0,2,0,2,0.000,0.000
3,0.970,Dg,16-23,9,14,0,23,39.130,39.130
3,0.970,Dg,23-5,29,23,0,52,55.769,55.769
3,0.970,Western Kingbird,16-23,0,1,0,1,0.000,0.000
3,0.970,Western Kingbird,23-5,0,1,0,1,0.000,0.000
3,0.970,White Crowned Sparrow,16-23,12,10,0,22,54.545,54.545
3,0.970,White Crowned Sparrow,23-5,5,27,0,32,15.625,15.625
3,0.970,Eared Grebe,16-23,0,0,0,0,NaN,NaN
3,0.970,Eared Grebe,23-5,4,14,0,18,22.222,22.222
3,0.970,cougar,16-23,0,0,0,0,NaN,NaN
3,0.970,cougar,23-5,0,0,0,0,NaN,NaN
3,0.970,Ocean Water,16-23,0,0,0,0,NaN,NaN
3,0.970,Ocean Water,23-5,0,0,0,0,NaN,NaN
3,0.970,Red Tailed Hawk,16-23,0,2,0,2,0.000,0.000
3,0.970,Red Tailed Hawk,23-5,0,18,0,18,0.000,0.000
3,0.970,Dog,16-23,77,99,0,176,43.750,43.750
3,0.970,Dog,23-5,130,144,0,274,47.445,47.445
3,0.970,Human,16-23,1705,510,0,2215,76.975,76.975
3,0.970,Human,23-5,2174,407,0,2581,84.231,84.231
3,0.970,Wild Turkey,16-23,10,34,0,44,22.727,22.727
3,0.970,Wild Turkey,23-5,6,50,0,56,10.714,10.714
3,0.970,Clark Grebe,16-23,0,0,0,0,NaN,NaN
3,0.970,Clark Grebe,23-5,0,2,0,2,0.000,0.000
3,0.970,Seagull,16-23,0,0,0,0,NaN,NaN
3,0.970,Seagull,23-5,26,6,0,32,81.250,81.250
3,0.970,Surf Scoter,16-23,0,0,0,0,NaN,NaN
3,0.970,Surf Scoter,23-5,0,2,0,2,0.000,0.000
3,0.970,Pigeon,16-23,99,150,0,249,39.759,39.759
3,0.970,Pigeon,23-5,117,282,0,399,29.323,29.323
3,0.970,Pacific Ocean Water,16-23,0,0,0,0,NaN,NaN
3,0.970,Pacific Ocean Water,23-5,0,0,0,0,NaN,NaN
3,0.970,Cat,16-23,30,41,0,71,42.254,42.254
3,0.970,Cat,23-5,33,48,0,81,40.741,40.741
3,0.970,Horse,16-23,21,54,0,75,28.000,28.000
3,0.970,Horse,23-5,41,300,0,341,12.023,12.023
3,0.970,orangutan,16-23,0,0,0,0,NaN,NaN
3,0.970,orangutan,23-5,0,0,0,0,NaN,NaN
3,0.970,Bat,16-23,36,11,0,47,76.596,76.596
3,0.970,Bat,23-5,37,19,0,56,66.071,66.071
3,0.970,Deer,16-23,15,20,0,35,42.857,42.857
3,0.970,Deer,23-5,17,51,0,68,25.000,25.000
3,0.970,Great Horned Owl,16-23,0,4,0,4,0.000,0.000
3,0.970,Great Horned Owl,23-5,1,17,0,18,5.556,5.556
3,0.970,Freshwater Lagoon,16-23,0,0,0,0,NaN,NaN
3,0.970,Freshwater Lagoon,23-5,0,0,0,0,NaN,NaN
3,0.970,Unknown Avian,16-23,0,0,0,0,NaN,NaN
3,0.970,Unknown Avian,23-5,0,0,0,0,NaN,NaN
3,0.970,Human UTI,16-23,93,91,0,184,50.543,50.543
3,0.970,Human UTI,23-5,107,96,0,203,52.709,52.709
3,0.970,unknown,16-23,0,5,0,5,0.000,0.000
3,0.970,unknown,23-5,3,13,0,16,18.750,18.750
3,0.970,SLO Creek Water,16-23,0,0,0,0,NaN,NaN
3,0.970,SLO Creek Water,23-5,1,0,0,1,100.000,100.000
3,0.970,Pig/Swine,16-23,16,9,0,25,64.000,64.000
3,0.970,Pig/Swine,23-5,10,6,0,16,62.500,62.500
3,0.970,Klebsiella,16-23,0,0,0,0,NaN,NaN
3,0.970,Klebsiella,23-5,0,0,0,0,NaN,NaN
3,0.970,Hu Cw and Dg,16-23,11,33,0,44,25.000,25.000
3,0.970,Hu Cw and Dg,23-5,28,33,0,61,45.902,45.902
3,0.970,Ground Squirrel,16-23,112,97,0,209,53.589,53.589
3,0.970,Ground Squirrel,23-5,101,123,0,224,45.089,45.089
3,0.970,Opossum,16-23,0,1,0,1,0.000,0.000
3,0.970,Opossum,23-5,0,9,0,9,0.000,0.000
3,0.970,Cow,16-23,1538,876,0,2414,63.712,63.712
3,0.970,Cow,23-5,1491,1039,0,2530,58.933,58.933
3,0.970,Deer Mouse,16-23,0,0,0,0,NaN,NaN
3,0.970,Deer Mouse,23-5,0,0,0,0,NaN,NaN
3,0.970,OVERALL,16-23,3964,2342,0,6306,62.861,62.861
3,0.970,OVERALL,23-5,4569,2987,0,7556,60.469,60.469
3,0.980,Chicken,16-23,9,28,0,37,24.324,24.324
3,0.980,Chicken,23-5,17,17,0,34,50.000,50.000
3,0.980,Sea Lion,16-23,1,1,0,2,50.000,50.000
3,0.980,Sea Lion,23-5,4,5,0,9,44.444,44.444
3,0.980,Hu and Cw,16-23,14,25,0,39,35.897,35.897
3,0.980,Hu and Cw,23-5,18,40,0,58,31.034,31.034
3,0.980,Sheep,16-23,68,72,0,140,48.571,48.571
3,0.980,Sheep,23-5,71,40,0,111,63.964,63.964
3,0.980,Hu and Dg,16-23,11,18,0,29,37.931,37.931
3,0.980,Hu and Dg,23-5,18,7,0,25,72.000,72.000
3,0.980,Common Loon,16-23,0,2,0,2,0.000,0.000
3,0.980,Common Loon,23-5,0,3,0,3,0.000,0.000
3,0.980,Red-Winged Blackbird,16-23,0,8,0,8,0.000,0.000
3,0.980,Red-Winged Blackbird,23-5,0,3,0,3,0.000,0.000
3,0.980,Cw,16-23,11,14,0,25,44.000,44.000
3,0.980,Cw,23-5,20,31,0,51,39.216,39.216
3,0.980,Cliff Sparrow,16-23,12,39,0,51,23.529,23.529
3,0.980,Cliff Sparrow,23-5,3,42,0,45,6.667,6.667
3,0.980,Pig,16-23,13,22,0,35,37.143,37.143
3,0.980,Pig,23-5,8,13,0,21,38.095,38.095
3,0.980,Barn Owl,16-23,0,0,0,0,NaN,NaN
3,0.980,Barn Owl,23-5,0,5,0,5,0.000,0.000
3,0.980,Wild Pig,16-23,7,13,0,20,35.000,35.000
3,0.980,Wild Pig,23-5,9,8,0,17,52.941,52.941
3,0.980,Pennington Creek Water,16-23,0,0,0,0,NaN,NaN
3,0.980,Pennington Creek Water,23-5,0,0,0,0,NaN,NaN
3,0.980,Guinni,16-23,0,0,0,0,NaN,NaN
3,0.980,Guinni,23-5,0,2,0,2,0.000,0.000
3,0.980,Racoon,16-23,2,3,0,5,40.000,40.000
3,0.980,Racoon,23-5,0,2,0,2,0.000,0.000
3,0.980,Hu,16-23,20,9,0,29,68.966,68.966
3,0.980,Hu,23-5,20,8,0,28,71.429,71.429
3,0.980,Cw and Dg,16-23,12,17,0,29,41.379,41.379
3,0.980,Cw and Dg,23-5,19,17,0,36,52.778,52.778
3,0.980,Red Wind Blackbird,16-23,0,2,0,2,0.000,0.000
3,0.980,Red Wind Blackbird,23-5,0,3,0,3,0.000,0.000
3,0.980,Tree Swallow,16-23,0,2,0,2,0.000,0.000
3,0.980,Tree Swallow,23-5,0,7,0,7,0.000,0.000
3,0.980,Turkey Vulture,16-23,0,1,0,1,0.000,0.000
3,0.980,Turkey Vulture,23-5,0,2,0,2,0.000,0.000
3,0.980,Dg,16-23,9,14,0,23,39.130,39.130
3,0.980,Dg,23-5,29,23,0,52,55.769,55.769
3,0.980,Western Kingbird,16-23,0,1,0,1,0.000,0.000
3,0.980,Western Kingbird,23-5,0,1,0,1,0.000,0.000
3,0.980,White Crowned Sparrow,16-23,12,10,0,22,54.545,54.545
3,0.980,White Crowned Sparrow,23-5,5,27,0,32,15.625,15.625
3,0.980,Eared Grebe,16-23,0,0,0,0,NaN,NaN
3,0.980,Eared Grebe,23-5,4,14,0,18,22.222,22.222
3,0.980,cougar,16-23,0,0,0,0,NaN,NaN
3,0.980,cougar,23-5,0,0,0,0,NaN,NaN
3,0.980,Ocean Water,16-23,0,0,0,0,NaN,NaN
3,0.980,Ocean Water,23-5,0,0,0,0,NaN,NaN
3,0.980,Red Tailed Hawk,16-23,0,2,0,2,0.000,0.000
3,0.980,Red Tailed Hawk,23-5,0,17,0,17,0.000,0.000
3,0.980,Dog,16-23,76,101,0,177,42.938,42.938
3,0.980,Dog,23-5,130,142,0,272,47.794,47.794
3,0.980,Human,16-23,1704,503,0,2207,77.209,77.209
3,0.980,Human,23-5,2170,398,0,2568,84.502,84.502
3,0.980,Wild Turkey,16-23,10,33,0,43,23.256,23.256
3,0.980,Wild Turkey,23-5,8,52,0,60,13.333,13.333
3,0.980,Clark Grebe,16-23,0,0,0,0,NaN,NaN
3,0.980,Clark Grebe,23-5,0,2,0,2,0.000,0.000
3,0.980,Seagull,16-23,0,0,0,0,NaN,NaN
3,0.980,Seagull,23-5,28,4,0,32,87.500,87.500
3,0.980,Surf Scoter,16-23,0,0,0,0,NaN,NaN
3,0.980,Surf Scoter,23-5,2,0,0,2,100.000,100.000
3,0.980,Pigeon,16-23,98,150,0,248,39.516,39.516
3,0.980,Pigeon,23-5,116,288,0,404,28.713,28.713
3,0.980,Pacific Ocean Water,16-23,0,0,0,0,NaN,NaN
3,0.980,Pacific Ocean Water,23-5,0,0,0,0,NaN,NaN
3,0.980,Cat,16-23,30,40,0,70,42.857,42.857
3,0.980,Cat,23-5,33,46,0,79,41.772,41.772
3,0.980,Horse,16-23,21,54,0,75,28.000,28.000
3,0.980,Horse,23-5,41,295,0,336,12.202,12.202
3,0.980,orangutan,16-23,0,0,0,0,NaN,NaN
3,0.980,orangutan,23-5,0,0,0,0,NaN,NaN
3,0.980,Bat,16-23,36,11,0,47,76.596,76.596
3,0.980,Bat,23-5,37,19,0,56,66.071,66.071
3,0.980,Deer,16-23,15,20,0,35,42.857,42.857
3,0.980,Deer,23-5,17,51,0,68,25.000,25.000
3,0.980,Great Horned Owl,16-23,0,4,0,4,0.000,0.000
3,0.980,Great Horned Owl,23-5,1,17,0,18,5.556,5.556
3,0.980,Freshwater Lagoon,16-23,0,0,0,0,NaN,NaN
3,0.980,Freshwater Lagoon,23-5,0,0,0,0,NaN,NaN
3,0.980,Unknown Avian,16-23,0,0,0,0,NaN,NaN
3,0.980,Unknown Avian,23-5,0,0,0,0,NaN,NaN
3,0.980,Human UTI,16-23,93,91,0,184,50.543,50.543
3,0.980,Human UTI,23-5,107,92,0,199,53.769,53.769
3,0.980,unknown,16-23,0,5,0,5,0.000,0.000
3,0.980,unknown,23-5,3,13,0,16,18.750,18.750
3,0.980,SLO Creek Water,16-23,0,0,0,0,NaN,NaN
3,0.980,SLO Creek Water,23-5,1,0,0,1,100.000,100.000
3,0.980,Pig/Swine,16-23,16,9,0,25,64.000,64.000
3,0.980,Pig/Swine,23-5,10,6,0,16,62.500,62.500
3,0.980,Klebsiella,16-23,0,0,0,0,NaN,NaN
3,0.980,Klebsiella,23-5,0,0,0,0,NaN,NaN
3,0.980,Hu Cw and Dg,16-23,11,33,0,44,25.000,25.000
3,0.980,Hu Cw and Dg,23-5,28,33,0,61,45.902,45.902
3,0.980,Ground Squirrel,16-23,110,96,0,206,53.398,53.398
3,0.980,Ground Squirrel,23-5,101,121,0,222,45.495,45.495
3,0.980,Opossum,16-23,0,1,0,1,0.000,0.000
3,0.980,Opossum,23-5,0,9,0,9,0.000,0.000
3,0.980,Cow,16-23,1533,868,0,2401,63.848,63.848
3,0.980,Cow,23-5,1484,1024,0,2508,59.171,59.171
3,0.980,Deer Mouse,16-23,0,0,0,0,NaN,NaN
3,0.980,Deer Mouse,23-5,0,0,0,0,NaN,NaN
3,0.980,OVERALL,16-23,3954,2322,0,6276,63.002,63.002
3,0.980,OVERALL,23-5,4562,2949,0,7511,60.738,60.738
3,0.990,Chicken,16-23,9,29,0,38,23.684,23.684
3,0.990,Chicken,23-5,18,16,0,34,52.941,52.941
3,0.990,Sea Lion,16-23,1,1,0,2,50.000,50.000
3,0.990,Sea Lion,23-5,4,5,0,9,44.444,44.444
3,0.990,Hu and Cw,16-23,15,25,0,40,37.500,37.500
3,0.990,Hu and Cw,23-5,19,37,0,56,33.929,33.929
3,0.990,Sheep,16-23,67,70,0,137,48.905,48.905
3,0.990,Sheep,23-5,71,40,0,111,63.964,63.964
3,0.990,Hu and Dg,16-23,11,18,0,29,37.931,37.931
3,0.990,Hu and Dg,23-5,18,6,0,24,75.000,75.000
3,0.990,Common Loon,16-23,0,2,0,2,0.000,0.000
3,0.990,Common Loon,23-5,0,4,0,4,0.000,0.000
3,0.990,Red-Winged Blackbird,16-23,0,7,0,7,0.000,0.000
3,0.990,Red-Winged Blackbird,23-5,0,3,0,3,0.000,0.000
3,0.990,Cw,16-23,11,14,0,25,44.000,44.000
3,0.990,Cw,23-5,20,31,0,51,39.216,39.216
3,0.990,Cliff Sparrow,16-23,12,38,0,50,24.000,24.000
3,0.990,Cliff Sparrow,23-5,3,43,0,46,6.522,6.522
3,0.990,Pig,16-23,13,21,0,34,38.235,38.235
3,0.990,Pig,23-5,8,13,0,21,38.095,38.095
3,0.990,Barn Owl,16-23,0,0,0,0,NaN,NaN
3,0.990,Barn Owl,23-5,0,4,0,4,0.000,0.000
3,0.990,Wild Pig,16-23,7,15,0,22,31.818,31.818
3,0.990,Wild Pig,23-5,9,7,0,16,56.250,56.250
3,0.990,Pennington Creek Water,16-23,0,0,0,0,NaN,NaN
3,0.990,Pennington Creek Water,23-5,0,0,0,0,NaN,NaN
3,0.990,Guinni,16-23,0,0,0,0,NaN,NaN
3,0.990,Guinni,23-5,0,1,0,1,0.000,0.000
3,0.990,Racoon,16-23,2,3,0,5,40.000,40.000
3,0.990,Racoon,23-5,0,2,0,2,0.000,0.000
3,0.990,Hu,16-23,20,8,0,28,71.429,71.429
3,0.990,Hu,23-5,20,5,0,25,80.000,80.000
3,0.990,Cw and Dg,16-23,12,17,0,29,41.379,41.379
3,0.990,Cw and Dg,23-5,19,13,0,32,59.375,59.375
3,0.990,Red Wind Blackbird,16-23,0,2,0,2,0.000,0.000
3,0.990,Red Wind Blackbird,23-5,0,3,0,3,0.000,0.000
3,0.990,Tree Swallow,16-23,0,2,0,2,0.000,0.000
3,0.990,Tree Swallow,23-5,0,7,0,7,0.000,0.000
3,0.990,Turkey Vulture,16-23,0,1,0,1,0.000,0.000
3,0.990,Turkey Vulture,23-5,0,2,0,2,0.000,0.000
3,0.990,Dg,16-23,9,14,0,23,39.130,39.130
3,0.990,Dg,23-5,29,22,0,51,56.863,56.863
3,0.990,Western Kingbird,16-23,0,1,0,1,0.000,0.000
3,0.990,Western Kingbird,23-5,0,1,0,1,0.000,0.000
3,0.990,White Crowned Sparrow,16-23,12,10,0,22,54.545,54.545
3,0.990,White Crowned Sparrow,23-5,5,27,0,32,15.625,15.625
3,0.990,Eared Grebe,16-23,0,0,0,0,NaN,NaN
3,0.990,Eared Grebe,23-5,4,13,0,17,23.529,23.529
3,0.990,cougar,16-23,0,1,0,1,0.000,0.000
3,0.990,cougar,23-5,0,0,0,0,NaN,NaN
3,0.990,Ocean Water,16-23,0,0,0,0,NaN,NaN
3,0.990,Ocean Water,23-5,0,0,0,0,NaN,NaN
3,0.990,Red Tailed Hawk,16-23,0,2,0,2,0.000,0.000
3,0.990,Red Tailed Hawk,23-5,0,17,0,17,0.000,0.000
3,0.990,Dog,16-23,77,95,0,172,44.767,44.767
3,0.990,Dog,23-5,129,138,0,267,48.315,48.315
3,0.990,Human,16-23,1688,478,0,2166,77.932,77.932
3,0.990,Human,23-5,2154,380,0,2534,85.004,85.004
3,0.990,Wild Turkey,16-23,12,31,0,43,27.907,27.907
3,0.990,Wild Turkey,23-5,8,45,0,53,15.094,15.094
3,0.990,Clark Grebe,16-23,0,0,0,0,NaN,NaN
3,0.990,Clark Grebe,23-5,2,3,0,5,40.000,40.000
3,0.990,Seagull,16-23,0,0,0,0,NaN,NaN
3,0.990,Seagull,23-5,28,4,0,32,87.500,87.500
3,0.990,Surf Scoter,16-23,0,0,0,0,NaN,NaN
3,0.990,Surf Scoter,23-5,2,0,0,2,100.000,100.000
3,0.990,Pigeon,16-23,100,146,0,246,40.650,40.650
3,0.990,Pigeon,23-5,116,267,0,383,30.287,30.287
3,0.990,Pacific Ocean Water,16-23,0,0,0,0,NaN,NaN
3,0.990,Pacific Ocean Water,23-5,0,0,0,0,NaN,NaN
3,0.990,Cat,16-23,30,38,0,68,44.118,44.118
3,0.990,Cat,23-5,33,43,0,76,43.421,43.421
3,0.990,Horse,16-23,21,50,0,71,29.577,29.577
3,0.990,Horse,23-5,40,287,0,327,12.232,12.232
3,0.990,orangutan,16-23,0,0,0,0,NaN,NaN
3,0.990,orangutan,23-5,0,0,0,0,NaN,NaN
3,0.990,Bat,16-23,36,11,0,47,76.596,76.596
3,0.990,Bat,23-5,37,18,0,55,67.273,67.273
3,0.990,Deer,16-23,15,20,0,35,42.857,42.857
3,0.990,Deer,23-5,17,50,0,67,25.373,25.373
3,0.990,Great Horned Owl,16-23,0,4,0,4,0.000,0.000
3,0.990,Great Horned Owl,23-5,1,16,0,17,5.882,5.882
3,0.990,Freshwater Lagoon,16-23,0,0,0,0,NaN,NaN
3,0.990,Freshwater Lagoon,23-5,0,0,0,0,NaN,NaN
3,0.990,Unknown Avian,16-23,0,0,0,0,NaN,NaN
3,0.990,Unknown Avian,23-5,0,0,0,0,NaN,NaN
3,0.990,Human UTI,16-23,97,84,0,181,53.591,53.591
3,0.990,Human UTI,23-5,108,77,0,185,58.378,58.378
3,0.990,unknown,16-23,0,5,0,5,0.000,0.000
3,0.990,unknown,23-5,3,12,0,15,20.000,20.000
3,0.990,SLO Creek Water,16-23,0,0,0,0,NaN,NaN
3,0.990,SLO Creek Water,23-5,1,0,0,1,100.000,100.000
3,0.990,Pig/Swine,16-23,15,9,0,24,62.500,62.500
3,0.990,Pig/Swine,23-5,10,7,0,17,58.824,58.824
3,0.990,Klebsiella,16-23,0,0,0,0,NaN,NaN
3,0.990,Klebsiella,23-5,0,0,0,0,NaN,NaN
3,0.990,Hu Cw and Dg,16-23,11,33,0,44,25.000,25.000
3,0.990,Hu Cw and Dg,23-5,28,33,0,61,45.902,45.902
3,0.990,Ground Squirrel,16-23,109,88,0,197,55.330,55.330
3,0.990,Ground Squirrel,23-5,100,111,0,211,47.393,47.393
3,0.990,Opossum,16-23,1,1,0,2,50.000,50.000
3,0.990,Opossum,23-5,2,9,0,11,18.182,18.182
3,0.990,Cow,16-23,1498,809,0,2307,64.933,64.933
3,0.990,Cow,23-5,1456,961,0,2417,60.240,60.240
3,0.990,Deer Mouse,16-23,0,0,0,0,NaN,NaN
3,0.990,Deer Mouse,23-5,0,0,0,0,NaN,NaN
3,0.990,OVERALL,16-23,3911,2203,0,6114,63.968,63.968
3,0.990,OVERALL,23-5,4522,2783,0,7305,61.903,61.903
3,1.000,Chicken,16-23,0,0,0,0,NaN,NaN
3,1.000,Chicken,23-5,0,0,0,0,NaN,NaN
3,1.000,Sea Lion,16-23,0,0,0,0,NaN,NaN
3,1.000,Sea Lion,23-5,0,0,0,0,NaN,NaN
3,1.000,Hu and Cw,16-23,0,0,0,0,NaN,NaN
3,1.000,Hu and Cw,23-5,0,0,0,0,NaN,NaN
3,1.000,Sheep,16-23,0,0,0,0,NaN,NaN
3,1.000,Sheep,23-5,0,0,0,0,NaN,NaN
3,1.000,Hu and Dg,16-23,0,0,0,0,NaN,NaN
3,1.000,Hu and Dg,23-5,0,0,0,0,NaN,NaN
3,1.000,Common Loon,16-23,0,0,0,0,NaN,NaN
3,1.000,Common Loon,23-5,0,0,0,0,NaN,NaN
3,1.000,Red-Winged Blackbird,16-23,0,0,0,0,NaN,NaN
3,1.000,Red-Winged Blackbird,23-5,0,0,0,0,NaN,NaN
3,1.000,Cw,16-23,0,0,0,0,NaN,NaN
3,1.000,Cw,23-5,0,0,0,0,NaN,NaN
3,1.000,Cliff Sparrow,16-23,0,0,0,0,NaN,NaN
3,1.000,Cliff Sparrow,23-5,0,0,0,0,NaN,NaN
3,1.000,Pig,16-23,0,0,0,0,NaN,NaN
3,1.000,Pig,23-5,0,0,0,0,NaN,NaN
3,1.000,Barn Owl,16-23,0,0,0,0,NaN,NaN
3,1.000,Barn Owl,23-5,0,0,0,0,NaN,NaN
3,1.000,Wild Pig,16-23,0,0,0,0,NaN,NaN
3,1.000,Wild Pig,23-5,0,0,0,0,NaN,NaN
3,1.000,Pennington Creek Water,16-23,0,0,0,0,NaN,NaN
3,1.000,Pennington Creek Water,23-5,0,0,0,0,NaN,NaN
3,1.000,Guinni,16-23,0,0,0,0,NaN,NaN
3,1.000,Guinni,23-5,0,0,0,0,NaN,NaN
3,1.000,Racoon,16-23,0,0,0,0,NaN,NaN
3,1.000,Racoon,23-5,0,0,0,0,NaN,NaN
3,1.000,Hu,16-23,0,0,0,0,NaN,NaN
3,1.000,Hu,23-5,0,0,0,0,NaN,NaN
3,1.000,Cw and Dg,16-23,0,0,0,0,NaN,NaN
3,1.000,Cw and Dg,23-5,0,0,0,0,NaN,NaN
3,1.000,Red Wind Blackbird,16-23,0,0,0,0,NaN,NaN
3,1.000,Red Wind Blackbird,23-5,0,0,0,0,NaN,NaN
3,1.000,Tree Swallow,16-23,0,0,0,0,NaN,NaN
3,1.000,Tree Swallow,23-5,0,0,0,0,NaN,NaN
3,1.000,Turkey Vulture,16-23,0,0,0,0,NaN,NaN
3,1.000,Turkey Vulture,23-5,0,0,0,0,NaN,NaN
3,1.000,Dg,16-23,0,0,0,0,NaN,NaN
3,1.000,Dg,23-5,0,0,0,0,NaN,NaN
3,1.000,Western Kingbird,16-23,0,0,0,0,NaN,NaN
3,1.000,Western Kingbird,23-5,0,0,0,0,NaN,NaN
3,1.000,White Crowned Sparrow,16-23,0,0,0,0,NaN,NaN
3,1.000,White Crowned Sparrow,23-5,0,0,0,0,NaN,NaN
3,1.000,Eared Grebe,16-23,0,0,0,0,NaN,NaN
3,1.000,Eared Grebe,23-5,0,0,0,0,NaN,NaN
3,1.000,cougar,16-23,0,0,0,0,NaN,NaN
3,1.000,cougar,23-5,0,0,0,0,NaN,NaN
3,1.000,Ocean Water,16-23,0,0,0,0,NaN,NaN
3,1.000,Ocean Water,23-5,0,0,0,0,NaN,NaN
3,1.000,Red Tailed Hawk,16-23,0,0,0,0,NaN,NaN
3,1.000,Red Tailed Hawk,23-5,0,0,0,0,NaN,NaN
3,1.000,Dog,16-23,0,0,0,0,NaN,NaN
3,1.000,Dog,23-5,0,0,0,0,NaN,NaN
3,1.000,Human,16-23,0,0,0,0,NaN,NaN
3,1.000,Human,23-5,0,0,0,0,NaN,NaN
3,1.000,Wild Turkey,16-23,0,0,0,0,NaN,NaN
3,1.000,Wild Turkey,23-5,0,0,0,0,NaN,NaN
3,1.000,Clark Grebe,16-23,0,0,0,0,NaN,NaN
3,1.000,Clark Grebe,23-5,0,0,0,0,NaN,NaN
3,1.000,Seagull,16-23,0,0,0,0,NaN,NaN
3,1.000,Seagull,23-5,0,0,0,0,NaN,NaN
3,1.000,Surf Scoter,16-23,0,0,0,0,NaN,NaN
3,1.000,Surf Scoter,23-5,0,0,0,0,NaN,NaN
3,1.000,Pigeon,16-23,0,0,0,0,NaN,NaN
3,1.000,Pigeon,23-5,0,0,0,0,NaN,NaN
3,1.000,Pacific Ocean Water,16-23,0,0,0,0,NaN,NaN
3,1.000,Pacific Ocean Water,23-5,0,0,0,0,NaN,NaN
3,1.000,Cat,16-23,0,0,0,0,NaN,NaN
3,1.000,Cat,23-5,0,0,0,0,NaN,NaN
3,1.000,Horse,16-23,0,0,0,0,NaN,NaN
3,1.000,Horse,23-5,0,0,0,0,NaN,NaN
3,1.000,orangutan,16-23,0,0,0,0,NaN,NaN
3,1.000,orangutan,23-5,0,0,0,0,NaN,NaN
3,1.000,Bat,16-23,0,0,0,0,NaN,NaN
3,1.000,Bat,23-5,0,0,0,0,NaN,NaN
3,1.000,Deer,16-23,0,0,0,0,NaN,NaN
3,1.000,Deer,23-5,0,0,0,0,NaN,NaN
3,1.000,Great Horned Owl,16-23,0,0,0,0,NaN,NaN
3,1.000,Great Horned Owl,23-5,0,0,0,0,NaN,NaN
3,1.000,Freshwater Lagoon,16-23,0,0,0,0,NaN,NaN
3,1.000,Freshwater Lagoon,23-5,0,0,0,0,NaN,NaN
3,1.000,Unknown Avian,16-23,0,0,0,0,NaN,NaN
3,1.000,Unknown Avian,23-5,0,0,0,0,NaN,NaN
3,1.000,Human UTI,16-23,0,0,0,0,NaN,NaN
3,1.000,Human UTI,23-5,0,0,0,0,NaN,NaN
3,1.000,unknown,16-23,0,0,0,0,NaN,NaN
3,1.000,unknown,23-5,0,0,0,0,NaN,NaN
3,1.000,SLO Creek Water,16-23,0,0,0,0,NaN,NaN
3,1.000,SLO Creek Water,23-5,0,0,0,0,NaN,NaN
3,1.000,Pig/Swine,16-23,0,0,0,0,NaN,NaN
3,1.000,Pig/Swine,23-5,0,0,0,0,NaN,NaN
3,1.000,Klebsiella,16-23,0,0,0,0,NaN,NaN
3,1.000,Klebsiella,23-5,0,0,0,0,NaN,NaN
3,1.000,Hu Cw and Dg,16-23,0,0,0,0,NaN,NaN
3,1.000,Hu Cw and Dg,23-5,0,0,0,0,NaN,NaN
3,1.000,Ground Squirrel,16-23,0,0,0,0,NaN,NaN
3,1.000,Ground Squirrel,23-5,0,0,0,0,NaN,NaN
3,1.000,Opossum,16-23,0,0,0,0,NaN,NaN
3,1.000,Opossum,23-5,0,0,0,0,NaN,NaN
3,1.000,Cow,16-23,0,0,0,0,NaN,NaN
3,1.000,Cow,23-5,0,0,0,0,NaN,NaN
3,1.000,Deer Mouse,16-23,0,0,0,0,NaN,NaN
3,1.000,Deer Mouse,23-5,0,0,0,0,NaN,NaN
3,1.000,OVERALL,16-23,0,0,0,0,NaN,NaN
3,1.000,OVERALL,23-5,0,0,0,0,NaN,NaN
4,0.000,Chicken,16-23,5,20,0,25,20.000,20.000
4,0.000,Chicken,23-5,17,22,0,39,43.590,43.590
4,0.000,Sea Lion,16-23,0,1,0,1,0.000,0.000
4,0.000,Sea Lion,23-5,4,9,0,13,30.769,30.769
4,0.000,Hu and Cw,16-23,10,25,0,35,28.571,28.571
4,0.000,Hu and Cw,23-5,12,28,0,40,30.000,30.000
4,0.000,Sheep,16-23,66,69,0,135,48.889,48.889
4,0.000,Sheep,23-5,70,44,0,114,61.404,61.404
4,0.000,Hu and Dg,16-23,11,18,0,29,37.931,37.931
4,0.000,Hu and Dg,23-5,16,9,0,25,64.000,64.000
4,0.000,Common Loon,16-23,0,2,0,2,0.000,0.000
4,0.000,Common Loon,23-5,0,3,0,3,0.000,0.000
4,0.000,Red-Winged Blackbird,16-23,0,10,0,10,0.000,0.000
4,0.000,Red-Winged Blackbird,23-5,0,7,0,7,0.000,0.000
4,0.000,Cw,16-23,14,14,0,28,50.000,50.000
4,0.000,Cw,23-5,25,42,0,67,37.313,37.313
4,0.000,Cliff Sparrow,16-23,10,33,0,43,23.256,23.256
4,0.000,Cliff Sparrow,23-5,1,23,0,24,4.167,4.167
4,0.000,Pig,16-23,13,12,0,25,52.000,52.000
4,0.000,Pig,23-5,7,13,0,20,35.000,35.000
4,0.000,Barn Owl,16-23,0,0,0,0,NaN,NaN
4,0.000,Barn Owl,23-5,0,1,0,1,0.000,0.000
4,0.000,Wild Pig,16-23,9,9,0,18,50.000,50.000
4,0.000,Wild Pig,23-5,8,10,0,18,44.444,44.444
4,0.000,Pennington Creek Water,16-23,0,0,0,0,NaN,NaN
4,0.000,Pennington Creek Water,23-5,0,0,0,0,NaN,NaN
4,0.000,Guinni,16-23,0,0,0,0,NaN,NaN
4,0.000,Guinni,23-5,0,2,0,2,0.000,0.000
4,0.000,Racoon,16-23,0,3,0,3,0.000,0.000
4,0.000,Racoon,23-5,0,0,0,0,NaN,NaN
4,0.000,Hu,16-23,18,14,0,32,56.250,56.250
4,0.000,Hu,23-5,20,12,0,32,62.500,62.500
4,0.000,Cw and Dg,16-23,13,19,0,32,40.625,40.625
4,0.000,Cw and Dg,23-5,17,16,0,33,51.515,51.515
4,0.000,Red Wind Blackbird,16-23,0,1,0,1,0.000,0.000
4,0.000,Red Wind Blackbird,23-5,0,3,0,3,0.000,0.000
4,0.000,Tree Swallow,16-23,0,6,0,6,0.000,0.000
4,0.000,Tree Swallow,23-5,0,6,0,6,0.000,0.000
4,0.000,Turkey Vulture,16-23,0,0,0,0,NaN,NaN
4,0.000,Turkey Vulture,23-5,0,4,0,4,0.000,0.000
4,0.000,Dg,16-23,9,16,0,25,36.000,36.000
4,0.000,Dg,23-5,30,22,0,52,57.692,57.692
4,0.000,Western Kingbird,16-23,0,0,0,0,NaN,NaN
4,0.000,Western Kingbird,23-5,0,0,0,0,NaN,NaN
4,0.000,White Crowned Sparrow,16-23,6,12,0,18,33.333,33.333
4,0.000,White Crowned Sparrow,23-5,5,22,0,27,18.519,18.519
4,0.000,Eared Grebe,16-23,0,0,0,0,NaN,NaN
4,0.000,Eared Grebe,23-5,4,17,0,21,19.048,19.048
4,0.000,cougar,16-23,0,0,0,0,NaN,NaN
4,0.000,cougar,23-5,0,0,0,0,NaN,NaN
4,0.000,Ocean Water,16-23,0,0,0,0,NaN,NaN
4,0.000,Ocean Water,23-5,0,0,0,0,NaN,NaN
4,0.000,Red Tailed Hawk,16-23,0,2,0,2,0.000,0.000
4,0.000,Red Tailed Hawk,23-5,0,12,0,12,0.000,0.000
4,0.000,Dog,16-23,74,82,0,156,47.436,47.436
4,0.000,Dog,23-5,122,156,0,278,43.885,43.885
4,0.000,Human,16-23,1722,576,0,2298,74.935,74.935
4,0.000,Human,23-5,2162,466,0,2628,82.268,82.268
4,0.000,Wild Turkey,16-23,11,35,0,46,23.913,23.913
4,0.000,Wild Turkey,23-5,6,37,0,43,13.953,13.953
4,0.000,Clark Grebe,16-23,0,0,0,0,NaN,NaN
4,0.000,Clark Grebe,23-5,0,2,0,2,0.000,0.000
4,0.000,Seagull,16-23,0,0,0,0,NaN,NaN
4,0.000,Seagull,23-5,23,9,0,32,71.875,71.875
4,0.000,Surf Scoter,16-23,0,0,0,0,NaN,NaN
4,0.000,Surf Scoter,23-5,0,4,0,4,0.000,0.000
4,0.000,Pigeon,16-23,94,188,0,282,33.333,33.333
4,0.000,Pigeon,23-5,120,349,0,469,25.586,25.586
4,0.000,Pacific Ocean Water,16-23,0,0,0,0,NaN,NaN
4,0.000,Pacific Ocean Water,23-5,0,0,0,0,NaN,NaN
4,0.000,Cat,16-23,28,40,0,68,41.176,41.176
4,0.000,Cat,23-5,29,54,0,83,34.940,34.940
4,0.000,Horse,16-23,16,45,0,61,26.230,26.230
4,0.000,Horse,23-5,40,249,0,289,13.841,13.841
4,0.000,orangutan,16-23,0,0,0,0,NaN,NaN
4,0.000,orangutan,23-5,0,0,0,0,NaN,NaN
4,0.000,Bat,16-23,36,16,0,52,69.231,69.231
4,0.000,Bat,23-5,37,25,0,62,59.677,59.677
4,0.000,Deer,16-23,15,30,0,45,33.333,33.333
4,0.000,Deer,23-5,17,76,0,93,18.280,18.280
4,0.000,Great Horned Owl,16-23,0,4,0,4,0.000,0.000
4,0.000,Great Horned Owl,23-5,0,8,0,8,0.000,0.000
4,0.000,Freshwater Lagoon,16-23,0,0,0,0,NaN,NaN
4,0.000,Freshwater Lagoon,23-5,0,0,0,0,NaN,NaN
4,0.000,Unknown Avian,16-23,0,0,0,0,NaN,NaN
4,0.000,Unknown Avian,23-5,0,0,0,0,NaN,NaN
4,0.000,Human UTI,16-23,82,92,0,174,47.126,47.126
4,0.000,Human UTI,23-5,112,104,0,216,51.852,51.852
4,0.000,unknown,16-23,0,8,0,8,0.000,0.000
4,0.000,unknown,23-5,2,10,0,12,16.667,16.667
4,0.000,SLO Creek Water,16-23,0,0,0,0,NaN,NaN
4,0.000,SLO Creek Water,23-5,0,0,0,0,NaN,NaN
4,0.000,Pig/Swine,16-23,15,10,0,25,60.000,60.000
4,0.000,Pig/Swine,23-5,11,9,0,20,55.000,55.000
4,0.000,Klebsiella,16-23,0,0,0,0,NaN,NaN
4,0.000,Klebsiella,23-5,0,0,0,0,NaN,NaN
4,0.000,Hu Cw and Dg,16-23,13,25,0,38,34.211,34.211
4,0.000,Hu Cw and Dg,23-5,22,33,0,55,40.000,40.000
4,0.000,Ground Squirrel,16-23,113,84,0,197,57.360,57.360
4,0.000,Ground Squirrel,23-5,98,114,0,212,46.226,46.226
4,0.000,Opossum,16-23,0,2,0,2,0.000,0.000
4,0.000,Opossum,23-5,0,12,0,12,0.000,0.000
4,0.000,Cow,16-23,1500,922,0,2422,61.932,61.932
4,0.000,Cow,23-5,1463,1066,0,2529,57.849,57.849
4,0.000,Deer Mouse,16-23,0,0,0,0,NaN,NaN
4,0.000,Deer Mouse,23-5,0,0,0,0,NaN,NaN
4,0.000,OVERALL,16-23,3903,2445,0,6348,61.484,61.484
4,0.000,OVERALL,23-5,4500,3110,0,7610,59.133,59.133
4,0.500,Chicken,16-23,5,20,0,25,20.000,20.000
4,0.500,Chicken,23-5,17,22,0,39,43.590,43.590
4,0.500,Sea Lion,16-23,0,1,0,1,0.000,0.000
4,0.500,Sea Lion,23-5,4,9,0,13,30.769,30.769
4,0.500,Hu and Cw,16-23,10,25,0,35,28.571,28.571
4,0.500,Hu and Cw,23-5,12,28,0,40,30.000,30.000
4,0.500,Sheep,16-23,66,69,0,135,48.889,48.889
4,0.500,Sheep,23-5,70,44,0,114,61.404,61.404
4,0.500,Hu and Dg,16-23,11,18,0,29,37.931,37.931
4,0.500,Hu and Dg,23-5,16,9,0,25,64.000,64.000
4,0.500,Common Loon,16-23,0,2,0,2,0.000,0.000
4,0.500,Common Loon,23-5,0,3,0,3,0.000,0.000
4,0.500,Red-Winged Blackbird,16-23,0,10,0,10,0.000,0.000
4,0.500,Red-Winged Blackbird,23-5,0,7,0,7,0.000,0.000
4,0.500,Cw,16-23,14,14,0,28,50.000,50.000
4,0.500,Cw,23-5,25,42,0,67,37.313,37.313
4,0.500,Cliff Sparrow,16-23,10,33,0,43,23.256,23.256
4,0.500,Cliff Sparrow,23-5,1,23,0,24,4.167,4.167
4,0.500,Pig,16-23,13,12,0,25,52.000,52.000
4,0.500,Pig,23-5,7,13,0,20,35.000,35.000
4,0.500,Barn Owl,16-23,0,0,0,0,NaN,NaN
4,0.500,Barn Owl,23-5,0,1,0,1,0.000,0.000
4,0.500,Wild Pig,16-23,9,9,0,18,50.000,50.000
4,0.500,Wild Pig,23-5,8,10,0,18,44.444,44.444
4,0.500,Pennington Creek Water,16-23,0,0,0,0,NaN,NaN
4,0.500,Pennington Creek Water,23-5,0,0,0,0,NaN,NaN
4,0.500,Guinni,16-23,0,0,0,0,NaN,NaN
4,0.500,Guinni,23-5,0,2,0,2,0.000,0.000
4,0.500,Racoon,16-23,0,3,0,3,0.000,0.000
4,0.500,Racoon,23-5,0,0,0,0,NaN,NaN
4,0.500,Hu,16-23,18,14,0,32,56.250,56.250
4,0.500,Hu,23-5,20,12,0,32,62.500,62.500
4,0.500,Cw and Dg,16-23,13,19,0,32,40.625,40.625
4,0.500,Cw and Dg,23-5,17,16,0,33,51.515,51.515
4,0.500,Red Wind Blackbird,16-23,0,1,0,1,0.000,0.000
4,0.500,Red Wind Blackbird,23-5,0,3,0,3,0.000,0.000
4,0.500,Tree Swallow,16-23,0,6,0,6,0.000,0.000
4,0.500,Tree Swallow,23-5,0,6,0,6,0.000,0.000
4,0.500,Turkey Vulture,16-23,0,0,0,0,NaN,NaN
4,0.500,Turkey Vulture,23-5,0,4,0,4,0.000,0.000
4,0.500,Dg,16-23,9,16,0,25,36.000,36.000
4,0.500,Dg,23-5,30,22,0,52,57.692,57.692
4,0.500,Western Kingbird,16-23,0,0,0,0,NaN,NaN
4,0.500,Western Kingbird,23-5,0,0,0,0,NaN,NaN
4,0.500,White Crowned Sparrow,16-23,6,12,0,18,33.333,33.333
4,0.500,White Crowned Sparrow,23-5,5,22,0,27,18.519,18.519
4,0.500,Eared Grebe,16-23,0,0,0,0,NaN,NaN
4,0.500,Eared Grebe,23-5,4,17,0,21,19.048,19.048
4,0.500,cougar,16-23,0,0,0,0,NaN,NaN
4,0.500,cougar,23-5,0,0,0,0,NaN,NaN
4,0.500,Ocean Water,16-23,0,0,0,0,NaN,NaN
4,0.500,Ocean Water,23-5,0,0,0,0,NaN,NaN
4,0.500,Red Tailed Hawk,16-23,0,2,0,2,0.000,0.000
4,0.500,Red Tailed Hawk,23-5,0,12,0,12,0.000,0.000
4,0.500,Dog,16-23,74,82,0,156,47.436,47.436
4,0.500,Dog,23-5,122,156,0,278,43.885,43.885
4,0.500,Human,16-23,1722,576,0,2298,74.935,74.935
4,0.500,Human,23-5,2162,466,0,2628,82.268,82.268
4,0.500,Wild Turkey,16-23,11,35,0,46,23.913,23.913
4,0.500,Wild Turkey,23-5,6,37,0,43,13.953,13.953
4,0.500,Clark Grebe,16-23,0,0,0,0,NaN,NaN
4,0.500,Clark Grebe,23-5,0,2,0,2,0.000,0.000
4,0.500,Seagull,16-23,0,0,0,0,NaN,NaN
4,0.500,Seagull,23-5,23,9,0,32,71.875,71.875
4,0.500,Surf Scoter,16-23,0,0,0,0,NaN,NaN
4,0.500,Surf Scoter,23-5,0,4,0,4,0.000,0.000
4,0.500,Pigeon,16-23,94,188,0,282,33.333,33.333
4,0.500,Pigeon,23-5,120,349,0,469,25.586,25.586
4,0.500,Pacific Ocean Water,16-23,0,0,0,0,NaN,NaN
4,0.500,Pacific Ocean Water,23-5,0,0,0,0,NaN,NaN
4,0.500,Cat,16-23,28,40,0,68,41.176,41.176
4,0.500,Cat,23-5,29,54,0,83,34.940,34.940
4,0.500,Horse,16-23,16,45,0,61,26.230,26.230
4,0.500,Horse,23-5,40,249,0,289,13.841,13.841
4,0.500,orangutan,16-23,0,0,0,0,NaN,NaN
4,0.500,orangutan,23-5,0,0,0,0,NaN,NaN
4,0.500,Bat,16-23,36,16,0,52,69.231,69.231
4,0.500,Bat,23-5,37,25,0,62,59.677,59.677
4,0.500,Deer,16-23,15,30,0,45,33.333,33.333
4,0.500,Deer,23-5,17,76,0,93,18.280,18.280
4,0.500,Great Horned Owl,16-23,0,4,0,4,0.000,0.000
4,0.500,Great Horned Owl,23-5,0,8,0,8,0.000,0.000
4,0.500,Freshwater Lagoon,16-23,0,0,0,0,NaN,NaN
4,0.500,Freshwater Lagoon,23-5,0,0,0,0,NaN,NaN
4,0.500,Unknown Avian,16-23,0,0,0,0,NaN,NaN
4,0.500,Unknown Avian,23-5,0,0,0,0,NaN,NaN
4,0.500,Human UTI,16-23,82,92,0,174,47.126,47.126
4,0.500,Human UTI,23-5,112,104,0,216,51.852,51.852
4,0.500,unknown,16-23,0,8,0,8,0.000,0.000
4,0.500,unknown,23-5,2,10,0,12,16.667,16.667
4,0.500,SLO Creek Water,16-23,0,0,0,0,NaN,NaN
4,0.500,SLO Creek Water,23-5,0,0,0,0,NaN,NaN
4,0.500,Pig/Swine,16-23,15,10,0,25,60.000,60.000
4,0.500,Pig/Swine,23-5,11,9,0,20,55.000,55.000
4,0.500,Klebsiella,16-23,0,0,0,0,NaN,NaN
4,0.500,Klebsiella,23-5,0,0,0,0,NaN,NaN
4,0.500,Hu Cw and Dg,16-23,13,25,0,38,34.211,34.211
4,0.500,Hu Cw and Dg,23-5,22,33,0,55,40.000,40.000
4,0.500,Ground Squirrel,16-23,113,84,0,197,57.360,57.360
4,0.500,Ground Squirrel,23-5,98,114,0,212,46.226,46.226
4,0.500,Opossum,16-23,0,2,0,2,0.000,0.000
4,0.500,Opossum,23-5,0,12,0,12,0.000,0.000
4,0.500,Cow,16-23,1500,922,0,2422,61.932,61.932
4,0.500,Cow,23-5,1463,1066,0,2529,57.849,57.849
4,0.500,Deer Mouse,16-23,0,0,0,0,NaN,NaN
4,0.500,Deer Mouse,23-5,0,0,0,0,NaN,NaN
4,0.500,OVERALL,16-23,3903,2445,0,6348,61.484,61.484
4,0.500,OVERALL,23-5,4500,3110,0,7610,59.133,59.133
4,0.900,Chicken,16-23,5,20,0,25,20.000,20.000
4,0.900,Chicken,23-5,17,22,0,39,43.590,43.590
4,0.900,Sea Lion,16-23,0,1,0,1,0.000,0.000
4,0.900,Sea Lion,23-5,4,9,0,13,30.769,30.769
4,0.900,Hu and Cw,16-23,10,25,0,35,28.571,28.571
4,0.900,Hu and Cw,23-5,12,28,0,40,30.000,30.000
4,0.900,Sheep,16-23,66,69,0,135,48.889,48.889
4,0.900,Sheep,23-5,70,44,0,114,61.404,61.404
4,0.900,Hu and Dg,16-23,11,18,0,29,37.931,37.931
4,0.900,Hu and Dg,23-5,16,9,0,25,64.000,64.000
4,0.900,Common Loon,16-23,0,2,0,2,0.000,0.000
4,0.900,Common Loon,23-5,0,3,0,3,0.000,0.000
4,0.900,Red-Winged Blackbird,16-23,0,10,0,10,0.000,0.000
4,0.900,Red-Winged Blackbird,23-5,0,7,0,7,0.000,0.000
4,0.900,Cw,16-23,14,14,0,28,50.000,50.000
4,0.900,Cw,23-5,25,42,0,67,37.313,37.313
4,0.900,Cliff Sparrow,16-23,10,33,0,43,23.256,23.256
4,0.900,Cliff Sparrow,23-5,1,23,0,24,4.167,4.167
4,0.900,Pig,16-23,13,12,0,25,52.000,52.000
4,0.900,Pig,23-5,7,13,0,20,35.000,35.000
4,0.900,Barn Owl,16-23,0,0,0,0,NaN,NaN
4,0.900,Barn Owl,23-5,0,1,0,1,0.000,0.000
4,0.900,Wild Pig,16-23,9,9,0,18,50.000,50.000
4,0.900,Wild Pig,23-5,8,10,0,18,44.444,44.444
4,0.900,Pennington Creek Water,16-23,0,0,0,0,NaN,NaN
4,0.900,Pennington Creek Water,23-5,0,0,0,0,NaN,NaN
4,0.900,Guinni,16-23,0,0,0,0,NaN,NaN
4,0.900,Guinni,23-5,0,2,0,2,0.000,0.000
4,0.900,Racoon,16-23,0,3,0,3,0.000,0.000
4,0.900,Racoon,23-5,0,0,0,0,NaN,NaN
4,0.900,Hu,16-23,18,14,0,32,56.250,56.250
4,0.900,Hu,23-5,20,12,0,32,62.500,62.500
4,0.900,Cw and Dg,16-23,13,19,0,32,40.625,40.625
4,0.900,Cw and Dg,23-5,17,16,0,33,51.515,51.515
4,0.900,Red Wind Blackbird,16-23,0,1,0,1,0.000,0.000
4,0.900,Red Wind Blackbird,23-5,0,3,0,3,0.000,0.000
4,0.900,Tree Swallow,16-23,0,6,0,6,0.000,0.000
4,0.900,Tree Swallow,23-5,0,6,0,6,0.000,0.000
4,0.900,Turkey Vulture,16-23,0,0,0,0,NaN,NaN
4,0.900,Turkey Vulture,23-5,0,4,0,4,0.000,0.000
4,0.900,Dg,16-23,9,16,0,25,36.000,36.000
4,0.900,Dg,23-5,30,22,0,52,57.692,57.692
4,0.900,Western Kingbird,16-23,0,0,0,0,NaN,NaN
4,0.900,Western Kingbird,23-5,0,0,0,0,NaN,NaN
4,0.900,White Crowned Sparrow,16-23,6,12,0,18,33.333,33.333
4,0.900,White Crowned Sparrow,23-5,5,22,0,27,18.519,18.519
4,0.900,Eared Grebe,16-23,0,0,0,0,NaN,NaN
4,0.900,Eared Grebe,23-5,4,17,0,21,19.048,19.048
4,0.900,cougar,16-23,0,0,0,0,NaN,NaN
4,0.900,cougar,23-5,0,0,0,0,NaN,NaN
4,0.900,Ocean Water,16-23,0,0,0,0,NaN,NaN
4,0.900,Ocean Water,23-5,0,0,0,0,NaN,NaN
4,0.900,Red Tailed Hawk,16-23,0,2,0,2,0.000,0.000
4,0.900,Red Tailed Hawk,23-5,0,12,0,12,0.000,0.000
4,0.900,Dog,16-23,74,82,0,156,47.436,47.436
4,0.900,Dog,23-5,122,154,0,276,44.203,44.203
4,0.900,Human,16-23,1722,572,0,2294,75.065,75.065
4,0.900,Human,23-5,2162,462,0,2624,82.393,82.393
4,0.900,Wild Turkey,16-23,11,35,0,46,23.913,23.913
4,0.900,Wild Turkey,23-5,6,37,0,43,13.953,13.953
4,0.900,Clark Grebe,16-23,0,0,0,0,NaN,NaN
4,0.900,Clark Grebe,23-5,0,2,0,2,0.000,0.000
4,0.900,Seagull,16-23,0,0,0,0,NaN,NaN
4,0.900,Seagull,23-5,23,9,0,32,71.875,71.875
4,0.900,Surf Scoter,16-23,0,0,0,0,NaN,NaN
4,0.900,Surf Scoter,23-5,0,4,0,4,0.000,0.000
4,0.900,Pigeon,16-23,94,188,0,282,33.333,33.333
4,0.900,Pigeon,23-5,120,349,0,469,25.586,25.586
4,0.900,Pacific Ocean Water,16-23,0,0,0,0,NaN,NaN
4,0.900,Pacific Ocean Water,23-5,0,0,0,0,NaN,NaN
4,0.900,Cat,16-23,28,40,0,68,41.176,41.176
4,0.900,Cat,23-5,29,54,0,83,34.940,34.940
4,0.900,Horse,16-23,16,45,0,61,26.230,26.230
4,0.900,Horse,23-5,40,249,0,289,13.841,13.841
4,0.900,orangutan,16-23,0,0,0,0,NaN,NaN
4,0.900,orangutan,23-5,0,0,0,0,NaN,NaN
4,0.900,Bat,16-23,36,16,0,52,69.231,69.231
4,0.900,Bat,23-5,37,25,0,62,59.677,59.677
4,0.900,Deer,16-23,15,30,0,45,33.333,33.333
4,0.900,Deer,23-5,17,76,0,93,18.280,18.280
4,0.900,Great Horned Owl,16-23,0,4,0,4,0.000,0.000
4,0.900,Great Horned Owl,23-5,0,8,0,8,0.000,0.000
4,0.900,Freshwater Lagoon,16-23,0,0,0,0,NaN,NaN
4,0.900,Freshwater Lagoon,23-5,0,0,0,0,NaN,NaN
4,0.900,Unknown Avian,16-23,0,0,0,0,NaN,NaN
4,0.900,Unknown Avian,23-5,0,0,0,0,NaN,NaN
4,0.900,Human UTI,16-23,82,92,0,174,47.126,47.126
4,0.900,Human UTI,23-5,112,104,0,216,51.852,51.852
4,0.900,unknown,16-23,0,8,0,8,0.000,0.000
4,0.900,unknown,23-5,2,10,0,12,16.667,16.667
4,0.900,SLO Creek Water,16-23,0,0,0,0,NaN,NaN
4,0.900,SLO Creek Water,23-5,0,0,0,0,NaN,NaN
4,0.900,Pig/Swine,16-23,15,10,0,25,60.000,60.000
4,0.900,Pig/Swine,23-5,11,9,0,20,55.000,55.000
4,0.900,Klebsiella,16-23,0,0,0,0,NaN,NaN
4,0.900,Klebsiella,23-5,0,0,0,0,NaN,NaN
4,0.900,Hu Cw and Dg,16-23,13,25,0,38,34.211,34.211
4,0.900,Hu Cw and Dg,23-5,22,33,0,55,40.000,40.000
4,0.900,Ground Squirrel,16-23,113,84,0,197,57.360,57.360
4,0.900,Ground Squirrel,23-5,98,114,0,212,46.226,46.226
4,0.900,Opossum,16-23,0,2,0,2,0.000,0.000
4,0.900,Opossum,23-5,0,12,0,12,0.000,0.000
4,0.900,Cow,16-23,1500,922,0,2422,61.932,61.932
4,0.900,Cow,23-5,1463,1064,0,2527,57.895,57.895
4,0.900,Deer Mouse,16-23,0,0,0,0,NaN,NaN
4,0.900,Deer Mouse,23-5,0,0,0,0,NaN,NaN
4,0.900,OVERALL,16-23,3903,2441,0,6344,61.523,61.523
4,0.900,OVERALL,23-5,4500,3102,0,7602,59.195,59.195
4,0.950,Chicken,16-23,5,20,0,25,20.000,20.000
4,0.950,Chicken,23-5,17,22,0,39,43.590,43.590
4,0.950,Sea Lion,16-23,0,1,0,1,0.000,0.000
4,0.950,Sea Lion,23-5,4,9,0,13,30.769,30.769
4,0.950,Hu and Cw,16-23,10,25,0,35,28.571,28.571
4,0.950,Hu and Cw,23-5,12,28,0,40,30.000,30.000
4,0.950,Sheep,16-23,66,69,0,135,48.889,48.889
4,0.950,Sheep,23-5,70,44,0,114,61.404,61.404
4,0.950,Hu and Dg,16-23,11,18,0,29,37.931,37.931
4,0.950,Hu and Dg,23-5,16,9,0,25,64.000,64.000
4,0.950,Common Loon,16-23,0,2,0,2,0.000,0.000
4,0.950,Common Loon,23-5,0,3,0,3,0.000,0.000
4,0.950,Red-Winged Blackbird,16-23,0,10,0,10,0.000,0.000
4,0.950,Red-Winged Blackbird,23-5,0,7,0,7,0.000,0.000
4,0.950,Cw,16-23,14,14,0,28,50.000,50.000
4,0.950,Cw,23-5,25,42,0,67,37.313,37.313
4,0.950,Cliff Sparrow,16-23,10,33,0,43,23.256,23.256
4,0.950,Cliff Sparrow,23-5,1,23,0,24,4.167,4.167
4,0.950,Pig,16-23,13,12,0,25,52.000,52.000
4,0.950,Pig,23-5,7,13,0,20,35.000,35.000
4,0.950,Barn Owl,16-23,0,0,0,0,NaN,NaN
4,0.950,Barn Owl,23-5,0,1,0,1,0.000,0.000
4,0.950,Wild Pig,16-23,9,9,0,18,50.000,50.000
4,0.950,Wild Pig,23-5,8,9,0,17,47.059,47.059
4,0.950,Pennington Creek Water,16-23,0,0,0,0,NaN,NaN
4,0.950,Pennington Creek Water,23-5,0,0,0,0,NaN,NaN
4,0.950,Guinni,16-23,0,0,0,0,NaN,NaN
4,0.950,Guinni,23-5,0,2,0,2,0.000,0.000
4,0.950,Racoon,16-23,0,3,0,3,0.000,0.000
4,0.950,Racoon,23-5,0,0,0,0,NaN,NaN
4,0.950,Hu,16-23,18,14,0,32,56.250,56.250
4,0.950,Hu,23-5,20,12,0,32,62.500,62.500
4,0.950,Cw and Dg,16-23,13,19,0,32,40.625,40.625
4,0.950,Cw and Dg,23-5,17,16,0,33,51.515,51.515
4,0.950,Red Wind Blackbird,16-23,0,1,0,1,0.000,0.000
4,0.950,Red Wind Blackbird,23-5,0,3,0,3,0.000,0.000
4,0.950,Tree Swallow,16-23,0,6,0,6,0.000,0.000
4,0.950,Tree Swallow,23-5,0,6,0,6,0.000,0.000
4,0.950,Turkey Vulture,16-23,0,0,0,0,NaN,NaN
4,0.950,Turkey Vulture,23-5,0,4,0,4,0.000,0.000
4,0.950,Dg,16-23,9,16,0,25,36.000,36.000
4,0.950,Dg,23-5,30,22,0,52,57.692,57.692
4,0.950,Western Kingbird,16-23,0,0,0,0,NaN,NaN
4,0.950,Western Kingbird,23-5,0,0,0,0,NaN,NaN
4,0.950,White Crowned Sparrow,16-23,6,12,0,18,33.333,33.333
4,0.950,White Crowned Sparrow,23-5,5,22,0,27,18.519,18.519
4,0.950,Eared Grebe,16-23,0,0,0,0,NaN,NaN
4,0.950,Eared Grebe,23-5,4,17,0,21,19.048,19.048
4,0.950,cougar,16-23,0,0,0,0,NaN,NaN
4,0.950,cougar,23-5,0,0,0,0,NaN,NaN
4,0.950,Ocean Water,16-23,0,0,0,0,NaN,NaN
4,0.950,Ocean Water,23-5,0,0,0,0,NaN,NaN
4,0.950,Red Tailed Hawk,16-23,0,2,0,2,0.000,0.000
4,0.950,Red Tailed Hawk,23-5,0,12,0,12,0.000,0.000
4,0.950,Dog,16-23,74,82,0,156,47.436,47.436
4,0.950,Dog,23-5,122,154,0,276,44.203,44.203
4,0.950,Human,16-23,1722,571,0,2293,75.098,75.098
4,0.950,Human,23-5,2162,457,0,2619,82.551,82.551
4,0.950,Wild Turkey,16-23,11,35,0,46,23.913,23.913
4,0.950,Wild Turkey,23-5,6,37,0,43,13.953,13.953
4,0.950,Clark Grebe,16-23,0,0,0,0,NaN,NaN
4,0.950,Clark Grebe,23-5,0,2,0,2,0.000,0.000
4,0.950,Seagull,16-23,0,0,0,0,NaN,NaN
4,0.950,Seagull,23-5,23,8,0,31,74.194,74.194
4,0.950,Surf Scoter,16-23,0,0,0,0,NaN,NaN
4,0.950,Surf Scoter,23-5,0,2,0,2,0.000,0.000
4,0.950,Pigeon,16-23,94,188,0,282,33.333,33.333
4,0.950,Pigeon,23-5,120,349,0,469,25.586,25.586
4,0.950,Pacific Ocean Water,16-23,0,0,0,0,NaN,NaN
4,0.950,Pacific Ocean Water,23-5,0,0,0,0,NaN,NaN
4,0.950,Cat,16-23,28,40,0,68,41.176,41.176
4,0.950,Cat,23-5,29,54,0,83,34.940,34.940
4,0.950,Horse,16-23,16,45,0,61,26.230,26.230
4,0.950,Horse,23-5,40,249,0,289,13.841,13.841
4,0.950,orangutan,16-23,0,0,0,0,NaN,NaN
4,0.950,orangutan,23-5,0,0,0,0,NaN,NaN
4,0.950,Bat,16-23,36,16,0,52,69.231,69.231
4,0.950,Bat,23-5,37,24,0,61,60.656,60.656
4,0.950,Deer,16-23,15,30,0,45,33.333,33.333
4,0.950,Deer,23-5,17,76,0,93,18.280,18.280
4,0.950,Great Horned Owl,16-23,0,4,0,4,0.000,0.000
4,0.950,Great Horned Owl,23-5,0,8,0,8,0.000,0.000
4,0.950,Freshwater Lagoon,16-23,0,0,0,0,NaN,NaN
4,0.950,Freshwater Lagoon,23-5,0,0,0,0,NaN,NaN
4,0.950,Unknown Avian,16-23,0,0,0,0,NaN,NaN
4,0.950,Unknown Avian,23-5,0,0,0,0,NaN,NaN
4,0.950,Human UTI,16-23,82,91,0,173,47.399,47.399
4,0.950,Human UTI,23-5,111,103,0,214,51.869,51.869
4,0.950,unknown,16-23,0,8,0,8,0.000,0.000
4,0.950,unknown,23-5,2,10,0,12,16.667,16.667
4,0.950,SLO Creek Water,16-23,0,0,0,0,NaN,NaN
4,0.950,SLO Creek Water,23-5,0,0,0,0,NaN,NaN
4,0.950,Pig/Swine,16-23,15,10,0,25,60.000,60.000
4,0.950,Pig/Swine,23-5,11,9,0,20,55.000,55.000
4,0.950,Klebsiella,16-23,0,0,0,0,NaN,NaN
4,0.950,Klebsiella,23-5,0,0,0,0,NaN,NaN
4,0.950,Hu Cw and Dg,16-23,13,25,0,38,34.211,34.211
4,0.950,Hu Cw and Dg,23-5,22,33,0,55,40.000,40.000
4,0.950,Ground Squirrel,16-23,113,84,0,197,57.360,57.360
4,0.950,Ground Squirrel,23-5,98,113,0,211,46.445,46.445
4,0.950,Opossum,16-23,0,2,0,2,0.000,0.000
4,0.950,Opossum,23-5,0,12,0,12,0.000,0.000
4,0.950,Cow,16-23,1501,906,0,2407,62.360,62.360
4,0.950,Cow,23-5,1462,1064,0,2526,57.878,57.878
4,0.950,Deer Mouse,16-23,0,0,0,0,NaN,NaN
4,0.950,Deer Mouse,23-5,0,0,0,0,NaN,NaN
4,0.950,OVERALL,16-23,3904,2423,0,6327,61.704,61.704
4,0.950,OVERALL,23-5,4498,3090,0,7588,59.278,59.278
4,0.960,Chicken,16-23,5,20,0,25,20.000,20.000
4,0.960,Chicken,23-5,17,22,0,39,43.590,43.590
4,0.960,Sea Lion,16-23,0,1,0,1,0.000,0.000
4,0.960,Sea Lion,23-5,4,9,0,13,30.769,30.769
4,0.960,Hu and Cw,16-23,10,25,0,35,28.571,28.571
4,0.960,Hu and Cw,23-5,12,28,0,40,30.000,30.000
4,0.960,Sheep,16-23,66,69,0,135,48.889,48.889
4,0.960,Sheep,23-5,70,44,0,114,61.404,61.404
4,0.960,Hu and Dg,16-23,11,18,0,29,37.931,37.931
4,0.960,Hu and Dg,23-5,16,9,0,25,64.000,64.000
4,0.960,Common Loon,16-23,0,2,0,2,0.000,0.000
4,0.960,Common Loon,23-5,0,3,0,3,0.000,0.000
4,0.960,Red-Winged Blackbird,16-23,0,10,0,10,0.000,0.000
4,0.960,Red-Winged Blackbird,23-5,0,7,0,7,0.000,0.000
4,0.960,Cw,16-23,14,14,0,28,50.000,50.000
4,0.960,Cw,23-5,25,42,0,67,37.313,37.313
4,0.960,Cliff Sparrow,16-23,10,33,0,43,23.256,23.256
4,0.960,Cliff Sparrow,23-5,1,23,0,24,4.167,4.167
4,0.960,Pig,16-23,13,12,0,25,52.000,52.000
4,0.960,Pig,23-5,7,13,0,20,35.000,35.000
4,0.960,Barn Owl,16-23,0,0,0,0,NaN,NaN
4,0.960,Barn Owl,23-5,0,1,0,1,0.000,0.000
4,0.960,Wild Pig,16-23,9,9,0,18,50.000,50.000
4,0.960,Wild Pig,23-5,8,9,0,17,47.059,47.059
4,0.960,Pennington Creek Water,16-23,0,0,0,0,NaN,NaN
4,0.960,Pennington Creek Water,23-5,0,0,0,0,NaN,NaN
4,0.960,Guinni,16-23,0,0,0,0,NaN,NaN
4,0.960,Guinni,23-5,0,2,0,2,0.000,0.000
4,0.960,Racoon,16-23,0,3,0,3,0.000,0.000
4,0.960,Racoon,23-5,0,0,0,0,NaN,NaN
4,0.960,Hu,16-23,18,14,0,32,56.250,56.250
4,0.960,Hu,23-5,20,12,0,32,62.500,62.500
4,0.960,Cw and Dg,16-23,13,19,0,32,40.625,40.625
4,0.960,Cw and Dg,23-5,17,16,0,33,51.515,51.515
4,0.960,Red Wind Blackbird,16-23,0,1,0,1,0.000,0.000
4,0.960,Red Wind Blackbird,23-5,0,3,0,3,0.000,0.000
4,0.960,Tree Swallow,16-23,0,6,0,6,0.000,0.000
4,0.960,Tree Swallow,23-5,0,6,0,6,0.000,0.000
4,0.960,Turkey Vulture,16-23,0,0,0,0,NaN,NaN
4,0.960,Turkey Vulture,23-5,0,4,0,4,0.000,0.000
4,0.960,Dg,16-23,9,16,0,25,36.000,36.000
4,0.960,Dg,23-5,30,22,0,52,57.692,57.692
4,0.960,Western Kingbird,16-23,0,0,0,0,NaN,NaN
4,0.960,Western Kingbird,23-5,0,0,0,0,NaN,NaN
4,0.960,White Crowned Sparrow,16-23,6,12,0,18,33.333,33.333
4,0.960,White Crowned Sparrow,23-5,5,22,0,27,18.519,18.519
4,0.960,Eared Grebe,16-23,0,0,0,0,NaN,NaN
4,0.960,Eared Grebe,23-5,4,17,0,21,19.048,19.048
4,0.960,cougar,16-23,0,0,0,0,NaN,NaN
4,0.960,cougar,23-5,0,0,0,0,NaN,NaN
4,0.960,Ocean Water,16-23,0,0,0,0,NaN,NaN
4,0.960,Ocean Water,23-5,0,0,0,0,NaN,NaN
4,0.960,Red Tailed Hawk,16-23,0,2,0,2,0.000,0.000
4,0.960,Red Tailed Hawk,23-5,0,12,0,12,0.000,0.000
4,0.960,Dog,16-23,74,82,0,156,47.436,47.436
4,0.960,Dog,23-5,122,151,0,273,44.689,44.689
4,0.960,Human,16-23,1722,570,0,2292,75.131,75.131
4,0.960,Human,23-5,2168,447,0,2615,82.906,82.906
4,0.960,Wild Turkey,16-23,11,35,0,46,23.913,23.913
4,0.960,Wild Turkey,23-5,6,39,0,45,13.333,13.333
4,0.960,Clark Grebe,16-23,0,0,0,0,NaN,NaN
4,0.960,Clark Grebe,23-5,0,2,0,2,0.000,0.000
4,0.960,Seagull,16-23,0,0,0,0,NaN,NaN
4,0.960,Seagull,23-5,23,8,0,31,74.194,74.194
4,0.960,Surf Scoter,16-23,0,0,0,0,NaN,NaN
4,0.960,Surf Scoter,23-5,0,2,0,2,0.000,0.000
4,0.960,Pigeon,16-23,94,188,0,282,33.333,33.333
4,0.960,Pigeon,23-5,121,349,0,470,25.745,25.745
4,0.960,Pacific Ocean Water,16-23,0,0,0,0,NaN,NaN
4,0.960,Pacific Ocean Water,23-5,0,0,0,0,NaN,NaN
4,0.960,Cat,16-23,28,40,0,68,41.176,41.176
4,0.960,Cat,23-5,29,54,0,83,34.940,34.940
4,0.960,Horse,16-23,16,45,0,61,26.230,26.230
4,0.960,Horse,23-5,40,249,0,289,13.841,13.841
4,0.960,orangutan,16-23,0,0,0,0,NaN,NaN
4,0.960,orangutan,23-5,0,0,0,0,NaN,NaN
4,0.960,Bat,16-23,36,16,0,52,69.231,69.231
4,0.960,Bat,23-5,37,24,0,61,60.656,60.656
4,0.960,Deer,16-23,15,30,0,45,33.333,33.333
4,0.960,Deer,23-5,17,76,0,93,18.280,18.280
4,0.960,Great Horned Owl,16-23,0,4,0,4,0.000,0.000
4,0.960,Great Horned Owl,23-5,0,8,0,8,0.000,0.000
4,0.960,Freshwater Lagoon,16-23,0,0,0,0,NaN,NaN
4,0.960,Freshwater Lagoon,23-5,0,0,0,0,NaN,NaN
4,0.960,Unknown Avian,16-23,0,0,0,0,NaN,NaN
4,0.960,Unknown Avian,23-5,0,0,0,0,NaN,NaN
4,0.960,Human UTI,16-23,82,91,0,173,47.399,47.399
4,0.960,Human UTI,23-5,111,102,0,213,52.113,52.113
4,0.960,unknown,16-23,0,8,0,8,0.000,0.000
4,0.960,unknown,23-5,2,10,0,12,16.667,16.667
4,0.960,SLO Creek Water,16-23,0,0,0,0,NaN,NaN
4,0.960,SLO Creek Water,23-5,0,0,0,0,NaN,NaN
4,0.960,Pig/Swine,16-23,15,10,0,25,60.000,60.000
4,0.960,Pig/Swine,23-5,11,9,0,20,55.000,55.000
4,0.960,Klebsiella,16-23,0,0,0,0,NaN,NaN
4,0.960,Klebsiella,23-5,0,0,0,0,NaN,NaN
4,0.960,Hu Cw and Dg,16-23,13,25,0,38,34.211,34.211
4,0.960,Hu Cw and Dg,23-5,22,33,0,55,40.000,40.000
4,0.960,Ground Squirrel,16-23,113,84,0,197,57.360,57.360
4,0.960,Ground Squirrel,23-5,98,113,0,211,46.445,46.445
4,0.960,Opossum,16-23,0,2,0,2,0.000,0.000
4,0.960,Opossum,23-5,0,12,0,12,0.000,0.000
4,0.960,Cow,16-23,1499,898,0,2397,62.537,62.537
4,0.960,Cow,23-5,1462,1058,0,2520,58.016,58.016
4,0.960,Deer Mouse,16-23,0,0,0,0,NaN,NaN
4,0.960,Deer Mouse,23-5,0,0,0,0,NaN,NaN
4,0.960,OVERALL,16-23,3902,2414,0,6316,61.780,61.780
4,0.960,OVERALL,23-5,4505,3072,0,7577,59.456,59.456
4,0.970,Chicken,16-23,5,20,0,25,20.000,20.000
4,0.970,Chicken,23-5,17,22,0,39,43.590,43.590
4,0.970,Sea Lion,16-23,0,1,0,1,0.000,0.000
4,0.970,Sea Lion,23-5,4,9,0,13,30.769,30.769
4,0.970,Hu and Cw,16-23,10,25,0,35,28.571,28.571
4,0.970,Hu and Cw,23-5,12,28,0,40,30.000,30.000
4,0.970,Sheep,16-23,66,69,0,135,48.889,48.889
4,0.970,Sheep,23-5,70,43,0,113,61.947,61.947
4,0.970,Hu and Dg,16-23,11,18,0,29,37.931,37.931
4,0.970,Hu and Dg,23-5,16,9,0,25,64.000,64.000
4,0.970,Common Loon,16-23,0,2,0,2,0.000,0.000
4,0.970,Common Loon,23-5,0,3,0,3,0.000,0.000
4,0.970,Red-Winged Blackbird,16-23,0,10,0,10,0.000,0.000
4,0.970,Red-Winged Blackbird,23-5,0,7,0,7,0.000,0.000
4,0.970,Cw,16-23,14,15,0,29,48.276,48.276
4,0.970,Cw,23-5,25,42,0,67,37.313,37.313
4,0.970,Cliff Sparrow,16-23,10,33,0,43,23.256,23.256
4,0.970,Cliff Sparrow,23-5,1,23,0,24,4.167,4.167
4,0.970,Pig,16-23,13,12,0,25,52.000,52.000
4,0.970,Pig,23-5,7,13,0,20,35.000,35.000
4,0.970,Barn Owl,16-23,0,0,0,0,NaN,NaN
4,0.970,Barn Owl,23-5,0,1,0,1,0.000,0.000
4,0.970,Wild Pig,16-23,9,9,0,18,50.000,50.000
4,0.970,Wild Pig,23-5,7,9,0,16,43.750,43.750
4,0.970,Pennington Creek Water,16-23,0,0,0,0,NaN,NaN
4,0.970,Pennington Creek Water,23-5,0,0,0,0,NaN,NaN
4,0.970,Guinni,16-23,0,0,0,0,NaN,NaN
4,0.970,Guinni,23-5,0,2,0,2,0.000,0.000
4,0.970,Racoon,16-23,0,3,0,3,0.000,0.000
4,0.970,Racoon,23-5,0,0,0,0,NaN,NaN
4,0.970,Hu,16-23,18,14,0,32,56.250,56.250
4,0.970,Hu,23-5,20,12,0,32,62.500,62.500
4,0.970,Cw and Dg,16-23,13,19,0,32,40.625,40.625
4,0.970,Cw and Dg,23-5,17,16,0,33,51.515,51.515
4,0.970,Red Wind Blackbird,16-23,0,1,0,1,0.000,0.000
4,0.970,Red Wind Blackbird,23-5,0,3,0,3,0.000,0.000
4,0.970,Tree Swallow,16-23,0,6,0,6,0.000,0.000
4,0.970,Tree Swallow,23-5,0,6,0,6,0.000,0.000
4,0.970,Turkey Vulture,16-23,0,0,0,0,NaN,NaN
4,0.970,Turkey Vulture,23-5,0,4,0,4,0.000,0.000
4,0.970,Dg,16-23,9,16,0,25,36.000,36.000
4,0.970,Dg,23-5,30,21,0,51,58.824,58.824
4,0.970,Western Kingbird,16-23,0,0,0,0,NaN,NaN
4,0.970,Western Kingbird,23-5,0,0,0,0,NaN,NaN
4,0.970,White Crowned Sparrow,16-23,6,12,0,18,33.333,33.333
4,0.970,White Crowned Sparrow,23-5,5,22,0,27,18.519,18.519
4,0.970,Eared Grebe,16-23,0,0,0,0,NaN,NaN
4,0.970,Eared Grebe,23-5,4,17,0,21,19.048,19.048
4,0.970,cougar,16-23,0,0,0,0,NaN,NaN
4,0.970,cougar,23-5,0,0,0,0,NaN,NaN
4,0.970,Ocean Water,16-23,0,0,0,0,NaN,NaN
4,0.970,Ocean Water,23-5,0,0,0,0,NaN,NaN
4,0.970,Red Tailed Hawk,16-23,0,2,0,2,0.000,0.000
4,0.970,Red Tailed Hawk,23-5,0,12,0,12,0.000,0.000
4,0.970,Dog,16-23,74,82,0,156,47.436,47.436
4,0.970,Dog,23-5,122,149,0,271,45.018,45.018
4,0.970,Human,16-23,1722,567,0,2289,75.229,75.229
4,0.970,Human,23-5,2165,446,0,2611,82.918,82.918
4,0.970,Wild Turkey,16-23,11,36,0,47,23.404,23.404
4,0.970,Wild Turkey,23-5,6,39,0,45,13.333,13.333
4,0.970,Clark Grebe,16-23,0,0,0,0,NaN,NaN
4,0.970,Clark Grebe,23-5,0,2,0,2,0.000,0.000
4,0.970,Seagull,16-23,0,0,0,0,NaN,NaN
4,0.970,Seagull,23-5,23,9,0,32,71.875,71.875
4,0.970,Surf Scoter,16-23,0,0,0,0,NaN,NaN
4,0.970,Surf Scoter,23-5,0,2,0,2,0.000,0.000
4,0.970,Pigeon,16-23,92,188,0,280,32.857,32.857
4,0.970,Pigeon,23-5,121,350,0,471,25.690,25.690
4,0.970,Pacific Ocean Water,16-23,0,0,0,0,NaN,NaN
4,0.970,Pacific Ocean Water,23-5,0,0,0,0,NaN,NaN
4,0.970,Cat,16-23,28,40,0,68,41.176,41.176
4,0.970,Cat,23-5,29,54,0,83,34.940,34.940
4,0.970,Horse,16-23,16,45,0,61,26.230,26.230
4,0.970,Horse,23-5,40,249,0,289,13.841,13.841
4,0.970,orangutan,16-23,0,0,0,0,NaN,NaN
4,0.970,orangutan,23-5,0,0,0,0,NaN,NaN
4,0.970,Bat,16-23,36,16,0,52,69.231,69.231
4,0.970,Bat,23-5,37,24,0,61,60.656,60.656
4,0.970,Deer,16-23,15,30,0,45,33.333,33.333
4,0.970,Deer,23-5,17,76,0,93,18.280,18.280
4,0.970,Great Horned Owl,16-23,0,4,0,4,0.000,0.000
4,0.970,Great Horned Owl,23-5,0,8,0,8,0.000,0.000
4,0.970,Freshwater Lagoon,16-23,0,0,0,0,NaN,NaN
4,0.970,Freshwater Lagoon,23-5,0,0,0,0,NaN,NaN
4,0.970,Unknown Avian,16-23,0,0,0,0,NaN,NaN
4,0.970,Unknown Avian,23-5,0,0,0,0,NaN,NaN
4,0.970,Human UTI,16-23,83,91,0,174,47.701,47.701
4,0.970,Human UTI,23-5,110,100,0,210,52.381,52.381
4,0.970,unknown,16-23,0,8,0,8,0.000,0.000
4,0.970,unknown,23-5,2,10,0,12,16.667,16.667
4,0.970,SLO Creek Water,16-23,0,0,0,0,NaN,NaN
4,0.970,SLO Creek Water,23-5,0,0,0,0,NaN,NaN
4,0.970,Pig/Swine,16-23,15,10,0,25,60.000,60.000
4,0.970,Pig/Swine,23-5,11,9,0,20,55.000,55.000
4,0.970,Klebsiella,16-23,0,0,0,0,NaN,NaN
4,0.970,Klebsiella,23-5,0,0,0,0,NaN,NaN
4,0.970,Hu Cw and Dg,16-23,13,25,0,38,34.211,34.211
4,0.970,Hu Cw and Dg,23-5,22,33,0,55,40.000,40.000
4,0.970,Ground Squirrel,16-23,112,81,0,193,58.031,58.031
4,0.970,Ground Squirrel,23-5,98,111,0,209,46.890,46.890
4,0.970,Opossum,16-23,0,2,0,2,0.000,0.000
4,0.970,Opossum,23-5,0,12,0,12,0.000,0.000
4,0.970,Cow,16-23,1495,898,0,2393,62.474,62.474
4,0.970,Cow,23-5,1460,1051,0,2511,58.144,58.144
4,0.970,Deer Mouse,16-23,0,0,0,0,NaN,NaN
4,0.970,Deer Mouse,23-5,0,0,0,0,NaN,NaN
4,0.970,OVERALL,16-23,3896,2410,0,6306,61.782,61.782
4,0.970,OVERALL,23-5,4498,3058,0,7556,59.529,59.529
4,0.980,Chicken,16-23,5,20,0,25,20.000,20.000
4,0.980,Chicken,23-5,18,22,0,40,45.000,45.000
4,0.980,Sea Lion,16-23,0,1,0,1,0.000,0.000
4,0.980,Sea Lion,23-5,4,9,0,13,30.769,30.769
4,0.980,Hu and Cw,16-23,10,25,0,35,28.571,28.571
4,0.980,Hu and Cw,23-5,12,30,0,42,28.571,28.571
4,0.980,Sheep,16-23,66,67,0,133,49.624,49.624
4,0.980,Sheep,23-5,69,42,0,111,62.162,62.162
4,0.980,Hu and Dg,16-23,11,18,0,29,37.931,37.931
4,0.980,Hu and Dg,23-5,16,9,0,25,64.000,64.000
4,0.980,Common Loon,16-23,0,2,0,2,0.000,0.000
4,0.980,Common Loon,23-5,0,2,0,2,0.000,0.000
4,0.980,Red-Winged Blackbird,16-23,0,10,0,10,0.000,0.000
4,0.980,Red-Winged Blackbird,23-5,0,7,0,7,0.000,0.000
4,0.980,Cw,16-23,14,14,0,28,50.000,50.000
4,0.980,Cw,23-5,25,42,0,67,37.313,37.313
4,0.980,Cliff Sparrow,16-23,10,31,0,41,24.390,24.390
4,0.980,Cliff Sparrow,23-5,1,23,0,24,4.167,4.167
4,0.980,Pig,16-23,13,12,0,25,52.000,52.000
4,0.980,Pig,23-5,7,13,0,20,35.000,35.000
4,0.980,Barn Owl,16-23,0,0,0,0,NaN,NaN
4,0.980,Barn Owl,23-5,0,1,0,1,0.000,0.000
4,0.980,Wild Pig,16-23,9,9,0,18,50.000,50.000
4,0.980,Wild Pig,23-5,7,8,0,15,46.667,46.667
4,0.980,Pennington Creek Water,16-23,0,0,0,0,NaN,NaN
4,0.980,Pennington Creek Water,23-5,0,0,0,0,NaN,NaN
4,0.980,Guinni,16-23,0,0,0,0,NaN,NaN
4,0.980,Guinni,23-5,0,2,0,2,0.000,0.000
4,0.980,Racoon,16-23,0,3,0,3,0.000,0.000
4,0.980,Racoon,23-5,0,0,0,0,NaN,NaN
4,0.980,Hu,16-23,18,14,0,32,56.250,56.250
4,0.980,Hu,23-5,20,12,0,32,62.500,62.500
4,0.980,Cw and Dg,16-23,13,19,0,32,40.625,40.625
4,0.980,Cw and Dg,23-5,17,15,0,32,53.125,53.125
4,0.980,Red Wind Blackbird,16-23,0,1,0,1,0.000,0.000
4,0.980,Red Wind Blackbird,23-5,0,3,0,3,0.000,0.000
4,0.980,Tree Swallow,16-23,0,6,0,6,0.000,0.000
4,0.980,Tree Swallow,23-5,0,6,0,6,0.000,0.000
4,0.980,Turkey Vulture,16-23,0,0,0,0,NaN,NaN
4,0.980,Turkey Vulture,23-5,0,4,0,4,0.000,0.000
4,0.980,Dg,16-23,9,16,0,25,36.000,36.000
4,0.980,Dg,23-5,30,21,0,51,58.824,58.824
4,0.980,Western Kingbird,16-23,0,0,0,0,NaN,NaN
4,0.980,Western Kingbird,23-5,0,0,0,0,NaN,NaN
4,0.980,White Crowned Sparrow,16-23,6,12,0,18,33.333,33.333
4,0.980,White Crowned Sparrow,23-5,5,22,0,27,18.519,18.519
4,0.980,Eared Grebe,16-23,0,0,0,0,NaN,NaN
4,0.980,Eared Grebe,23-5,4,17,0,21,19.048,19.048
4,0.980,cougar,16-23,0,0,0,0,NaN,NaN
4,0.980,cougar,23-5,0,0,0,0,NaN,NaN
4,0.980,Ocean Water,16-23,0,0,0,0,NaN,NaN
4,0.980,Ocean Water,23-5,0,0,0,0,NaN,NaN
4,0.980,Red Tailed Hawk,16-23,0,2,0,2,0.000,0.000
4,0.980,Red Tailed Hawk,23-5,0,12,0,12,0.000,0.000
4,0.980,Dog,16-23,73,83,0,156,46.795,46.795
4,0.980,Dog,23-5,122,149,0,271,45.018,45.018
4,0.980,Human,16-23,1721,561,0,2282,75.416,75.416
4,0.980,Human,23-5,2161,437,0,2598,83.179,83.179
4,0.980,Wild Turkey,16-23,11,36,0,47,23.404,23.404
4,0.980,Wild Turkey,23-5,8,42,0,50,16.000,16.000
4,0.980,Clark Grebe,16-23,0,0,0,0,NaN,NaN
4,0.980,Clark Grebe,23-5,0,2,0,2,0.000,0.000
4,0.980,Seagull,16-23,0,0,0,0,NaN,NaN
4,0.980,Seagull,23-5,25,6,0,31,80.645,80.645
4,0.980,Surf Scoter,16-23,0,0,0,0,NaN,NaN
4,0.980,Surf Scoter,23-5,2,0,0,2,100.000,100.000
4,0.980,Pigeon,16-23,92,187,0,279,32.975,32.975
4,0.980,Pigeon,23-5,120,351,0,471,25.478,25.478
4,0.980,Pacific Ocean Water,16-23,0,0,0,0,NaN,NaN
4,0.980,Pacific Ocean Water,23-5,0,0,0,0,NaN,NaN
4,0.980,Cat,16-23,28,38,0,66,42.424,42.424
4,0.980,Cat,23-5,29,52,0,81,35.802,35.802
4,0.980,Horse,16-23,16,45,0,61,26.230,26.230
4,0.980,Horse,23-5,40,244,0,284,14.085,14.085
4,0.980,orangutan,16-23,0,0,0,0,NaN,NaN
4,0.980,orangutan,23-5,0,0,0,0,NaN,NaN
4,0.980,Bat,16-23,36,16,0,52,69.231,69.231
4,0.980,Bat,23-5,37,24,0,61,60.656,60.656
4,0.980,Deer,16-23,15,30,0,45,33.333,33.333
4,0.980,Deer,23-5,17,76,0,93,18.280,18.280
4,0.980,Great Horned Owl,16-23,0,4,0,4,0.000,0.000
4,0.980,Great Horned Owl,23-5,0,8,0,8,0.000,0.000
4,0.980,Freshwater Lagoon,16-23,0,0,0,0,NaN,NaN
4,0.980,Freshwater Lagoon,23-5,0,0,0,0,NaN,NaN
4,0.980,Unknown Avian,16-23,0,0,0,0,NaN,NaN
4,0.980,Unknown Avian,23-5,0,0,0,0,NaN,NaN
4,0.980,Human UTI,16-23,83,89,0,172,48.256,48.256
4,0.980,Human UTI,23-5,110,97,0,207,53.140,53.140
4,0.980,unknown,16-23,0,8,0,8,0.000,0.000
4,0.980,unknown,23-5,2,10,0,12,16.667,16.667
4,0.980,SLO Creek Water,16-23,0,0,0,0,NaN,NaN
4,0.980,SLO Creek Water,23-5,0,0,0,0,NaN,NaN
4,0.980,Pig/Swine,16-23,15,10,0,25,60.000,60.000
4,0.980,Pig/Swine,23-5,11,9,0,20,55.000,55.000
4,0.980,Klebsiella,16-23,0,0,0,0,NaN,NaN
4,0.980,Klebsiella,23-5,0,0,0,0,NaN,NaN
4,0.980,Hu Cw and Dg,16-23,13,25,0,38,34.211,34.211
4,0.980,Hu Cw and Dg,23-5,22,31,0,53,41.509,41.509
4,0.980,Ground Squirrel,16-23,111,81,0,192,57.813,57.813
4,0.980,Ground Squirrel,23-5,98,108,0,206,47.573,47.573
4,0.980,Opossum,16-23,0,2,0,2,0.000,0.000
4,0.980,Opossum,23-5,0,12,0,12,0.000,0.000
4,0.980,Cow,16-23,1491,890,0,2381,62.621,62.621
4,0.980,Cow,23-5,1456,1036,0,2492,58.427,58.427
4,0.980,Deer Mouse,16-23,0,0,0,0,NaN,NaN
4,0.980,Deer Mouse,23-5,0,0,0,0,NaN,NaN
4,0.980,OVERALL,16-23,3889,2387,0,6276,61.966,61.966
4,0.980,OVERALL,23-5,4495,3016,0,7511,59.846,59.846
4,0.990,Chicken,16-23,5,24,0,29,17.241,17.241
4,0.990,Chicken,23-5,19,21,0,40,47.500,47.500
4,0.990,Sea Lion,16-23,0,1,0,1,0.000,0.000
4,0.990,Sea Lion,23-5,4,7,0,11,36.364,36.364
4,0.990,Hu and Cw,16-23,11,25,0,36,30.556,30.556
4,0.990,Hu and Cw,23-5,13,27,0,40,32.500,32.500
4,0.990,Sheep,16-23,64,65,0,129,49.612,49.612
4,0.990,Sheep,23-5,69,41,0,110,62.727,62.727
4,0.990,Hu and Dg,16-23,11,19,0,30,36.667,36.667
4,0.990,Hu and Dg,23-5,16,7,0,23,69.565,69.565
4,0.990,Common Loon,16-23,0,2,0,2,0.000,0.000
4,0.990,Common Loon,23-5,0,3,0,3,0.000,0.000
4,0.990,Red-Winged Blackbird,16-23,0,9,0,9,0.000,0.000
4,0.990,Red-Winged Blackbird,23-5,0,7,0,7,0.000,0.000
4,0.990,Cw,16-23,14,14,0,28,50.000,50.000
4,0.990,Cw,23-5,24,41,0,65,36.923,36.923
4,0.990,Cliff Sparrow,16-23,10,31,0,41,24.390,24.390
4,0.990,Cliff Sparrow,23-5,1,24,0,25,4.000,4.000
4,0.990,Pig,16-23,13,13,0,26,50.000,50.000
4,0.990,Pig,23-5,7,13,0,20,35.000,35.000
4,0.990,Barn Owl,16-23,0,0,0,0,NaN,NaN
4,0.990,Barn Owl,23-5,0,1,0,1,0.000,0.000
4,0.990,Wild Pig,16-23,9,11,0,20,45.000,45.000
4,0.990,Wild Pig,23-5,7,6,0,13,53.846,53.846
4,0.990,Pennington Creek Water,16-23,0,0,0,0,NaN,NaN
4,0.990,Pennington Creek Water,23-5,0,0,0,0,NaN,NaN
4,0.990,Guinni,16-23,0,0,0,0,NaN,NaN
4,0.990,Guinni,23-5,0,1,0,1,0.000,0.000
4,0.990,Racoon,16-23,0,3,0,3,0.000,0.000
4,0.990,Racoon,23-5,0,1,0,1,0.000,0.000
4,0.990,Hu,16-23,18,12,0,30,60.000,60.000
4,0.990,Hu,23-5,20,8,0,28,71.429,71.429
4,0.990,Cw and Dg,16-23,13,19,0,32,40.625,40.625
4,0.990,Cw and Dg,23-5,16,12,0,28,57.143,57.143
4,0.990,Red Wind Blackbird,16-23,0,1,0,1,0.000,0.000
4,0.990,Red Wind Blackbird,23-5,0,3,0,3,0.000,0.000
4,0.990,Tree Swallow,16-23,0,6,0,6,0.000,0.000
4,0.990,Tree Swallow,23-5,0,6,0,6,0.000,0.000
4,0.990,Turkey Vulture,16-23,0,0,0,0,NaN,NaN
4,0.990,Turkey Vulture,23-5,0,4,0,4,0.000,0.000
4,0.990,Dg,16-23,9,16,0,25,36.000,36.000
4,0.990,Dg,23-5,30,20,0,50,60.000,60.000
4,0.990,Western Kingbird,16-23,0,0,0,0,NaN,NaN
4,0.990,Western Kingbird,23-5,0,0,0,0,NaN,NaN
4,0.990,White Crowned Sparrow,16-23,6,11,0,17,35.294,35.294
4,0.990,White Crowned Sparrow,23-5,5,21,0,26,19.231,19.231
4,0.990,Eared Grebe,16-23,0,0,0,0,NaN,NaN
4,0.990,Eared Grebe,23-5,4,16,0,20,20.000,20.000
4,0.990,cougar,16-23,0,1,0,1,0.000,0.000
4,0.990,cougar,23-5,0,0,0,0,NaN,NaN
4,0.990,Ocean Water,16-23,0,0,0,0,NaN,NaN
4,0.990,Ocean Water,23-5,0,0,0,0,NaN,NaN
4,0.990,Red Tailed Hawk,16-23,0,2,0,2,0.000,0.000
4,0.990,Red Tailed Hawk,23-5,0,12,0,12,0.000,0.000
4,0.990,Dog,16-23,73,80,0,153,47.712,47.712
4,0.990,Dog,23-5,122,142,0,264,46.212,46.212
4,0.990,Human,16-23,1704,535,0,2239,76.105,76.105
4,0.990,Human,23-5,2143,415,0,2558,83.776,83.776
4,0.990,Wild Turkey,16-23,13,37,0,50,26.000,26.000
4,0.990,Wild Turkey,23-5,8,39,0,47,17.021,17.021
4,0.990,Clark Grebe,16-23,0,0,0,0,NaN,NaN
4,0.990,Clark Grebe,23-5,2,3,0,5,40.000,40.000
4,0.990,Seagull,16-23,0,0,0,0,NaN,NaN
4,0.990,Seagull,23-5,26,6,0,32,81.250,81.250
4,0.990,Surf Scoter,16-23,0,0,0,0,NaN,NaN
4,0.990,Surf Scoter,23-5,2,0,0,2,100.000,100.000
4,0.990,Pigeon,16-23,93,179,0,272,34.191,34.191
4,0.990,Pigeon,23-5,121,329,0,450,26.889,26.889
4,0.990,Pacific Ocean Water,16-23,0,0,0,0,NaN,NaN
4,0.990,Pacific Ocean Water,23-5,0,0,0,0,NaN,NaN
4,0.990,Cat,16-23,28,36,0,64,43.750,43.750
4,0.990,Cat,23-5,29,49,0,78,37.179,37.179
4,0.990,Horse,16-23,16,43,0,59,27.119,27.119
4,0.990,Horse,23-5,39,240,0,279,13.978,13.978
4,0.990,orangutan,16-23,0,0,0,0,NaN,NaN
4,0.990,orangutan,23-5,0,0,0,0,NaN,NaN
4,0.990,Bat,16-23,36,16,0,52,69.231,69.231
4,0.990,Bat,23-5,37,24,0,61,60.656,60.656
4,0.990,Deer,16-23,15,31,0,46,32.609,32.609
4,0.990,Deer,23-5,17,75,0,92,18.478,18.478
4,0.990,Great Horned Owl,16-23,0,4,0,4,0.000,0.000
4,0.990,Great Horned Owl,23-5,0,7,0,7,0.000,0.000
4,0.990,Freshwater Lagoon,16-23,0,0,0,0,NaN,NaN
4,0.990,Freshwater Lagoon,23-5,0,0,0,0,NaN,NaN
4,0.990,Unknown Avian,16-23,0,0,0,0,NaN,NaN
4,0.990,Unknown Avian,23-5,0,0,0,0,NaN,NaN
4,0.990,Human UTI,16-23,87,83,0,170,51.176,51.176
4,0.990,Human UTI,23-5,111,81,0,192,57.813,57.813
4,0.990,unknown,16-23,0,8,0,8,0.000,0.000
4,0.990,unknown,23-5,2,11,0,13,15.385,15.385
4,0.990,SLO Creek Water,16-23,0,0,0,0,NaN,NaN
4,0.990,SLO Creek Water,23-5,0,0,0,0,NaN,NaN
4,0.990,Pig/Swine,16-23,14,10,0,24,58.333,58.333
4,0.990,Pig/Swine,23-5,11,9,0,20,55.000,55.000
4,0.990,Klebsiella,16-23,0,0,0,0,NaN,NaN
4,0.990,Klebsiella,23-5,0,0,0,0,NaN,NaN
4,0.990,Hu Cw and Dg,16-23,13,25,0,38,34.211,34.211
4,0.990,Hu Cw and Dg,23-5,22,31,0,53,41.509,41.509
4,0.990,Ground Squirrel,16-23,110,77,0,187,58.824,58.824
4,0.990,Ground Squirrel,23-5,99,101,0,200,49.500,49.500
4,0.990,Opossum,16-23,1,2,0,3,33.333,33.333
4,0.990,Opossum,23-5,2,12,0,14,14.286,14.286
4,0.990,Cow,16-23,1457,820,0,2277,63.988,63.988
4,0.990,Cow,23-5,1429,972,0,2401,59.517,59.517
4,0.990,Deer Mouse,16-23,0,0,0,0,NaN,NaN
4,0.990,Deer Mouse,23-5,0,0,0,0,NaN,NaN
4,0.990,OVERALL,16-23,3843,2271,0,6114,62.856,62.856
4,0.990,OVERALL,23-5,4457,2848,0,7305,61.013,61.013
4,1.000,Chicken,16-23,0,0,0,0,NaN,NaN
4,1.000,Chicken,23-5,0,0,0,0,NaN,NaN
4,1.000,Sea Lion,16-23,0,0,0,0,NaN,NaN
4,1.000,Sea Lion,23-5,0,0,0,0,NaN,NaN
4,1.000,Hu and Cw,16-23,0,0,0,0,NaN,NaN
4,1.000,Hu and Cw,23-5,0,0,0,0,NaN,NaN
4,1.000,Sheep,16-23,0,0,0,0,NaN,NaN
4,1.000,Sheep,23-5,0,0,0,0,NaN,NaN
4,1.000,Hu and Dg,16-23,0,0,0,0,NaN,NaN
4,1.000,Hu and Dg,23-5,0,0,0,0,NaN,NaN
4,1.000,Common Loon,16-23,0,0,0,0,NaN,NaN
4,1.000,Common Loon,23-5,0,0,0,0,NaN,NaN
4,1.000,Red-Winged Blackbird,16-23,0,0,0,0,NaN,NaN
4,1.000,Red-Winged Blackbird,23-5,0,0,0,0,NaN,NaN
4,1.000,Cw,16-23,0,0,0,0,NaN,NaN
4,1.000,Cw,23-5,0,0,0,0,NaN,NaN
4,1.000,Cliff Sparrow,16-23,0,0,0,0,NaN,NaN
4,1.000,Cliff Sparrow,23-5,0,0,0,0,NaN,NaN
4,1.000,Pig,16-23,0,0,0,0,NaN,NaN
4,1.000,Pig,23-5,0,0,0,0,NaN,NaN
4,1.000,Barn Owl,16-23,0,0,0,0,NaN,NaN
4,1.000,Barn Owl,23-5,0,0,0,0,NaN,NaN
4,1.000,Wild Pig,16-23,0,0,0,0,NaN,NaN
4,1.000,Wild Pig,23-5,0,0,0,0,NaN,NaN
4,1.000,Pennington Creek Water,16-23,0,0,0,0,NaN,NaN
4,1.000,Pennington Creek Water,23-5,0,0,0,0,NaN,NaN
4,1.000,Guinni,16-23,0,0,0,0,NaN,NaN
4,1.000,Guinni,23-5,0,0,0,0,NaN,NaN
4,1.000,Racoon,16-23,0,0,0,0,NaN,NaN
4,1.000,Racoon,23-5,0,0,0,0,NaN,NaN
4,1.000,Hu,16-23,0,0,0,0,NaN,NaN
4,1.000,Hu,23-5,0,0,0,0,NaN,NaN
4,1.000,Cw and Dg,16-23,0,0,0,0,NaN,NaN
4,1.000,Cw and Dg,23-5,0,0,0,0,NaN,NaN
4,1.000,Red Wind Blackbird,16-23,0,0,0,0,NaN,NaN
4,1.000,Red Wind Blackbird,23-5,0,0,0,0,NaN,NaN
4,1.000,Tree Swallow,16-23,0,0,0,0,NaN,NaN
4,1.000,Tree Swallow,23-5,0,0,0,0,NaN,NaN
4,1.000,Turkey Vulture,16-23,0,0,0,0,NaN,NaN
4,1.000,Turkey Vulture,23-5,0,0,0,0,NaN,NaN
4,1.000,Dg,16-23,0,0,0,0,NaN,NaN
4,1.000,Dg,23-5,0,0,0,0,NaN,NaN
4,1.000,Western Kingbird,16-23,0,0,0,0,NaN,NaN
4,1.000,Western Kingbird,23-5,0,0,0,0,NaN,NaN
4,1.000,White Crowned Sparrow,16-23,0,0,0,0,NaN,NaN
4,1.000,White Crowned Sparrow,23-5,0,0,0,0,NaN,NaN
4,1.000,Eared Grebe,16-23,0,0,0,0,NaN,NaN
4,1.000,Eared Grebe,23-5,0,0,0,0,NaN,NaN
4,1.000,cougar,16-23,0,0,0,0,NaN,NaN
4,1.000,cougar,23-5,0,0,0,0,NaN,NaN
4,1.000,Ocean Water,16-23,0,0,0,0,NaN,NaN
4,1.000,Ocean Water,23-5,0,0,0,0,NaN,NaN
4,1.000,Red Tailed Hawk,16-23,0,0,0,0,NaN,NaN
4,1.000,Red Tailed Hawk,23-5,0,0,0,0,NaN,NaN
4,1.000,Dog,16-23,0,0,0,0,NaN,NaN
4,1.000,Dog,23-5,0,0,0,0,NaN,NaN
4,1.000,Human,16-23,0,0,0,0,NaN,NaN
4,1.000,Human,23-5,0,0,0,0,NaN,NaN
4,1.000,Wild Turkey,16-23,0,0,0,0,NaN,NaN
4,1.000,Wild Turkey,23-5,0,0,0,0,NaN,NaN
4,1.000,Clark Grebe,16-23,0,0,0,0,NaN,NaN
4,1.000,Clark Grebe,23-5,0,0,0,0,NaN,NaN
4,1.000,Seagull,16-23,0,0,0,0,NaN,NaN
4,1.000,Seagull,23-5,0,0,0,0,NaN,NaN
4,1.000,Surf Scoter,16-23,0,0,0,0,NaN,NaN
4,1.000,Surf Scoter,23-5,0,0,0,0,NaN,NaN
4,1.000,Pigeon,16-23,0,0,0,0,NaN,NaN
4,1.000,Pigeon,23-5,0,0,0,0,NaN,NaN
4,1.000,Pacific Ocean Water,16-23,0,0,0,0,NaN,NaN
4,1.000,Pacific Ocean Water,23-5,0,0,0,0,NaN,NaN
4,1.000,Cat,16-23,0,0,0,0,NaN,NaN
4,1.000,Cat,23-5,0,0,0,0,NaN,NaN
4,1.000,Horse,16-23,0,0,0,0,NaN,NaN
4,1.000,Horse,23-5,0,0,0,0,NaN,NaN
4,1.000,orangutan,16-23,0,0,0,0,NaN,NaN
4,1.000,orangutan,23-5,0,0,0,0,NaN,NaN
4,1.000,Bat,16-23,0,0,0,0,NaN,NaN
4,1.000,Bat,23-5,0,0,0,0,NaN,NaN
4,1.000,Deer,16-23,0,0,0,0,NaN,NaN
4,1.000,Deer,23-5,0,0,0,0,NaN,NaN
4,1.000,Great Horned Owl,16-23,0,0,0,0,NaN,NaN
4,1.000,Great Horned Owl,23-5,0,0,0,0,NaN,NaN
4,1.000,Freshwater Lagoon,16-23,0,0,0,0,NaN,NaN
4,1.000,Freshwater Lagoon,23-5,0,0,0,0,NaN,NaN
4,1.000,Unknown Avian,16-23,0,0,0,0,NaN,NaN
4,1.000,Unknown Avian,23-5,0,0,0,0,NaN,NaN
4,1.000,Human UTI,16-23,0,0,0,0,NaN,NaN
4,1.000,Human UTI,23-5,0,0,0,0,NaN,NaN
4,1.000,unknown,16-23,0,0,0,0,NaN,NaN
4,1.000,unknown,23-5,0,0,0,0,NaN,NaN
4,1.000,SLO Creek Water,16-23,0,0,0,0,NaN,NaN
4,1.000,SLO Creek Water,23-5,0,0,0,0,NaN,NaN
4,1.000,Pig/Swine,16-23,0,0,0,0,NaN,NaN
4,1.000,Pig/Swine,23-5,0,0,0,0,NaN,NaN
4,1.000,Klebsiella,16-23,0,0,0,0,NaN,NaN
4,1.000,Klebsiella,23-5,0,0,0,0,NaN,NaN
4,1.000,Hu Cw and Dg,16-23,0,0,0,0,NaN,NaN
4,1.000,Hu Cw and Dg,23-5,0,0,0,0,NaN,NaN
4,1.000,Ground Squirrel,16-23,0,0,0,0,NaN,NaN
4,1.000,Ground Squirrel,23-5,0,0,0,0,NaN,NaN
4,1.000,Opossum,16-23,0,0,0,0,NaN,NaN
4,1.000,Opossum,23-5,0,0,0,0,NaN,NaN
4,1.000,Cow,16-23,0,0,0,0,NaN,NaN
4,1.000,Cow,23-5,0,0,0,0,NaN,NaN
4,1.000,Deer Mouse,16-23,0,0,0,0,NaN,NaN
4,1.000,Deer Mouse,23-5,0,0,0,0,NaN,NaN
4,1.000,OVERALL,16-23,0,0,0,0,NaN,NaN
4,1.000,OVERALL,23-5,0,0,0,0,NaN,NaN
5,0.000,Chicken,16-23,5,25,0,30,16.667,16.667
5,0.000,Chicken,23-5,12,13,0,25,48.000,48.000
5,0.000,Sea Lion,16-23,0,0,0,0,NaN,NaN
5,0.000,Sea Lion,23-5,3,10,0,13,23.077,23.077
5,0.000,Hu and Cw,16-23,10,22,0,32,31.250,31.250
5,0.000,Hu and Cw,23-5,8,29,0,37,21.622,21.622
5,0.000,Sheep,16-23,58,59,0,117,49.573,49.573
5,0.000,Sheep,23-5,70,39,0,109,64.220,64.220
5,0.000,Hu and Dg,16-23,11,19,0,30,36.667,36.667
5,0.000,Hu and Dg,23-5,20,13,0,33,60.606,60.606
5,0.000,Common Loon,16-23,0,2,0,2,0.000,0.000
5,0.000,Common Loon,23-5,0,3,0,3,0.000,0.000
5,0.000,Red-Winged Blackbird,16-23,0,12,0,12,0.000,0.000
5,0.000,Red-Winged Blackbird,23-5,0,8,0,8,0.000,0.000
5,0.000,Cw,16-23,8,14,0,22,36.364,36.364
5,0.000,Cw,23-5,26,41,0,67,38.806,38.806
5,0.000,Cliff Sparrow,16-23,3,28,0,31,9.677,9.677
5,0.000,Cliff Sparrow,23-5,2,12,0,14,14.286,14.286
5,0.000,Pig,16-23,11,8,0,19,57.895,57.895
5,0.000,Pig,23-5,8,14,0,22,36.364,36.364
5,0.000,Barn Owl,16-23,0,0,0,0,NaN,NaN
5,0.000,Barn Owl,23-5,0,1,0,1,0.000,0.000
5,0.000,Wild Pig,16-23,9,5,0,14,64.286,64.286
5,0.000,Wild Pig,23-5,4,6,0,10,40.000,40.000
5,0.000,Pennington Creek Water,16-23,0,0,0,0,NaN,NaN
5,0.000,Pennington Creek Water,23-5,0,0,0,0,NaN,NaN
5,0.000,Guinni,16-23,0,0,0,0,NaN,NaN
5,0.000,Guinni,23-5,0,0,0,0,NaN,NaN
5,0.000,Racoon,16-23,0,3,0,3,0.000,0.000
5,0.000,Racoon,23-5,0,0,0,0,NaN,NaN
5,0.000,Hu,16-23,17,20,0,37,45.946,45.946
5,0.000,Hu,23-5,19,10,0,29,65.517,65.517
5,0.000,Cw and Dg,16-23,8,18,0,26,30.769,30.769
5,0.000,Cw and Dg,23-5,19,23,0,42,45.238,45.238
5,0.000,Red Wind Blackbird,16-23,0,0,0,0,NaN,NaN
5,0.000,Red Wind Blackbird,23-5,0,3,0,3,0.000,0.000
5,0.000,Tree Swallow,16-23,0,2,0,2,0.000,0.000
5,0.000,Tree Swallow,23-5,0,4,0,4,0.000,0.000
5,0.000,Turkey Vulture,16-23,0,0,0,0,NaN,NaN
5,0.000,Turkey Vulture,23-5,0,0,0,0,NaN,NaN
5,0.000,Dg,16-23,9,14,0,23,39.130,39.130
5,0.000,Dg,23-5,30,24,0,54,55.556,55.556
5,0.000,Western Kingbird,16-23,0,0,0,0,NaN,NaN
5,0.000,Western Kingbird,23-5,0,0,0,0,NaN,NaN
5,0.000,White Crowned Sparrow,16-23,3,11,0,14,21.429,21.429
5,0.000,White Crowned Sparrow,23-5,4,21,0,25,16.000,16.000
5,0.000,Eared Grebe,16-23,0,0,0,0,NaN,NaN
5,0.000,Eared Grebe,23-5,3,14,0,17,17.647,17.647
5,0.000,cougar,16-23,0,0,0,0,NaN,NaN
5,0.000,cougar,23-5,0,0,0,0,NaN,NaN
5,0.000,Ocean Water,16-23,0,0,0,0,NaN,NaN
5,0.000,Ocean Water,23-5,0,0,0,0,NaN,NaN
5,0.000,Red Tailed Hawk,16-23,0,2,0,2,0.000,0.000
5,0.000,Red Tailed Hawk,23-5,0,11,0,11,0.000,0.000
5,0.000,Dog,16-23,79,88,0,167,47.305,47.305
5,0.000,Dog,23-5,116,152,0,268,43.284,43.284
5,0.000,Human,16-23,1722,597,0,2319,74.256,74.256
5,0.000,Human,23-5,2167,482,0,2649,81.804,81.804
5,0.000,Wild Turkey,16-23,12,23,0,35,34.286,34.286
5,0.000,Wild Turkey,23-5,4,31,0,35,11.429,11.429
5,0.000,Clark Grebe,16-23,0,0,0,0,NaN,NaN
5,0.000,Clark Grebe,23-5,0,2,0,2,0.000,0.000
5,0.000,Seagull,16-23,0,0,0,0,NaN,NaN
5,0.000,Seagull,23-5,24,6,0,30,80.000,80.000
5,0.000,Surf Scoter,16-23,0,0,0,0,NaN,NaN
5,0.000,Surf Scoter,23-5,0,5,0,5,0.000,0.000
5,0.000,Pigeon,16-23,84,200,0,284,29.577,29.577
5,0.000,Pigeon,23-5,103,279,0,382,26.963,26.963
5,0.000,Pacific Ocean Water,16-23,0,0,0,0,NaN,NaN
5,0.000,Pacific Ocean Water,23-5,0,0,0,0,NaN,NaN
5,0.000,Cat,16-23,27,42,0,69,39.130,39.130
5,0.000,Cat,23-5,28,43,0,71,39.437,39.437
5,0.000,Horse,16-23,13,35,0,48,27.083,27.083
5,0.000,Horse,23-5,34,211,0,245,13.878,13.878
5,0.000,orangutan,16-23,0,0,0,0,NaN,NaN
5,0.000,orangutan,23-5,0,0,0,0,NaN,NaN
5,0.000,Bat,16-23,36,16,0,52,69.231,69.231
5,0.000,Bat,23-5,37,23,0,60,61.667,61.667
5,0.000,Deer,16-23,16,29,0,45,35.556,35.556
5,0.000,Deer,23-5,18,84,0,102,17.647,17.647
5,0.000,Great Horned Owl,16-23,0,0,0,0,NaN,NaN
5,0.000,Great Horned Owl,23-5,0,8,0,8,0.000,0.000
5,0.000,Freshwater Lagoon,16-23,0,0,0,0,NaN,NaN
5,0.000,Freshwater Lagoon,23-5,0,0,0,0,NaN,NaN
5,0.000,Unknown Avian,16-23,0,0,0,0,NaN,NaN
5,0.000,Unknown Avian,23-5,0,0,0,0,NaN,NaN
5,0.000,Human UTI,16-23,89,89,0,178,50.000,50.000
5,0.000,Human UTI,23-5,111,101,0,212,52.358,52.358
5,0.000,unknown,16-23,0,6,0,6,0.000,0.000
5,0.000,unknown,23-5,3,8,0,11,27.273,27.273
5,0.000,SLO Creek Water,16-23,0,0,0,0,NaN,NaN
5,0.000,SLO Creek Water,23-5,0,0,0,0,NaN,NaN
5,0.000,Pig/Swine,16-23,13,14,0,27,48.148,48.148
5,0.000,Pig/Swine,23-5,13,10,0,23,56.522,56.522
5,0.000,Klebsiella,16-23,0,0,0,0,NaN,NaN
5,0.000,Klebsiella,23-5,0,0,0,0,NaN,NaN
5,0.000,Hu Cw and Dg,16-23,12,24,0,36,33.333,33.333
5,0.000,Hu Cw and Dg,23-5,21,29,0,50,42.000,42.000
5,0.000,Ground Squirrel,16-23,104,76,0,180,57.778,57.778
5,0.000,Ground Squirrel,23-5,89,108,0,197,45.178,45.178
5,0.000,Opossum,16-23,0,2,0,2,0.000,0.000
5,0.000,Opossum,23-5,0,9,0,9,0.000,0.000
5,0.000,Cow,16-23,1524,960,0,2484,61.353,61.353
5,0.000,Cow,23-5,1487,1237,0,2724,54.589,54.589
5,0.000,Deer Mouse,16-23,0,0,0,0,NaN,NaN
5,0.000,Deer Mouse,23-5,0,0,0,0,NaN,NaN
5,0.000,OVERALL,16-23,3883,2465,0,6348,61.169,61.169
5,0.000,OVERALL,23-5,4483,3127,0,7610,58.909,58.909
5,0.500,Chicken,16-23,5,25,0,30,16.667,16.667
5,0.500,Chicken,23-5,12,13,0,25,48.000,48.000
5,0.500,Sea Lion,16-23,0,0,0,0,NaN,NaN
5,0.500,Sea Lion,23-5,3,10,0,13,23.077,23.077
5,0.500,Hu and Cw,16-23,10,22,0,32,31.250,31.250
5,0.500,Hu and Cw,23-5,8,29,0,37,21.622,21.622
5,0.500,Sheep,16-23,58,59,0,117,49.573,49.573
5,0.500,Sheep,23-5,70,39,0,109,64.220,64.220
5,0.500,Hu and Dg,16-23,11,19,0,30,36.667,36.667
5,0.500,Hu and Dg,23-5,20,13,0,33,60.606,60.606
5,0.500,Common Loon,16-23,0,2,0,2,0.000,0.000
5,0.500,Common Loon,23-5,0,3,0,3,0.000,0.000
5,0.500,Red-Winged Blackbird,16-23,0,12,0,12,0.000,0.000
5,0.500,Red-Winged Blackbird,23-5,0,8,0,8,0.000,0.000
5,0.500,Cw,16-23,8,14,0,22,36.364,36.364
5,0.500,Cw,23-5,26,41,0,67,38.806,38.806
5,0.500,Cliff Sparrow,16-23,3,28,0,31,9.677,9.677
5,0.500,Cliff Sparrow,23-5,2,12,0,14,14.286,14.286
5,0.500,Pig,16-23,11,8,0,19,57.895,57.895
5,0.500,Pig,23-5,8,14,0,22,36.364,36.364
5,0.500,Barn Owl,16-23,0,0,0,0,NaN,NaN
5,0.500,Barn Owl,23-5,0,1,0,1,0.000,0.000
5,0.500,Wild Pig,16-23,9,5,0,14,64.286,64.286
5,0.500,Wild Pig,23-5,4,6,0,10,40.000,40.000
5,0.500,Pennington Creek Water,16-23,0,0,0,0,NaN,NaN
5,0.500,Pennington Creek Water,23-5,0,0,0,0,NaN,NaN
5,0.500,Guinni,16-23,0,0,0,0,NaN,NaN
5,0.500,Guinni,23-5,0,0,0,0,NaN,NaN
5,0.500,Racoon,16-23,0,3,0,3,0.000,0.000
5,0.500,Racoon,23-5,0,0,0,0,NaN,NaN
5,0.500,Hu,16-23,17,20,0,37,45.946,45.946
5,0.500,Hu,23-5,19,10,0,29,65.517,65.517
5,0.500,Cw and Dg,16-23,8,18,0,26,30.769,30.769
5,0.500,Cw and Dg,23-5,19,23,0,42,45.238,45.238
5,0.500,Red Wind Blackbird,16-23,0,0,0,0,NaN,NaN
5,0.500,Red Wind Blackbird,23-5,0,3,0,3,0.000,0.000
5,0.500,Tree Swallow,16-23,0,2,0,2,0.000,0.000
5,0.500,Tree Swallow,23-5,0,4,0,4,0.000,0.000
5,0.500,Turkey Vulture,16-23,0,0,0,0,NaN,NaN
5,0.500,Turkey Vulture,23-5,0,0,0,0,NaN,NaN
5,0.500,Dg,16-23,9,14,0,23,39.130,39.130
5,0.500,Dg,23-5,30,24,0,54,55.556,55.556
5,0.500,Western Kingbird,16-23,0,0,0,0,NaN,NaN
5,0.500,Western Kingbird,23-5,0,0,0,0,NaN,NaN
5,0.500,White Crowned Sparrow,16-23,3,11,0,14,21.429,21.429
5,0.500,White Crowned Sparrow,23-5,4,21,0,25,16.000,16.000
5,0.500,Eared Grebe,16-23,0,0,0,0,NaN,NaN
5,0.500,Eared Grebe,23-5,3,14,0,17,17.647,17.647
5,0.500,cougar,16-23,0,0,0,0,NaN,NaN
5,0.500,cougar,23-5,0,0,0,0,NaN,NaN
5,0.500,Ocean Water,16-23,0,0,0,0,NaN,NaN
5,0.500,Ocean Water,23-5,0,0,0,0,NaN,NaN
5,0.500,Red Tailed Hawk,16-23,0,2,0,2,0.000,0.000
5,0.500,Red Tailed Hawk,23-5,0,11,0,11,0.000,0.000
5,0.500,Dog,16-23,79,88,0,167,47.305,47.305
5,0.500,Dog,23-5,116,152,0,268,43.284,43.284
5,0.500,Human,16-23,1722,597,0,2319,74.256,74.256
5,0.500,Human,23-5,2167,482,0,2649,81.804,81.804
5,0.500,Wild Turkey,16-23,12,23,0,35,34.286,34.286
5,0.500,Wild Turkey,23-5,4,31,0,35,11.429,11.429
5,0.500,Clark Grebe,16-23,0,0,0,0,NaN,NaN
5,0.500,Clark Grebe,23-5,0,2,0,2,0.000,0.000
5,0.500,Seagull,16-23,0,0,0,0,NaN,NaN
5,0.500,Seagull,23-5,24,6,0,30,80.000,80.000
5,0.500,Surf Scoter,16-23,0,0,0,0,NaN,NaN
5,0.500,Surf Scoter,23-5,0,5,0,5,0.000,0.000
5,0.500,Pigeon,16-23,84,200,0,284,29.577,29.577
5,0.500,Pigeon,23-5,103,279,0,382,26.963,26.963
5,0.500,Pacific Ocean Water,16-23,0,0,0,0,NaN,NaN
5,0.500,Pacific Ocean Water,23-5,0,0,0,0,NaN,NaN
5,0.500,Cat,16-23,27,42,0,69,39.130,39.130
5,0.500,Cat,23-5,28,43,0,71,39.437,39.437
5,0.500,Horse,16-23,13,35,0,48,27.083,27.083
5,0.500,Horse,23-5,34,211,0,245,13.878,13.878
5,0.500,orangutan,16-23,0,0,0,0,NaN,NaN
5,0.500,orangutan,23-5,0,0,0,0,NaN,NaN
5,0.500,Bat,16-23,36,16,0,52,69.231,69.231
5,0.500,Bat,23-5,37,23,0,60,61.667,61.667
5,0.500,Deer,16-23,16,29,0,45,35.556,35.556
5,0.500,Deer,23-5,18,84,0,102,17.647,17.647
5,0.500,Great Horned Owl,16-23,0,0,0,0,NaN,NaN
5,0.500,Great Horned Owl,23-5,0,8,0,8,0.000,0.000
5,0.500,Freshwater Lagoon,16-23,0,0,0,0,NaN,NaN
5,0.500,Freshwater Lagoon,23-5,0,0,0,0,NaN,NaN
5,0.500,Unknown Avian,16-23,0,0,0,0,NaN,NaN
5,0.500,Unknown Avian,23-5,0,0,0,0,NaN,NaN
5,0.500,Human UTI,16-23,89,89,0,178,50.000,50.000
5,0.500,Human UTI,23-5,111,101,0,212,52.358,52.358
5,0.500,unknown,16-23,0,6,0,6,0.000,0.000
5,0.500,unknown,23-5,3,8,0,11,27.273,27.273
5,0.500,SLO Creek Water,16-23,0,0,0,0,NaN,NaN
5,0.500,SLO Creek Water,23-5,0,0,0,0,NaN,NaN
5,0.500,Pig/Swine,16-23,13,14,0,27,48.148,48.148
5,0.500,Pig/Swine,23-5,13,10,0,23,56.522,56.522
5,0.500,Klebsiella,16-23,0,0,0,0,NaN,NaN
5,0.500,Klebsiella,23-5,0,0,0,0,NaN,NaN
5,0.500,Hu Cw and Dg,16-23,12,24,0,36,33.333,33.333
5,0.500,Hu Cw and Dg,23-5,21,29,0,50,42.000,42.000
5,0.500,Ground Squirrel,16-23,104,76,0,180,57.778,57.778
5,0.500,Ground Squirrel,23-5,89,108,0,197,45.178,45.178
5,0.500,Opossum,16-23,0,2,0,2,0.000,0.000
5,0.500,Opossum,23-5,0,9,0,9,0.000,0.000
5,0.500,Cow,16-23,1524,960,0,2484,61.353,61.353
5,0.500,Cow,23-5,1487,1237,0,2724,54.589,54.589
5,0.500,Deer Mouse,16-23,0,0,0,0,NaN,NaN
5,0.500,Deer Mouse,23-5,0,0,0,0,NaN,NaN
5,0.500,OVERALL,16-23,3883,2465,0,6348,61.169,61.169
5,0.500,OVERALL,23-5,4483,3127,0,7610,58.909,58.909
5,0.900,Chicken,16-23,5,25,0,30,16.667,16.667
5,0.900,Chicken,23-5,12,13,0,25,48.000,48.000
5,0.900,Sea Lion,16-23,0,0,0,0,NaN,NaN
5,0.900,Sea Lion,23-5,3,10,0,13,23.077,23.077
5,0.900,Hu and Cw,16-23,10,22,0,32,31.250,31.250
5,0.900,Hu and Cw,23-5,8,29,0,37,21.622,21.622
5,0.900,Sheep,16-23,58,59,0,117,49.573,49.573
5,0.900,Sheep,23-5,70,39,0,109,64.220,64.220
5,0.900,Hu and Dg,16-23,11,19,0,30,36.667,36.667
5,0.900,Hu and Dg,23-5,20,13,0,33,60.606,60.606
5,0.900,Common Loon,16-23,0,2,0,2,0.000,0.000
5,0.900,Common Loon,23-5,0,3,0,3,0.000,0.000
5,0.900,Red-Winged Blackbird,16-23,0,12,0,12,0.000,0.000
5,0.900,Red-Winged Blackbird,23-5,0,8,0,8,0.000,0.000
5,0.900,Cw,16-23,8,14,0,22,36.364,36.364
5,0.900,Cw,23-5,26,41,0,67,38.806,38.806
5,0.900,Cliff Sparrow,16-23,3,28,0,31,9.677,9.677
5,0.900,Cliff Sparrow,23-5,2,12,0,14,14.286,14.286
5,0.900,Pig,16-23,11,8,0,19,57.895,57.895
5,0.900,Pig,23-5,8,14,0,22,36.364,36.364
5,0.900,Barn Owl,16-23,0,0,0,0,NaN,NaN
5,0.900,Barn Owl,23-5,0,1,0,1,0.000,0.000
5,0.900,Wild Pig,16-23,9,5,0,14,64.286,64.286
5,0.900,Wild Pig,23-5,4,6,0,10,40.000,40.000
5,0.900,Pennington Creek Water,16-23,0,0,0,0,NaN,NaN
5,0.900,Pennington Creek Water,23-5,0,0,0,0,NaN,NaN
5,0.900,Guinni,16-23,0,0,0,0,NaN,NaN
5,0.900,Guinni,23-5,0,0,0,0,NaN,NaN
5,0.900,Racoon,16-23,0,3,0,3,0.000,0.000
5,0.900,Racoon,23-5,0,0,0,0,NaN,NaN
5,0.900,Hu,16-23,17,20,0,37,45.946,45.946
5,0.900,Hu,23-5,19,10,0,29,65.517,65.517
5,0.900,Cw and Dg,16-23,8,18,0,26,30.769,30.769
5,0.900,Cw and Dg,23-5,19,23,0,42,45.238,45.238
5,0.900,Red Wind Blackbird,16-23,0,0,0,0,NaN,NaN
5,0.900,Red Wind Blackbird,23-5,0,3,0,3,0.000,0.000
5,0.900,Tree Swallow,16-23,0,2,0,2,0.000,0.000
5,0.900,Tree Swallow,23-5,0,4,0,4,0.000,0.000
5,0.900,Turkey Vulture,16-23,0,0,0,0,NaN,NaN
5,0.900,Turkey Vulture,23-5,0,0,0,0,NaN,NaN
5,0.900,Dg,16-23,9,14,0,23,39.130,39.130
5,0.900,Dg,23-5,30,24,0,54,55.556,55.556
5,0.900,Western Kingbird,16-23,0,0,0,0,NaN,NaN
5,0.900,Western Kingbird,23-5,0,0,0,0,NaN,NaN
5,0.900,White Crowned Sparrow,16-23,3,11,0,14,21.429,21.429
5,0.900,White Crowned Sparrow,23-5,4,21,0,25,16.000,16.000
5,0.900,Eared Grebe,16-23,0,0,0,0,NaN,NaN
5,0.900,Eared Grebe,23-5,3,14,0,17,17.647,17.647
5,0.900,cougar,16-23,0,0,0,0,NaN,NaN
5,0.900,cougar,23-5,0,0,0,0,NaN,NaN
5,0.900,Ocean Water,16-23,0,0,0,0,NaN,NaN
5,0.900,Ocean Water,23-5,0,0,0,0,NaN,NaN
5,0.900,Red Tailed Hawk,16-23,0,2,0,2,0.000,0.000
5,0.900,Red Tailed Hawk,23-5,0,11,0,11,0.000,0.000
5,0.900,Dog,16-23,79,88,0,167,47.305,47.305
5,0.900,Dog,23-5,116,150,0,266,43.609,43.609
5,0.900,Human,16-23,1722,593,0,2315,74.384,74.384
5,0.900,Human,23-5,2167,478,0,2645,81.928,81.928
5,0.900,Wild Turkey,16-23,12,23,0,35,34.286,34.286
5,0.900,Wild Turkey,23-5,4,31,0,35,11.429,11.429
5,0.900,Clark Grebe,16-23,0,0,0,0,NaN,NaN
5,0.900,Clark Grebe,23-5,0,2,0,2,0.000,0.000
5,0.900,Seagull,16-23,0,0,0,0,NaN,NaN
5,0.900,Seagull,23-5,24,7,0,31,77.419,77.419
5,0.900,Surf Scoter,16-23,0,0,0,0,NaN,NaN
5,0.900,Surf Scoter,23-5,0,4,0,4,0.000,0.000
5,0.900,Pigeon,16-23,84,200,0,284,29.577,29.577
5,0.900,Pigeon,23-5,103,279,0,382,26.963,26.963
5,0.900,Pacific Ocean Water,16-23,0,0,0,0,NaN,NaN
5,0.900,Pacific Ocean Water,23-5,0,0,0,0,NaN,NaN
5,0.900,Cat,16-23,27,42,0,69,39.130,39.130
5,0.900,Cat,23-5,28,43,0,71,39.437,39.437
5,0.900,Horse,16-23,13,35,0,48,27.083,27.083
5,0.900,Horse,23-5,34,211,0,245,13.878,13.878
5,0.900,orangutan,16-23,0,0,0,0,NaN,NaN
5,0.900,orangutan,23-5,0,0,0,0,NaN,NaN
5,0.900,Bat,16-23,36,16,0,52,69.231,69.231
5,0.900,Bat,23-5,37,23,0,60,61.667,61.667
5,0.900,Deer,16-23,16,29,0,45,35.556,35.556
5,0.900,Deer,23-5,18,84,0,102,17.647,17.647
5,0.900,Great Horned Owl,16-23,0,0,0,0,NaN,NaN
5,0.900,Great Horned Owl,23-5,0,8,0,8,0.000,0.000
5,0.900,Freshwater Lagoon,16-23,0,0,0,0,NaN,NaN
5,0.900,Freshwater Lagoon,23-5,0,0,0,0,NaN,NaN
5,0.900,Unknown Avian,16-23,0,0,0,0,NaN,NaN
5,0.900,Unknown Avian,23-5,0,0,0,0,NaN,NaN
5,0.900,Human UTI,16-23,89,89,0,178,50.000,50.000
5,0.900,Human UTI,23-5,111,101,0,212,52.358,52.358
5,0.900,unknown,16-23,0,6,0,6,0.000,0.000
5,0.900,unknown,23-5,3,8,0,11,27.273,27.273
5,0.900,SLO Creek Water,16-23,0,0,0,0,NaN,NaN
5,0.900,SLO Creek Water,23-5,0,0,0,0,NaN,NaN
5,0.900,Pig/Swine,16-23,13,14,0,27,48.148,48.148
5,0.900,Pig/Swine,23-5,13,10,0,23,56.522,56.522
5,0.900,Klebsiella,16-23,0,0,0,0,NaN,NaN
5,0.900,Klebsiella,23-5,0,0,0,0,NaN,NaN
5,0.900,Hu Cw and Dg,16-23,12,24,0,36,33.333,33.333
5,0.900,Hu Cw and Dg,23-5,21,29,0,50,42.000,42.000
5,0.900,Ground Squirrel,16-23,104,76,0,180,57.778,57.778
5,0.900,Ground Squirrel,23-5,89,108,0,197,45.178,45.178
5,0.900,Opossum,16-23,0,2,0,2,0.000,0.000
5,0.900,Opossum,23-5,0,9,0,9,0.000,0.000
5,0.900,Cow,16-23,1524,960,0,2484,61.353,61.353
5,0.900,Cow,23-5,1487,1235,0,2722,54.629,54.629
5,0.900,Deer Mouse,16-23,0,0,0,0,NaN,NaN
5,0.900,Deer Mouse,23-5,0,0,0,0,NaN,NaN
5,0.900,OVERALL,16-23,3883,2461,0,6344,61.207,61.207
5,0.900,OVERALL,23-5,4483,3119,0,7602,58.971,58.971
5,0.950,Chicken,16-23,5,25,0,30,16.667,16.667
5,0.950,Chicken,23-5,12,13,0,25,48.000,48.000
5,0.950,Sea Lion,16-23,0,0,0,0,NaN,NaN
5,0.950,Sea Lion,23-5,3,10,0,13,23.077,23.077
5,0.950,Hu and Cw,16-23,10,22,0,32,31.250,31.250
5,0.950,Hu and Cw,23-5,8,29,0,37,21.622,21.622
5,0.950,Sheep,16-23,58,59,0,117,49.573,49.573
5,0.950,Sheep,23-5,70,39,0,109,64.220,64.220
5,0.950,Hu and Dg,16-23,11,19,0,30,36.667,36.667
5,0.950,Hu and Dg,23-5,20,13,0,33,60.606,60.606
5,0.950,Common Loon,16-23,0,2,0,2,0.000,0.000
5,0.950,Common Loon,23-5,0,3,0,3,0.000,0.000
5,0.950,Red-Winged Blackbird,16-23,0,12,0,12,0.000,0.000
5,0.950,Red-Winged Blackbird,23-5,0,8,0,8,0.000,0.000
5,0.950,Cw,16-23,8,14,0,22,36.364,36.364
5,0.950,Cw,23-5,26,41,0,67,38.806,38.806
5,0.950,Cliff Sparrow,16-23,3,28,0,31,9.677,9.677
5,0.950,Cliff Sparrow,23-5,2,12,0,14,14.286,14.286
5,0.950,Pig,16-23,11,8,0,19,57.895,57.895
5,0.950,Pig,23-5,8,14,0,22,36.364,36.364
5,0.950,Barn Owl,16-23,0,0,0,0,NaN,NaN
5,0.950,Barn Owl,23-5,0,1,0,1,0.000,0.000
5,0.950,Wild Pig,16-23,9,5,0,14,64.286,64.286
5,0.950,Wild Pig,23-5,4,5,0,9,44.444,44.444
5,0.950,Pennington Creek Water,16-23,0,0,0,0,NaN,NaN
5,0.950,Pennington Creek Water,23-5,0,0,0,0,NaN,NaN
5,0.950,Guinni,16-23,0,0,0,0,NaN,NaN
5,0.950,Guinni,23-5,0,0,0,0,NaN,NaN
5,0.950,Racoon,16-23,0,3,0,3,0.000,0.000
5,0.950,Racoon,23-5,0,0,0,0,NaN,NaN
5,0.950,Hu,16-23,17,20,0,37,45.946,45.946
5,0.950,Hu,23-5,19,10,0,29,65.517,65.517
5,0.950,Cw and Dg,16-23,8,18,0,26,30.769,30.769
5,0.950,Cw and Dg,23-5,19,23,0,42,45.238,45.238
5,0.950,Red Wind Blackbird,16-23,0,0,0,0,NaN,NaN
5,0.950,Red Wind Blackbird,23-5,0,3,0,3,0.000,0.000
5,0.950,Tree Swallow,16-23,0,2,0,2,0.000,0.000
5,0.950,Tree Swallow,23-5,0,4,0,4,0.000,0.000
5,0.950,Turkey Vulture,16-23,0,0,0,0,NaN,NaN
5,0.950,Turkey Vulture,23-5,0,0,0,0,NaN,NaN
5,0.950,Dg,16-23,9,14,0,23,39.130,39.130
5,0.950,Dg,23-5,30,24,0,54,55.556,55.556
5,0.950,Western Kingbird,16-23,0,0,0,0,NaN,NaN
5,0.950,Western Kingbird,23-5,0,0,0,0,NaN,NaN
5,0.950,White Crowned Sparrow,16-23,3,11,0,14,21.429,21.429
5,0.950,White Crowned Sparrow,23-5,4,21,0,25,16.000,16.000
5,0.950,Eared Grebe,16-23,0,0,0,0,NaN,NaN
5,0.950,Eared Grebe,23-5,3,14,0,17,17.647,17.647
5,0.950,cougar,16-23,0,0,0,0,NaN,NaN
5,0.950,cougar,23-5,0,0,0,0,NaN,NaN
5,0.950,Ocean Water,16-23,0,0,0,0,NaN,NaN
5,0.950,Ocean Water,23-5,0,0,0,0,NaN,NaN
5,0.950,Red Tailed Hawk,16-23,0,2,0,2,0.000,0.000
5,0.950,Red Tailed Hawk,23-5,0,11,0,11,0.000,0.000
5,0.950,Dog,16-23,79,88,0,167,47.305,47.305
5,0.950,Dog,23-5,116,149,0,265,43.774,43.774
5,0.950,Human,16-23,1722,593,0,2315,74.384,74.384
5,0.950,Human,23-5,2167,472,0,2639,82.114,82.114
5,0.950,Wild Turkey,16-23,12,23,0,35,34.286,34.286
5,0.950,Wild Turkey,23-5,4,31,0,35,11.429,11.429
5,0.950,Clark Grebe,16-23,0,0,0,0,NaN,NaN
5,0.950,Clark Grebe,23-5,0,2,0,2,0.000,0.000
5,0.950,Seagull,16-23,0,0,0,0,NaN,NaN
5,0.950,Seagull,23-5,24,6,0,30,80.000,80.000
5,0.950,Surf Scoter,16-23,0,0,0,0,NaN,NaN
5,0.950,Surf Scoter,23-5,0,3,0,3,0.000,0.000
5,0.950,Pigeon,16-23,84,200,0,284,29.577,29.577
5,0.950,Pigeon,23-5,103,280,0,383,26.893,26.893
5,0.950,Pacific Ocean Water,16-23,0,0,0,0,NaN,NaN
5,0.950,Pacific Ocean Water,23-5,0,0,0,0,NaN,NaN
5,0.950,Cat,16-23,27,42,0,69,39.130,39.130
5,0.950,Cat,23-5,28,43,0,71,39.437,39.437
5,0.950,Horse,16-23,13,35,0,48,27.083,27.083
5,0.950,Horse,23-5,34,211,0,245,13.878,13.878
5,0.950,orangutan,16-23,0,0,0,0,NaN,NaN
5,0.950,orangutan,23-5,0,0,0,0,NaN,NaN
5,0.950,Bat,16-23,36,16,0,52,69.231,69.231
5,0.950,Bat,23-5,37,22,0,59,62.712,62.712
5,0.950,Deer,16-23,16,29,0,45,35.556,35.556
5,0.950,Deer,23-5,18,84,0,102,17.647,17.647
5,0.950,Great Horned Owl,16-23,0,0,0,0,NaN,NaN
5,0.950,Great Horned Owl,23-5,0,8,0,8,0.000,0.000
5,0.950,Freshwater Lagoon,16-23,0,0,0,0,NaN,NaN
5,0.950,Freshwater Lagoon,23-5,0,0,0,0,NaN,NaN
5,0.950,Unknown Avian,16-23,0,0,0,0,NaN,NaN
5,0.950,Unknown Avian,23-5,0,0,0,0,NaN,NaN
5,0.950,Human UTI,16-23,90,89,0,179,50.279,50.279
5,0.950,Human UTI,23-5,110,100,0,210,52.381,52.381
5,0.950,unknown,16-23,0,6,0,6,0.000,0.000
5,0.950,unknown,23-5,3,8,0,11,27.273,27.273
5,0.950,SLO Creek Water,16-23,0,0,0,0,NaN,NaN
5,0.950,SLO Creek Water,23-5,0,0,0,0,NaN,NaN
5,0.950,Pig/Swine,16-23,13,14,0,27,48.148,48.148
5,0.950,Pig/Swine,23-5,13,10,0,23,56.522,56.522
5,0.950,Klebsiella,16-23,0,0,0,0,NaN,NaN
5,0.950,Klebsiella,23-5,0,0,0,0,NaN,NaN
5,0.950,Hu Cw and Dg,16-23,12,24,0,36,33.333,33.333
5,0.950,Hu Cw and Dg,23-5,21,29,0,50,42.000,42.000
5,0.950,Ground Squirrel,16-23,104,76,0,180,57.778,57.778
5,0.950,Ground Squirrel,23-5,89,107,0,196,45.408,45.408
5,0.950,Opossum,16-23,0,2,0,2,0.000,0.000
5,0.950,Opossum,23-5,0,9,0,9,0.000,0.000
5,0.950,Cow,16-23,1524,942,0,2466,61.800,61.800
5,0.950,Cow,23-5,1486,1235,0,2721,54.612,54.612
5,0.950,Deer Mouse,16-23,0,0,0,0,NaN,NaN
5,0.950,Deer Mouse,23-5,0,0,0,0,NaN,NaN
5,0.950,OVERALL,16-23,3884,2443,0,6327,61.388,61.388
5,0.950,OVERALL,23-5,4481,3107,0,7588,59.054,59.054
5,0.960,Chicken,16-23,5,25,0,30,16.667,16.667
5,0.960,Chicken,23-5,12,13,0,25,48.000,48.000
5,0.960,Sea Lion,16-23,0,0,0,0,NaN,NaN
5,0.960,Sea Lion,23-5,3,10,0,13,23.077,23.077
5,0.960,Hu and Cw,16-23,10,22,0,32,31.250,31.250
5,0.960,Hu and Cw,23-5,8,29,0,37,21.622,21.622
5,0.960,Sheep,16-23,58,59,0,117,49.573,49.573
5,0.960,Sheep,23-5,70,40,0,110,63.636,63.636
5,0.960,Hu and Dg,16-23,11,19,0,30,36.667,36.667
5,0.960,Hu and Dg,23-5,20,13,0,33,60.606,60.606
5,0.960,Common Loon,16-23,0,2,0,2,0.000,0.000
5,0.960,Common Loon,23-5,0,3,0,3,0.000,0.000
5,0.960,Red-Winged Blackbird,16-23,0,12,0,12,0.000,0.000
5,0.960,Red-Winged Blackbird,23-5,0,8,0,8,0.000,0.000
5,0.960,Cw,16-23,8,14,0,22,36.364,36.364
5,0.960,Cw,23-5,26,41,0,67,38.806,38.806
5,0.960,Cliff Sparrow,16-23,3,28,0,31,9.677,9.677
5,0.960,Cliff Sparrow,23-5,2,12,0,14,14.286,14.286
5,0.960,Pig,16-23,11,8,0,19,57.895,57.895
5,0.960,Pig,23-5,8,14,0,22,36.364,36.364
5,0.960,Barn Owl,16-23,0,0,0,0,NaN,NaN
5,0.960,Barn Owl,23-5,0,1,0,1,0.000,0.000
5,0.960,Wild Pig,16-23,9,5,0,14,64.286,64.286
5,0.960,Wild Pig,23-5,5,5,0,10,50.000,50.000
5,0.960,Pennington Creek Water,16-23,0,0,0,0,NaN,NaN
5,0.960,Pennington Creek Water,23-5,0,0,0,0,NaN,NaN
5,0.960,Guinni,16-23,0,0,0,0,NaN,NaN
5,0.960,Guinni,23-5,0,0,0,0,NaN,NaN
5,0.960,Racoon,16-23,0,3,0,3,0.000,0.000
5,0.960,Racoon,23-5,0,0,0,0,NaN,NaN
5,0.960,Hu,16-23,17,20,0,37,45.946,45.946
5,0.960,Hu,23-5,19,10,0,29,65.517,65.517
5,0.960,Cw and Dg,16-23,8,18,0,26,30.769,30.769
5,0.960,Cw and Dg,23-5,19,23,0,42,45.238,45.238
5,0.960,Red Wind Blackbird,16-23,0,0,0,0,NaN,NaN
5,0.960,Red Wind Blackbird,23-5,0,3,0,3,0.000,0.000
5,0.960,Tree Swallow,16-23,0,2,0,2,0.000,0.000
5,0.960,Tree Swallow,23-5,0,4,0,4,0.000,0.000
5,0.960,Turkey Vulture,16-23,0,0,0,0,NaN,NaN
5,0.960,Turkey Vulture,23-5,0,0,0,0,NaN,NaN
5,0.960,Dg,16-23,9,14,0,23,39.130,39.130
5,0.960,Dg,23-5,30,24,0,54,55.556,55.556
5,0.960,Western Kingbird,16-23,0,0,0,0,NaN,NaN
5,0.960,Western Kingbird,23-5,0,0,0,0,NaN,NaN
5,0.960,White Crowned Sparrow,16-23,3,11,0,14,21.429,21.429
5,0.960,White Crowned Sparrow,23-5,4,21,0,25,16.000,16.000
5,0.960,Eared Grebe,16-23,0,0,0,0,NaN,NaN
5,0.960,Eared Grebe,23-5,3,14,0,17,17.647,17.647
5,0.960,cougar,16-23,0,0,0,0,NaN,NaN
5,0.960,cougar,23-5,0,0,0,0,NaN,NaN
5,0.960,Ocean Water,16-23,0,0,0,0,NaN,NaN
5,0.960,Ocean Water,23-5,0,0,0,0,NaN,NaN
5,0.960,Red Tailed Hawk,16-23,0,2,0,2,0.000,0.000
5,0.960,Red Tailed Hawk,23-5,0,11,0,11,0.000,0.000
5,0.960,Dog,16-23,79,88,0,167,47.305,47.305
5,0.960,Dog,23-5,116,147,0,263,44.106,44.106
5,0.960,Human,16-23,1722,592,0,2314,74.417,74.417
5,0.960,Human,23-5,2172,460,0,2632,82.523,82.523
5,0.960,Wild Turkey,16-23,12,23,0,35,34.286,34.286
5,0.960,Wild Turkey,23-5,4,33,0,37,10.811,10.811
5,0.960,Clark Grebe,16-23,0,0,0,0,NaN,NaN
5,0.960,Clark Grebe,23-5,0,2,0,2,0.000,0.000
5,0.960,Seagull,16-23,0,0,0,0,NaN,NaN
5,0.960,Seagull,23-5,24,6,0,30,80.000,80.000
5,0.960,Surf Scoter,16-23,0,0,0,0,NaN,NaN
5,0.960,Surf Scoter,23-5,0,2,0,2,0.000,0.000
5,0.960,Pigeon,16-23,83,200,0,283,29.329,29.329
5,0.960,Pigeon,23-5,104,294,0,398,26.131,26.131
5,0.960,Pacific Ocean Water,16-23,0,0,0,0,NaN,NaN
5,0.960,Pacific Ocean Water,23-5,0,0,0,0,NaN,NaN
5,0.960,Cat,16-23,27,42,0,69,39.130,39.130
5,0.960,Cat,23-5,28,43,0,71,39.437,39.437
5,0.960,Horse,16-23,13,35,0,48,27.083,27.083
5,0.960,Horse,23-5,34,211,0,245,13.878,13.878
5,0.960,orangutan,16-23,0,0,0,0,NaN,NaN
5,0.960,orangutan,23-5,0,0,0,0,NaN,NaN
5,0.960,Bat,16-23,36,16,0,52,69.231,69.231
5,0.960,Bat,23-5,37,22,0,59,62.712,62.712
5,0.960,Deer,16-23,16,29,0,45,35.556,35.556
5,0.960,Deer,23-5,18,84,0,102,17.647,17.647
5,0.960,Great Horned Owl,16-23,0,0,0,0,NaN,NaN
5,0.960,Great Horned Owl,23-5,0,8,0,8,0.000,0.000
5,0.960,Freshwater Lagoon,16-23,0,0,0,0,NaN,NaN
5,0.960,Freshwater Lagoon,23-5,0,0,0,0,NaN,NaN
5,0.960,Unknown Avian,16-23,0,0,0,0,NaN,NaN
5,0.960,Unknown Avian,23-5,0,0,0,0,NaN,NaN
5,0.960,Human UTI,16-23,90,89,0,179,50.279,50.279
5,0.960,Human UTI,23-5,110,99,0,209,52.632,52.632
5,0.960,unknown,16-23,0,6,0,6,0.000,0.000
5,0.960,unknown,23-5,3,8,0,11,27.273,27.273
5,0.960,SLO Creek Water,16-23,0,0,0,0,NaN,NaN
5,0.960,SLO Creek Water,23-5,0,0,0,0,NaN,NaN
5,0.960,Pig/Swine,16-23,13,14,0,27,48.148,48.148
5,0.960,Pig/Swine,23-5,13,10,0,23,56.522,56.522
5,0.960,Klebsiella,16-23,0,0,0,0,NaN,NaN
5,0.960,Klebsiella,23-5,0,0,0,0,NaN,NaN
5,0.960,Hu Cw and Dg,16-23,12,24,0,36,33.333,33.333
5,0.960,Hu Cw and Dg,23-5,21,29,0,50,42.000,42.000
5,0.960,Ground Squirrel,16-23,104,76,0,180,57.778,57.778
5,0.960,Ground Squirrel,23-5,89,108,0,197,45.178,45.178
5,0.960,Opossum,16-23,0,2,0,2,0.000,0.000
5,0.960,Opossum,23-5,0,9,0,9,0.000,0.000
5,0.960,Cow,16-23,1522,935,0,2457,61.945,61.945
5,0.960,Cow,23-5,1486,1215,0,2701,55.017,55.017
5,0.960,Deer Mouse,16-23,0,0,0,0,NaN,NaN
5,0.960,Deer Mouse,23-5,0,0,0,0,NaN,NaN
5,0.960,OVERALL,16-23,3881,2435,0,6316,61.447,61.447
5,0.960,OVERALL,23-5,4488,3089,0,7577,59.232,59.232
5,0.970,Chicken,16-23,5,25,0,30,16.667,16.667
5,0.970,Chicken,23-5,12,13,0,25,48.000,48.000
5,0.970,Sea Lion,16-23,0,0,0,0,NaN,NaN
5,0.970,Sea Lion,23-5,3,10,0,13,23.077,23.077
5,0.970,Hu and Cw,16-23,10,22,0,32,31.250,31.250
5,0.970,Hu and Cw,23-5,8,29,0,37,21.622,21.622
5,0.970,Sheep,16-23,58,60,0,118,49.153,49.153
5,0.970,Sheep,23-5,70,39,0,109,64.220,64.220
5,0.970,Hu and Dg,16-23,11,19,0,30,36.667,36.667
5,0.970,Hu and Dg,23-5,20,13,0,33,60.606,60.606
5,0.970,Common Loon,16-23,0,2,0,2,0.000,0.000
5,0.970,Common Loon,23-5,0,3,0,3,0.000,0.000
5,0.970,Red-Winged Blackbird,16-23,0,12,0,12,0.000,0.000
5,0.970,Red-Winged Blackbird,23-5,0,8,0,8,0.000,0.000
5,0.970,Cw,16-23,8,15,0,23,34.783,34.783
5,0.970,Cw,23-5,26,41,0,67,38.806,38.806
5,0.970,Cliff Sparrow,16-23,3,28,0,31,9.677,9.677
5,0.970,Cliff Sparrow,23-5,2,12,0,14,14.286,14.286
5,0.970,Pig,16-23,11,8,0,19,57.895,57.895
5,0.970,Pig,23-5,8,14,0,22,36.364,36.364
5,0.970,Barn Owl,16-23,0,0,0,0,NaN,NaN
5,0.970,Barn Owl,23-5,0,1,0,1,0.000,0.000
5,0.970,Wild Pig,16-23,9,5,0,14,64.286,64.286
5,0.970,Wild Pig,23-5,4,5,0,9,44.444,44.444
5,0.970,Pennington Creek Water,16-23,0,0,0,0,NaN,NaN
5,0.970,Pennington Creek Water,23-5,0,0,0,0,NaN,NaN
5,0.970,Guinni,16-23,0,0,0,0,NaN,NaN
5,0.970,Guinni,23-5,0,0,0,0,NaN,NaN
5,0.970,Racoon,16-23,0,3,0,3,0.000,0.000
5,0.970,Racoon,23-5,0,0,0,0,NaN,NaN
5,0.970,Hu,16-23,17,20,0,37,45.946,45.946
5,0.970,Hu,23-5,19,10,0,29,65.517,65.517
5,0.970,Cw and Dg,16-23,8,18,0,26,30.769,30.769
5,0.970,Cw and Dg,23-5,19,23,0,42,45.238,45.238
5,0.970,Red Wind Blackbird,16-23,0,0,0,0,NaN,NaN
5,0.970,Red Wind Blackbird,23-5,0,3,0,3,0.000,0.000
5,0.970,Tree Swallow,16-23,0,2,0,2,0.000,0.000
5,0.970,Tree Swallow,23-5,0,4,0,4,0.000,0.000
5,0.970,Turkey Vulture,16-23,0,0,0,0,NaN,NaN
5,0.970,Turkey Vulture,23-5,0,0,0,0,NaN,NaN
5,0.970,Dg,16-23,9,14,0,23,39.130,39.130
5,0.970,Dg,23-5,30,23,0,53,56.604,56.604
5,0.970,Western Kingbird,16-23,0,0,0,0,NaN,NaN
5,0.970,Western Kingbird,23-5,0,0,0,0,NaN,NaN
5,0.970,White Crowned Sparrow,16-23,3,11,0,14,21.429,21.429
5,0.970,White Crowned Sparrow,23-5,4,21,0,25,16.000,16.000
5,0.970,Eared Grebe,16-23,0,0,0,0,NaN,NaN
5,0.970,Eared Grebe,23-5,3,14,0,17,17.647,17.647
5,0.970,cougar,16-23,0,0,0,0,NaN,NaN
5,0.970,cougar,23-5,0,0,0,0,NaN,NaN
5,0.970,Ocean Water,16-23,0,0,0,0,NaN,NaN
5,0.970,Ocean Water,23-5,0,0,0,0,NaN,NaN
5,0.970,Red Tailed Hawk,16-23,0,2,0,2,0.000,0.000
5,0.970,Red Tailed Hawk,23-5,0,11,0,11,0.000,0.000
5,0.970,Dog,16-23,79,88,0,167,47.305,47.305
5,0.970,Dog,23-5,116,146,0,262,44.275,44.275
5,0.970,Human,16-23,1722,591,0,2313,74.449,74.449
5,0.970,Human,23-5,2168,460,0,2628,82.496,82.496
5,0.970,Wild Turkey,16-23,12,24,0,36,33.333,33.333
5,0.970,Wild Turkey,23-5,6,32,0,38,15.789,15.789
5,0.970,Clark Grebe,16-23,0,0,0,0,NaN,NaN
5,0.970,Clark Grebe,23-5,0,2,0,2,0.000,0.000
5,0.970,Seagull,16-23,0,0,0,0,NaN,NaN
5,0.970,Seagull,23-5,24,7,0,31,77.419,77.419
5,0.970,Surf Scoter,16-23,0,0,0,0,NaN,NaN
5,0.970,Surf Scoter,23-5,0,2,0,2,0.000,0.000
5,0.970,Pigeon,16-23,81,200,0,281,28.826,28.826
5,0.970,Pigeon,23-5,104,307,0,411,25.304,25.304
5,0.970,Pacific Ocean Water,16-23,0,0,0,0,NaN,NaN
5,0.970,Pacific Ocean Water,23-5,0,0,0,0,NaN,NaN
5,0.970,Cat,16-23,27,42,0,69,39.130,39.130
5,0.970,Cat,23-5,28,43,0,71,39.437,39.437
5,0.970,Horse,16-23,13,35,0,48,27.083,27.083
5,0.970,Horse,23-5,34,212,0,246,13.821,13.821
5,0.970,orangutan,16-23,0,0,0,0,NaN,NaN
5,0.970,orangutan,23-5,0,0,0,0,NaN,NaN
5,0.970,Bat,16-23,36,16,0,52,69.231,69.231
5,0.970,Bat,23-5,37,22,0,59,62.712,62.712
5,0.970,Deer,16-23,16,29,0,45,35.556,35.556
5,0.970,Deer,23-5,18,84,0,102,17.647,17.647
5,0.970,Great Horned Owl,16-23,0,0,0,0,NaN,NaN
5,0.970,Great Horned Owl,23-5,0,8,0,8,0.000,0.000
5,0.970,Freshwater Lagoon,16-23,0,0,0,0,NaN,NaN
5,0.970,Freshwater Lagoon,23-5,0,0,0,0,NaN,NaN
5,0.970,Unknown Avian,16-23,0,0,0,0,NaN,NaN
5,0.970,Unknown Avian,23-5,0,0,0,0,NaN,NaN
5,0.970,Human UTI,16-23,90,89,0,179,50.279,50.279
5,0.970,Human UTI,23-5,109,97,0,206,52.913,52.913
5,0.970,unknown,16-23,0,6,0,6,0.000,0.000
5,0.970,unknown,23-5,3,8,0,11,27.273,27.273
5,0.970,SLO Creek Water,16-23,0,0,0,0,NaN,NaN
5,0.970,SLO Creek Water,23-5,0,0,0,0,NaN,NaN
5,0.970,Pig/Swine,16-23,13,14,0,27,48.148,48.148
5,0.970,Pig/Swine,23-5,13,10,0,23,56.522,56.522
5,0.970,Klebsiella,16-23,0,0,0,0,NaN,NaN
5,0.970,Klebsiella,23-5,0,0,0,0,NaN,NaN
5,0.970,Hu Cw and Dg,16-23,12,24,0,36,33.333,33.333
5,0.970,Hu Cw and Dg,23-5,21,29,0,50,42.000,42.000
5,0.970,Ground Squirrel,16-23,103,72,0,175,58.857,58.857
5,0.970,Ground Squirrel,23-5,89,106,0,195,45.641,45.641
5,0.970,Opossum,16-23,0,2,0,2,0.000,0.000
5,0.970,Opossum,23-5,0,9,0,9,0.000,0.000
5,0.970,Cow,16-23,1518,934,0,2452,61.909,61.909
5,0.970,Cow,23-5,1483,1194,0,2677,55.398,55.398
5,0.970,Deer Mouse,16-23,0,0,0,0,NaN,NaN
5,0.970,Deer Mouse,23-5,0,0,0,0,NaN,NaN
5,0.970,OVERALL,16-23,3874,2432,0,6306,61.434,61.434
5,0.970,OVERALL,23-5,4481,3075,0,7556,59.304,59.304
5,0.980,Chicken,16-23,5,25,0,30,16.667,16.667
5,0.980,Chicken,23-5,13,12,0,25,52.000,52.000
5,0.980,Sea Lion,16-23,0,0,0,0,NaN,NaN
5,0.980,Sea Lion,23-5,3,9,0,12,25.000,25.000
5,0.980,Hu and Cw,16-23,10,22,0,32,31.250,31.250
5,0.980,Hu and Cw,23-5,8,34,0,42,19.048,19.048
5,0.980,Sheep,16-23,58,58,0,116,50.000,50.000
5,0.980,Sheep,23-5,69,38,0,107,64.486,64.486
5,0.980,Hu and Dg,16-23,11,19,0,30,36.667,36.667
5,0.980,Hu and Dg,23-5,20,12,0,32,62.500,62.500
5,0.980,Common Loon,16-23,0,2,0,2,0.000,0.000
5,0.980,Common Loon,23-5,0,2,0,2,0.000,0.000
5,0.980,Red-Winged Blackbird,16-23,0,12,0,12,0.000,0.000
5,0.980,Red-Winged Blackbird,23-5,0,8,0,8,0.000,0.000
5,0.980,Cw,16-23,8,14,0,22,36.364,36.364
5,0.980,Cw,23-5,26,42,0,68,38.235,38.235
5,0.980,Cliff Sparrow,16-23,3,26,0,29,10.345,10.345
5,0.980,Cliff Sparrow,23-5,2,12,0,14,14.286,14.286
5,0.980,Pig,16-23,11,8,0,19,57.895,57.895
5,0.980,Pig,23-5,8,14,0,22,36.364,36.364
5,0.980,Barn Owl,16-23,0,0,0,0,NaN,NaN
5,0.980,Barn Owl,23-5,0,1,0,1,0.000,0.000
5,0.980,Wild Pig,16-23,9,5,0,14,64.286,64.286
5,0.980,Wild Pig,23-5,4,4,0,8,50.000,50.000
5,0.980,Pennington Creek Water,16-23,0,0,0,0,NaN,NaN
5,0.980,Pennington Creek Water,23-5,0,0,0,0,NaN,NaN
5,0.980,Guinni,16-23,0,0,0,0,NaN,NaN
5,0.980,Guinni,23-5,0,0,0,0,NaN,NaN
5,0.980,Racoon,16-23,0,3,0,3,0.000,0.000
5,0.980,Racoon,23-5,0,0,0,0,NaN,NaN
5,0.980,Hu,16-23,17,20,0,37,45.946,45.946
5,0.980,Hu,23-5,19,10,0,29,65.517,65.517
5,0.980,Cw and Dg,16-23,8,18,0,26,30.769,30.769
5,0.980,Cw and Dg,23-5,19,22,0,41,46.341,46.341
5,0.980,Red Wind Blackbird,16-23,0,0,0,0,NaN,NaN
5,0.980,Red Wind Blackbird,23-5,0,3,0,3,0.000,0.000
5,0.980,Tree Swallow,16-23,0,2,0,2,0.000,0.000
5,0.980,Tree Swallow,23-5,0,4,0,4,0.000,0.000
5,0.980,Turkey Vulture,16-23,0,0,0,0,NaN,NaN
5,0.980,Turkey Vulture,23-5,0,0,0,0,NaN,NaN
5,0.980,Dg,16-23,9,14,0,23,39.130,39.130
5,0.980,Dg,23-5,30,21,0,51,58.824,58.824
5,0.980,Western Kingbird,16-23,0,0,0,0,NaN,NaN
5,0.980,Western Kingbird,23-5,0,0,0,0,NaN,NaN
5,0.980,White Crowned Sparrow,16-23,3,11,0,14,21.429,21.429
5,0.980,White Crowned Sparrow,23-5,4,21,0,25,16.000,16.000
5,0.980,Eared Grebe,16-23,0,0,0,0,NaN,NaN
5,0.980,Eared Grebe,23-5,3,14,0,17,17.647,17.647
5,0.980,cougar,16-23,0,0,0,0,NaN,NaN
5,0.980,cougar,23-5,0,0,0,0,NaN,NaN
5,0.980,Ocean Water,16-23,0,0,0,0,NaN,NaN
5,0.980,Ocean Water,23-5,0,0,0,0,NaN,NaN
5,0.980,Red Tailed Hawk,16-23,0,2,0,2,0.000,0.000
5,0.980,Red Tailed Hawk,23-5,0,11,0,11,0.000,0.000
5,0.980,Dog,16-23,78,89,0,167,46.707,46.707
5,0.980,Dog,23-5,116,145,0,261,44.444,44.444
5,0.980,Human,16-23,1722,583,0,2305,74.707,74.707
5,0.980,Human,23-5,2164,449,0,2613,82.817,82.817
5,0.980,Wild Turkey,16-23,12,24,0,36,33.333,33.333
5,0.980,Wild Turkey,23-5,8,35,0,43,18.605,18.605
5,0.980,Clark Grebe,16-23,0,0,0,0,NaN,NaN
5,0.980,Clark Grebe,23-5,0,2,0,2,0.000,0.000
5,0.980,Seagull,16-23,0,0,0,0,NaN,NaN
5,0.980,Seagull,23-5,26,5,0,31,83.871,83.871
5,0.980,Surf Scoter,16-23,0,0,0,0,NaN,NaN
5,0.980,Surf Scoter,23-5,2,0,0,2,100.000,100.000
5,0.980,Pigeon,16-23,81,200,0,281,28.826,28.826
5,0.980,Pigeon,23-5,103,311,0,414,24.879,24.879
5,0.980,Pacific Ocean Water,16-23,0,0,0,0,NaN,NaN
5,0.980,Pacific Ocean Water,23-5,0,0,0,0,NaN,NaN
5,0.980,Cat,16-23,27,40,0,67,40.299,40.299
5,0.980,Cat,23-5,28,41,0,69,40.580,40.580
5,0.980,Horse,16-23,13,35,0,48,27.083,27.083
5,0.980,Horse,23-5,34,208,0,242,14.050,14.050
5,0.980,orangutan,16-23,0,0,0,0,NaN,NaN
5,0.980,orangutan,23-5,0,0,0,0,NaN,NaN
5,0.980,Bat,16-23,36,16,0,52,69.231,69.231
5,0.980,Bat,23-5,37,21,0,58,63.793,63.793
5,0.980,Deer,16-23,16,29,0,45,35.556,35.556
5,0.980,Deer,23-5,18,84,0,102,17.647,17.647
5,0.980,Great Horned Owl,16-23,0,0,0,0,NaN,NaN
5,0.980,Great Horned Owl,23-5,0,8,0,8,0.000,0.000
5,0.980,Freshwater Lagoon,16-23,0,0,0,0,NaN,NaN
5,0.980,Freshwater Lagoon,23-5,0,0,0,0,NaN,NaN
5,0.980,Unknown Avian,16-23,0,0,0,0,NaN,NaN
5,0.980,Unknown Avian,23-5,0,0,0,0,NaN,NaN
5,0.980,Human UTI,16-23,90,89,0,179,50.279,50.279
5,0.980,Human UTI,23-5,109,95,0,204,53.431,53.431
5,0.980,unknown,16-23,0,6,0,6,0.000,0.000
5,0.980,unknown,23-5,3,9,0,12,25.000,25.000
5,0.980,SLO Creek Water,16-23,0,0,0,0,NaN,NaN
5,0.980,SLO Creek Water,23-5,0,0,0,0,NaN,NaN
5,0.980,Pig/Swine,16-23,13,14,0,27,48.148,48.148
5,0.980,Pig/Swine,23-5,13,10,0,23,56.522,56.522
5,0.980,Klebsiella,16-23,0,0,0,0,NaN,NaN
5,0.980,Klebsiella,23-5,0,0,0,0,NaN,NaN
5,0.980,Hu Cw and Dg,16-23,12,24,0,36,33.333,33.333
5,0.980,Hu Cw and Dg,23-5,21,27,0,48,43.750,43.750
5,0.980,Ground Squirrel,16-23,102,73,0,175,58.286,58.286
5,0.980,Ground Squirrel,23-5,89,103,0,192,46.354,46.354
5,0.980,Opossum,16-23,0,2,0,2,0.000,0.000
5,0.980,Opossum,23-5,0,9,0,9,0.000,0.000
5,0.980,Cow,16-23,1512,925,0,2437,62.043,62.043
5,0.980,Cow,23-5,1479,1177,0,2656,55.685,55.685
5,0.980,Deer Mouse,16-23,0,0,0,0,NaN,NaN
5,0.980,Deer Mouse,23-5,0,0,0,0,NaN,NaN
5,0.980,OVERALL,16-23,3866,2410,0,6276,61.600,61.600
5,0.980,OVERALL,23-5,4478,3033,0,7511,59.619,59.619
5,0.990,Chicken,16-23,5,30,0,35,14.286,14.286
5,0.990,Chicken,23-5,14,11,0,25,56.000,56.000
5,0.990,Sea Lion,16-23,0,0,0,0,NaN,NaN
5,0.990,Sea Lion,23-5,4,7,0,11,36.364,36.364
5,0.990,Hu and Cw,16-23,11,22,0,33,33.333,33.333
5,0.990,Hu and Cw,23-5,9,32,0,41,21.951,21.951
5,0.990,Sheep,16-23,58,57,0,115,50.435,50.435
5,0.990,Sheep,23-5,69,38,0,107,64.486,64.486
5,0.990,Hu and Dg,16-23,11,20,0,31,35.484,35.484
5,0.990,Hu and Dg,23-5,20,11,0,31,64.516,64.516
5,0.990,Common Loon,16-23,0,2,0,2,0.000,0.000
5,0.990,Common Loon,23-5,0,3,0,3,0.000,0.000
5,0.990,Red-Winged Blackbird,16-23,0,11,0,11,0.000,0.000
5,0.990,Red-Winged Blackbird,23-5,0,8,0,8,0.000,0.000
5,0.990,Cw,16-23,8,14,0,22,36.364,36.364
5,0.990,Cw,23-5,26,41,0,67,38.806,38.806
5,0.990,Cliff Sparrow,16-23,3,24,0,27,11.111,11.111
5,0.990,Cliff Sparrow,23-5,2,14,0,16,12.500,12.500
5,0.990,Pig,16-23,11,9,0,20,55.000,55.000
5,0.990,Pig,23-5,8,13,0,21,38.095,38.095
5,0.990,Barn Owl,16-23,0,0,0,0,NaN,NaN
5,0.990,Barn Owl,23-5,0,1,0,1,0.000,0.000
5,0.990,Wild Pig,16-23,9,7,0,16,56.250,56.250
5,0.990,Wild Pig,23-5,4,3,0,7,57.143,57.143
5,0.990,Pennington Creek Water,16-23,0,0,0,0,NaN,NaN
5,0.990,Pennington Creek Water,23-5,0,0,0,0,NaN,NaN
5,0.990,Guinni,16-23,0,0,0,0,NaN,NaN
5,0.990,Guinni,23-5,0,0,0,0,NaN,NaN
5,0.990,Racoon,16-23,0,3,0,3,0.000,0.000
5,0.990,Racoon,23-5,0,1,0,1,0.000,0.000
5,0.990,Hu,16-23,17,18,0,35,48.571,48.571
5,0.990,Hu,23-5,19,7,0,26,73.077,73.077
5,0.990,Cw and Dg,16-23,8,18,0,26,30.769,30.769
5,0.990,Cw and Dg,23-5,18,15,0,33,54.545,54.545
5,0.990,Red Wind Blackbird,16-23,0,0,0,0,NaN,NaN
5,0.990,Red Wind Blackbird,23-5,0,3,0,3,0.000,0.000
5,0.990,Tree Swallow,16-23,0,2,0,2,0.000,0.000
5,0.990,Tree Swallow,23-5,0,4,0,4,0.000,0.000
5,0.990,Turkey Vulture,16-23,0,0,0,0,NaN,NaN
5,0.990,Turkey Vulture,23-5,0,0,0,0,NaN,NaN
5,0.990,Dg,16-23,9,14,0,23,39.130,39.130
5,0.990,Dg,23-5,30,19,0,49,61.224,61.224
5,0.990,Western Kingbird,16-23,0,0,0,0,NaN,NaN
5,0.990,Western Kingbird,23-5,0,0,0,0,NaN,NaN
5,0.990,White Crowned Sparrow,16-23,3,9,0,12,25.000,25.000
5,0.990,White Crowned Sparrow,23-5,4,20,0,24,16.667,16.667
5,0.990,Eared Grebe,16-23,0,0,0,0,NaN,NaN
5,0.990,Eared Grebe,23-5,3,12,0,15,20.000,20.000
5,0.990,cougar,16-23,0,1,0,1,0.000,0.000
5,0.990,cougar,23-5,0,0,0,0,NaN,NaN
5,0.990,Ocean Water,16-23,0,0,0,0,NaN,NaN
5,0.990,Ocean Water,23-5,0,0,0,0,NaN,NaN
5,0.990,Red Tailed Hawk,16-23,0,2,0,2,0.000,0.000
5,0.990,Red Tailed Hawk,23-5,0,12,0,12,0.000,0.000
5,0.990,Dog,16-23,79,85,0,164,48.171,48.171
5,0.990,Dog,23-5,116,136,0,252,46.032,46.032
5,0.990,Human,16-23,1703,555,0,2258,75.421,75.421
5,0.990,Human,23-5,2150,426,0,2576,83.463,83.463
5,0.990,Wild Turkey,16-23,13,26,0,39,33.333,33.333
5,0.990,Wild Turkey,23-5,8,32,0,40,20.000,20.000
5,0.990,Clark Grebe,16-23,0,0,0,0,NaN,NaN
5,0.990,Clark Grebe,23-5,2,3,0,5,40.000,40.000
5,0.990,Seagull,16-23,0,0,0,0,NaN,NaN
5,0.990,Seagull,23-5,27,5,0,32,84.375,84.375
5,0.990,Surf Scoter,16-23,0,0,0,0,NaN,NaN
5,0.990,Surf Scoter,23-5,2,0,0,2,100.000,100.000
5,0.990,Pigeon,16-23,82,191,0,273,30.037,30.037
5,0.990,Pigeon,23-5,106,293,0,399,26.566,26.566
5,0.990,Pacific Ocean Water,16-23,0,0,0,0,NaN,NaN
5,0.990,Pacific Ocean Water,23-5,0,0,0,0,NaN,NaN
5,0.990,Cat,16-23,26,36,0,62,41.935,41.935
5,0.990,Cat,23-5,28,40,0,68,41.176,41.176
5,0.990,Horse,16-23,15,34,0,49,30.612,30.612
5,0.990,Horse,23-5,34,209,0,243,13.992,13.992
5,0.990,orangutan,16-23,0,0,0,0,NaN,NaN
5,0.990,orangutan,23-5,0,0,0,0,NaN,NaN
5,0.990,Bat,16-23,36,15,0,51,70.588,70.588
5,0.990,Bat,23-5,37,21,0,58,63.793,63.793
5,0.990,Deer,16-23,16,30,0,46,34.783,34.783
5,0.990,Deer,23-5,18,83,0,101,17.822,17.822
5,0.990,Great Horned Owl,16-23,0,0,0,0,NaN,NaN
5,0.990,Great Horned Owl,23-5,0,8,0,8,0.000,0.000
5,0.990,Freshwater Lagoon,16-23,0,0,0,0,NaN,NaN
5,0.990,Freshwater Lagoon,23-5,0,0,0,0,NaN,NaN
5,0.990,Unknown Avian,16-23,0,0,0,0,NaN,NaN
5,0.990,Unknown Avian,23-5,0,0,0,0,NaN,NaN
5,0.990,Human UTI,16-23,94,81,0,175,53.714,53.714
5,0.990,Human UTI,23-5,110,80,0,190,57.895,57.895
5,0.990,unknown,16-23,0,6,0,6,0.000,0.000
5,0.990,unknown,23-5,3,10,0,13,23.077,23.077
5,0.990,SLO Creek Water,16-23,0,0,0,0,NaN,NaN
5,0.990,SLO Creek Water,23-5,0,0,0,0,NaN,NaN
5,0.990,Pig/Swine,16-23,12,15,0,27,44.444,44.444
5,0.990,Pig/Swine,23-5,13,10,0,23,56.522,56.522
5,0.990,Klebsiella,16-23,0,0,0,0,NaN,NaN
5,0.990,Klebsiella,23-5,0,0,0,0,NaN,NaN
5,0.990,Hu Cw and Dg,16-23,12,24,0,36,33.333,33.333
5,0.990,Hu Cw and Dg,23-5,21,27,0,48,43.750,43.750
5,0.990,Ground Squirrel,16-23,103,71,0,174,59.195,59.195
5,0.990,Ground Squirrel,23-5,90,102,0,192,46.875,46.875
5,0.990,Opossum,16-23,1,2,0,3,33.333,33.333
5,0.990,Opossum,23-5,2,9,0,11,18.182,18.182
5,0.990,Cow,16-23,1482,853,0,2335,63.469,63.469
5,0.990,Cow,23-5,1449,1090,0,2539,57.070,57.070
5,0.990,Deer Mouse,16-23,0,0,0,0,NaN,NaN
5,0.990,Deer Mouse,23-5,0,0,0,0,NaN,NaN
5,0.990,OVERALL,16-23,3827,2287,0,6114,62.594,62.594
5,0.990,OVERALL,23-5,4446,2859,0,7305,60.862,60.862
5,1.000,Chicken,16-23,0,0,0,0,NaN,NaN
5,1.000,Chicken,23-5,0,0,0,0,NaN,NaN
5,1.000,Sea Lion,16-23,0,0,0,0,NaN,NaN
5,1.000,Sea Lion,23-5,0,0,0,0,NaN,NaN
5,1.000,Hu and Cw,16-23,0,0,0,0,NaN,NaN
5,1.000,Hu and Cw,23-5,0,0,0,0,NaN,NaN
5,1.000,Sheep,16-23,0,0,0,0,NaN,NaN
5,1.000,Sheep,23-5,0,0,0,0,NaN,NaN
5,1.000,Hu and Dg,16-23,0,0,0,0,NaN,NaN
5,1.000,Hu and Dg,23-5,0,0,0,0,NaN,NaN
5,1.000,Common Loon,16-23,0,0,0,0,NaN,NaN
5,1.000,Common Loon,23-5,0,0,0,0,NaN,NaN
5,1.000,Red-Winged Blackbird,16-23,0,0,0,0,NaN,NaN
5,1.000,Red-Winged Blackbird,23-5,0,0,0,0,NaN,NaN
5,1.000,Cw,16-23,0,0,0,0,NaN,NaN
5,1.000,Cw,23-5,0,0,0,0,NaN,NaN
5,1.000,Cliff Sparrow,16-23,0,0,0,0,NaN,NaN
5,1.000,Cliff Sparrow,23-5,0,0,0,0,NaN,NaN
5,1.000,Pig,16-23,0,0,0,0,NaN,NaN
5,1.000,Pig,23-5,0,0,0,0,NaN,NaN
5,1.000,Barn Owl,16-23,0,0,0,0,NaN,NaN
5,1.000,Barn Owl,23-5,0,0,0,0,NaN,NaN
5,1.000,Wild Pig,16-23,0,0,0,0,NaN,NaN
5,1.000,Wild Pig,23-5,0,0,0,0,NaN,NaN
5,1.000,Pennington Creek Water,16-23,0,0,0,0,NaN,NaN
5,1.000,Pennington Creek Water,23-5,0,0,0,0,NaN,NaN
5,1.000,Guinni,16-23,0,0,0,0,NaN,NaN
5,1.000,Guinni,23-5,0,0,0,0,NaN,NaN
5,1.000,Racoon,16-23,0,0,0,0,NaN,NaN
5,1.000,Racoon,23-5,0,0,0,0,NaN,NaN
5,1.000,Hu,16-23,0,0,0,0,NaN,NaN
5,1.000,Hu,23-5,0,0,0,0,NaN,NaN
5,1.000,Cw and Dg,16-23,0,0,0,0,NaN,NaN
5,1.000,Cw and Dg,23-5,0,0,0,0,NaN,NaN
5,1.000,Red Wind Blackbird,16-23,0,0,0,0,NaN,NaN
5,1.000,Red Wind Blackbird,23-5,0,0,0,0,NaN,NaN
5,1.000,Tree Swallow,16-23,0,0,0,0,NaN,NaN
5,1.000,Tree Swallow,23-5,0,0,0,0,NaN,NaN
5,1.000,Turkey Vulture,16-23,0,0,0,0,NaN,NaN
5,1.000,Turkey Vulture,23-5,0,0,0,0,NaN,NaN
5,1.000,Dg,16-23,0,0,0,0,NaN,NaN
5,1.000,Dg,23-5,0,0,0,0,NaN,NaN
5,1.000,Western Kingbird,16-23,0,0,0,0,NaN,NaN
5,1.000,Western Kingbird,23-5,0,0,0,0,NaN,NaN
5,1.000,White Crowned Sparrow,16-23,0,0,0,0,NaN,NaN
5,1.000,White Crowned Sparrow,23-5,0,0,0,0,NaN,NaN
5,1.000,Eared Grebe,16-23,0,0,0,0,NaN,NaN
5,1.000,Eared Grebe,23-5,0,0,0,0,NaN,NaN
5,1.000,cougar,16-23,0,0,0,0,NaN,NaN
5,1.000,cougar,23-5,0,0,0,0,NaN,NaN
5,1.000,Ocean Water,16-23,0,0,0,0,NaN,NaN
5,1.000,Ocean Water,23-5,0,0,0,0,NaN,NaN
5,1.000,Red Tailed Hawk,16-23,0,0,0,0,NaN,NaN
5,1.000,Red Tailed Hawk,23-5,0,0,0,0,NaN,NaN
5,1.000,Dog,16-23,0,0,0,0,NaN,NaN
5,1.000,Dog,23-5,0,0,0,0,NaN,NaN
5,1.000,Human,16-23,0,0,0,0,NaN,NaN
5,1.000,Human,23-5,0,0,0,0,NaN,NaN
5,1.000,Wild Turkey,16-23,0,0,0,0,NaN,NaN
5,1.000,Wild Turkey,23-5,0,0,0,0,NaN,NaN
5,1.000,Clark Grebe,16-23,0,0,0,0,NaN,NaN
5,1.000,Clark Grebe,23-5,0,0,0,0,NaN,NaN
5,1.000,Seagull,16-23,0,0,0,0,NaN,NaN
5,1.000,Seagull,23-5,0,0,0,0,NaN,NaN
5,1.000,Surf Scoter,16-23,0,0,0,0,NaN,NaN
5,1.000,Surf Scoter,23-5,0,0,0,0,NaN,NaN
5,1.000,Pigeon,16-23,0,0,0,0,NaN,NaN
5,1.000,Pigeon,23-5,0,0,0,0,NaN,NaN
5,1.000,Pacific Ocean Water,16-23,0,0,0,0,NaN,NaN
5,1.000,Pacific Ocean Water,23-5,0,0,0,0,NaN,NaN
5,1.000,Cat,16-23,0,0,0,0,NaN,NaN
5,1.000,Cat,23-5,0,0,0,0,NaN,NaN
5,1.000,Horse,16-23,0,0,0,0,NaN,NaN
5,1.000,Horse,23-5,0,0,0,0,NaN,NaN
5,1.000,orangutan,16-23,0,0,0,0,NaN,NaN
5,1.000,orangutan,23-5,0,0,0,0,NaN,NaN
5,1.000,Bat,16-23,0,0,0,0,NaN,NaN
5,1.000,Bat,23-5,0,0,0,0,NaN,NaN
5,1.000,Deer,16-23,0,0,0,0,NaN,NaN
5,1.000,Deer,23-5,0,0,0,0,NaN,NaN
5,1.000,Great Horned Owl,16-23,0,0,0,0,NaN,NaN
5,1.000,Great Horned Owl,23-5,0,0,0,0,NaN,NaN
5,1.000,Freshwater Lagoon,16-23,0,0,0,0,NaN,NaN
5,1.000,Freshwater Lagoon,23-5,0,0,0,0,NaN,NaN
5,1.000,Unknown Avian,16-23,0,0,0,0,NaN,NaN
5,1.000,Unknown Avian,23-5,0,0,0,0,NaN,NaN
5,1.000,Human UTI,16-23,0,0,0,0,NaN,NaN
5,1.000,Human UTI,23-5,0,0,0,0,NaN,NaN
5,1.000,unknown,16-23,0,0,0,0,NaN,NaN
5,1.000,unknown,23-5,0,0,0,0,NaN,NaN
5,1.000,SLO Creek Water,16-23,0,0,0,0,NaN,NaN
5,1.000,SLO Creek Water,23-5,0,0,0,0,NaN,NaN
5,1.000,Pig/Swine,16-23,0,0,0,0,NaN,NaN
5,1.000,Pig/Swine,23-5,0,0,0,0,NaN,NaN
5,1.000,Klebsiella,16-23,0,0,0,0,NaN,NaN
5,1.000,Klebsiella,23-5,0,0,0,0,NaN,NaN
5,1.000,Hu Cw and Dg,16-23,0,0,0,0,NaN,NaN
5,1.000,Hu Cw and Dg,23-5,0,0,0,0,NaN,NaN
5,1.000,Ground Squirrel,16-23,0,0,0,0,NaN,NaN
5,1.000,Ground Squirrel,23-5,0,0,0,0,NaN,NaN
5,1.000,Opossum,16-23,0,0,0,0,NaN,NaN
5,1.000,Opossum,23-5,0,0,0,0,NaN,NaN
5,1.000,Cow,16-23,0,0,0,0,NaN,NaN
5,1.000,Cow,23-5,0,0,0,0,NaN,NaN
5,1.000,Deer Mouse,16-23,0,0,0,0,NaN,NaN
5,1.000,Deer Mouse,23-5,0,0,0,0,NaN,NaN
5,1.000,OVERALL,16-23,0,0,0,0,NaN,NaN
5,1.000,OVERALL,23-5,0,0,0,0,NaN,NaN
6,0.000,Chicken,16-23,4,15,0,19,21.053,21.053
6,0.000,Chicken,23-5,12,11,0,23,52.174,52.174
6,0.000,Sea Lion,16-23,0,1,0,1,0.000,0.000
6,0.000,Sea Lion,23-5,3,12,0,15,20.000,20.000
6,0.000,Hu and Cw,16-23,8,18,0,26,30.769,30.769
6,0.000,Hu and Cw,23-5,8,21,0,29,27.586,27.586
6,0.000,Sheep,16-23,56,52,0,108,51.852,51.852
6,0.000,Sheep,23-5,71,41,0,112,63.393,63.393
6,0.000,Hu and Dg,16-23,10,18,0,28,35.714,35.714
6,0.000,Hu and Dg,23-5,19,14,0,33,57.576,57.576
6,0.000,Common Loon,16-23,0,0,0,0,NaN,NaN
6,0.000,Common Loon,23-5,0,4,0,4,0.000,0.000
6,0.000,Red-Winged Blackbird,16-23,0,12,0,12,0.000,0.000
6,0.000,Red-Winged Blackbird,23-5,0,6,0,6,0.000,0.000
6,0.000,Cw,16-23,12,12,0,24,50.000,50.000
6,0.000,Cw,23-5,27,45,0,72,37.500,37.500
6,0.000,Cliff Sparrow,16-23,3,30,0,33,9.091,9.091
6,0.000,Cliff Sparrow,23-5,2,8,0,10,20.000,20.000
6,0.000,Pig,16-23,11,10,0,21,52.381,52.381
6,0.000,Pig,23-5,4,12,0,16,25.000,25.000
6,0.000,Barn Owl,16-23,0,0,0,0,NaN,NaN
6,0.000,Barn Owl,23-5,0,0,0,0,NaN,NaN
6,0.000,Wild Pig,16-23,5,3,0,8,62.500,62.500
6,0.000,Wild Pig,23-5,3,4,0,7,42.857,42.857
6,0.000,Pennington Creek Water,16-23,0,0,0,0,NaN,NaN
6,0.000,Pennington Creek Water,23-5,0,0,0,0,NaN,NaN
6,0.000,Guinni,16-23,0,0,0,0,NaN,NaN
6,0.000,Guinni,23-5,0,0,0,0,NaN,NaN
6,0.000,Racoon,16-23,0,3,0,3,0.000,0.000
6,0.000,Racoon,23-5,0,0,0,0,NaN,NaN
6,0.000,Hu,16-23,17,18,0,35,48.571,48.571
6,0.000,Hu,23-5,19,10,0,29,65.517,65.517
6,0.000,Cw and Dg,16-23,4,16,0,20,20.000,20.000
6,0.000,Cw and Dg,23-5,16,23,0,39,41.026,41.026
6,0.000,Red Wind Blackbird,16-23,0,0,0,0,NaN,NaN
6,0.000,Red Wind Blackbird,23-5,0,0,0,0,NaN,NaN
6,0.000,Tree Swallow,16-23,0,2,0,2,0.000,0.000
6,0.000,Tree Swallow,23-5,0,4,0,4,0.000,0.000
6,0.000,Turkey Vulture,16-23,0,0,0,0,NaN,NaN
6,0.000,Turkey Vulture,23-5,0,0,0,0,NaN,NaN
6,0.000,Dg,16-23,8,16,0,24,33.333,33.333
6,0.000,Dg,23-5,30,30,0,60,50.000,50.000
6,0.000,Western Kingbird,16-23,0,0,0,0,NaN,NaN
6,0.000,Western Kingbird,23-5,0,0,0,0,NaN,NaN
6,0.000,White Crowned Sparrow,16-23,1,7,0,8,12.500,12.500
6,0.000,White Crowned Sparrow,23-5,3,19,0,22,13.636,13.636
6,0.000,Eared Grebe,16-23,0,0,0,0,NaN,NaN
6,0.000,Eared Grebe,23-5,2,18,0,20,10.000,10.000
6,0.000,cougar,16-23,0,0,0,0,NaN,NaN
6,0.000,cougar,23-5,0,0,0,0,NaN,NaN
6,0.000,Ocean Water,16-23,0,0,0,0,NaN,NaN
6,0.000,Ocean Water,23-5,0,0,0,0,NaN,NaN
6,0.000,Red Tailed Hawk,16-23,0,4,0,4,0.000,0.000
6,0.000,Red Tailed Hawk,23-5,0,9,0,9,0.000,0.000
6,0.000,Dog,16-23,72,82,0,154,46.753,46.753
6,0.000,Dog,23-5,109,145,0,254,42.913,42.913
6,0.000,Human,16-23,1729,650,0,2379,72.678,72.678
6,0.000,Human,23-5,2165,545,0,2710,79.889,79.889
6,0.000,Wild Turkey,16-23,13,24,0,37,35.135,35.135
6,0.000,Wild Turkey,23-5,2,31,0,33,6.061,6.061
6,0.000,Clark Grebe,16-23,0,0,0,0,NaN,NaN
6,0.000,Clark Grebe,23-5,0,1,0,1,0.000,0.000
6,0.000,Seagull,16-23,0,0,0,0,NaN,NaN
6,0.000,Seagull,23-5,13,6,0,19,68.421,68.421
6,0.000,Surf Scoter,16-23,0,0,0,0,NaN,NaN
6,0.000,Surf Scoter,23-5,0,3,0,3,0.000,0.000
6,0.000,Pigeon,16-23,78,181,0,259,30.116,30.116
6,0.000,Pigeon,23-5,106,265,0,371,28.571,28.571
6,0.000,Pacific Ocean Water,16-23,0,0,0,0,NaN,NaN
6,0.000,Pacific Ocean Water,23-5,0,0,0,0,NaN,NaN
6,0.000,Cat,16-23,25,39,0,64,39.063,39.063
6,0.000,Cat,23-5,28,42,0,70,40.000,40.000
6,0.000,Horse,16-23,10,22,0,32,31.250,31.250
6,0.000,Horse,23-5,35,191,0,226,15.487,15.487
6,0.000,orangutan,16-23,0,0,0,0,NaN,NaN
6,0.000,orangutan,23-5,0,0,0,0,NaN,NaN
6,0.000,Bat,16-23,36,22,0,58,62.069,62.069
6,0.000,Bat,23-5,37,24,0,61,60.656,60.656
6,0.000,Deer,16-23,16,29,0,45,35.556,35.556
6,0.000,Deer,23-5,18,86,0,104,17.308,17.308
6,0.000,Great Horned Owl,16-23,0,0,0,0,NaN,NaN
6,0.000,Great Horned Owl,23-5,0,6,0,6,0.000,0.000
6,0.000,Freshwater Lagoon,16-23,0,0,0,0,NaN,NaN
6,0.000,Freshwater Lagoon,23-5,0,0,0,0,NaN,NaN
6,0.000,Unknown Avian,16-23,0,0,0,0,NaN,NaN
6,0.000,Unknown Avian,23-5,0,0,0,0,NaN,NaN
6,0.000,Human UTI,16-23,83,80,0,163,50.920,50.920
6,0.000,Human UTI,23-5,111,96,0,207,53.623,53.623
6,0.000,unknown,16-23,0,3,0,3,0.000,0.000
6,0.000,unknown,23-5,2,6,0,8,25.000,25.000
6,0.000,SLO Creek Water,16-23,0,0,0,0,NaN,NaN
6,0.000,SLO Creek Water,23-5,0,0,0,0,NaN,NaN
6,0.000,Pig/Swine,16-23,14,12,0,26,53.846,53.846
6,0.000,Pig/Swine,23-5,13,9,0,22,59.091,59.091
6,0.000,Klebsiella,16-23,0,0,0,0,NaN,NaN
6,0.000,Klebsiella,23-5,0,0,0,0,NaN,NaN
6,0.000,Hu Cw and Dg,16-23,11,24,0,35,31.429,31.429
6,0.000,Hu Cw and Dg,23-5,18,27,0,45,40.000,40.000
6,0.000,Ground Squirrel,16-23,104,80,0,184,56.522,56.522
6,0.000,Ground Squirrel,23-5,90,105,0,195,46.154,46.154
6,0.000,Opossum,16-23,0,2,0,2,0.000,0.000
6,0.000,Opossum,23-5,0,8,0,8,0.000,0.000
6,0.000,Cow,16-23,1529,1002,0,2531,60.411,60.411
6,0.000,Cow,23-5,1475,1282,0,2757,53.500,53.500
6,0.000,Deer Mouse,16-23,0,0,0,0,NaN,NaN
6,0.000,Deer Mouse,23-5,0,0,0,0,NaN,NaN
6,0.000,OVERALL,16-23,3859,2489,0,6348,60.791,60.791
6,0.000,OVERALL,23-5,4441,3169,0,7610,58.357,58.357
6,0.500,Chicken,16-23,4,15,0,19,21.053,21.053
6,0.500,Chicken,23-5,12,11,0,23,52.174,52.174
6,0.500,Sea Lion,16-23,0,1,0,1,0.000,0.000
6,0.500,Sea Lion,23-5,3,12,0,15,20.000,20.000
6,0.500,Hu and Cw,16-23,8,18,0,26,30.769,30.769
6,0.500,Hu and Cw,23-5,8,21,0,29,27.586,27.586
6,0.500,Sheep,16-23,56,52,0,108,51.852,51.852
6,0.500,Sheep,23-5,71,41,0,112,63.393,63.393
6,0.500,Hu and Dg,16-23,10,18,0,28,35.714,35.714
6,0.500,Hu and Dg,23-5,19,14,0,33,57.576,57.576
6,0.500,Common Loon,16-23,0,0,0,0,NaN,NaN
6,0.500,Common Loon,23-5,0,4,0,4,0.000,0.000
6,0.500,Red-Winged Blackbird,16-23,0,12,0,12,0.000,0.000
6,0.500,Red-Winged Blackbird,23-5,0,6,0,6,0.000,0.000
6,0.500,Cw,16-23,12,12,0,24,50.000,50.000
6,0.500,Cw,23-5,27,45,0,72,37.500,37.500
6,0.500,Cliff Sparrow,16-23,3,30,0,33,9.091,9.091
6,0.500,Cliff Sparrow,23-5,2,8,0,10,20.000,20.000
6,0.500,Pig,16-23,11,10,0,21,52.381,52.381
6,0.500,Pig,23-5,4,12,0,16,25.000,25.000
6,0.500,Barn Owl,16-23,0,0,0,0,NaN,NaN
6,0.500,Barn Owl,23-5,0,0,0,0,NaN,NaN
6,0.500,Wild Pig,16-23,5,3,0,8,62.500,62.500
6,0.500,Wild Pig,23-5,3,4,0,7,42.857,42.857
6,0.500,Pennington Creek Water,16-23,0,0,0,0,NaN,NaN
6,0.500,Pennington Creek Water,23-5,0,0,0,0,NaN,NaN
6,0.500,Guinni,16-23,0,0,0,0,NaN,NaN
6,0.500,Guinni,23-5,0,0,0,0,NaN,NaN
6,0.500,Racoon,16-23,0,3,0,3,0.000,0.000
6,0.500,Racoon,23-5,0,0,0,0,NaN,NaN
6,0.500,Hu,16-23,17,18,0,35,48.571,48.571
6,0.500,Hu,23-5,19,10,0,29,65.517,65.517
6,0.500,Cw and Dg,16-23,4,16,0,20,20.000,20.000
6,0.500,Cw and Dg,23-5,16,23,0,39,41.026,41.026
6,0.500,Red Wind Blackbird,16-23,0,0,0,0,NaN,NaN
6,0.500,Red Wind Blackbird,23-5,0,0,0,0,NaN,NaN
6,0.500,Tree Swallow,16-23,0,2,0,2,0.000,0.000
6,0.500,Tree Swallow,23-5,0,4,0,4,0.000,0.000
6,0.500,Turkey Vulture,16-23,0,0,0,0,NaN,NaN
6,0.500,Turkey Vulture,23-5,0,0,0,0,NaN,NaN
6,0.500,Dg,16-23,8,16,0,24,33.333,33.333
6,0.500,Dg,23-5,30,30,0,60,50.000,50.000
6,0.500,Western Kingbird,16-23,0,0,0,0,NaN,NaN
6,0.500,Western Kingbird,23-5,0,0,0,0,NaN,NaN
6,0.500,White Crowned Sparrow,16-23,1,7,0,8,12.500,12.500
6,0.500,White Crowned Sparrow,23-5,3,19,0,22,13.636,13.636
6,0.500,Eared Grebe,16-23,0,0,0,0,NaN,NaN
6,0.500,Eared Grebe,23-5,2,18,0,20,10.000,10.000
6,0.500,cougar,16-23,0,0,0,0,NaN,NaN
6,0.500,cougar,23-5,0,0,0,0,NaN,NaN
6,0.500,Ocean Water,16-23,0,0,0,0,NaN,NaN
6,0.500,Ocean Water,23-5,0,0,0,0,NaN,NaN
6,0.500,Red Tailed Hawk,16-23,0,4,0,4,0.000,0.000
6,0.500,Red Tailed Hawk,23-5,0,9,0,9,0.000,0.000
6,0.500,Dog,16-23,72,82,0,154,46.753,46.753
6,0.500,Dog,23-5,109,145,0,254,42.913,42.913
6,0.500,Human,16-23,1729,650,0,2379,72.678,72.678
6,0.500,Human,23-5,2165,545,0,2710,79.889,79.889
6,0.500,Wild Turkey,16-23,13,24,0,37,35.135,35.135
6,0.500,Wild Turkey,23-5,2,31,0,33,6.061,6.061
6,0.500,Clark Grebe,16-23,0,0,0,0,NaN,NaN
6,0.500,Clark Grebe,23-5,0,1,0,1,0.000,0.000
6,0.500,Seagull,16-23,0,0,0,0,NaN,NaN
6,0.500,Seagull,23-5,13,6,0,19,68.421,68.421
6,0.500,Surf Scoter,16-23,0,0,0,0,NaN,NaN
6,0.500,Surf Scoter,23-5,0,3,0,3,0.000,0.000
6,0.500,Pigeon,16-23,78,181,0,259,30.116,30.116
6,0.500,Pigeon,23-5,106,265,0,371,28.571,28.571
6,0.500,Pacific Ocean Water,16-23,0,0,0,0,NaN,NaN
6,0.500,Pacific Ocean Water,23-5,0,0,0,0,NaN,NaN
6,0.500,Cat,16-23,25,39,0,64,39.063,39.063
6,0.500,Cat,23-5,28,42,0,70,40.000,40.000
6,0.500,Horse,16-23,10,22,0,32,31.250,31.250
6,0.500,Horse,23-5,35,191,0,226,15.487,15.487
6,0.500,orangutan,16-23,0,0,0,0,NaN,NaN
6,0.500,orangutan,23-5,0,0,0,0,NaN,NaN
6,0.500,Bat,16-23,36,22,0,58,62.069,62.069
6,0.500,Bat,23-5,37,24,0,61,60.656,60.656
6,0.500,Deer,16-23,16,29,0,45,35.556,35.556
6,0.500,Deer,23-5,18,86,0,104,17.308,17.308
6,0.500,Great Horned Owl,16-23,0,0,0,0,NaN,NaN
6,0.500,Great Horned Owl,23-5,0,6,0,6,0.000,0.000
6,0.500,Freshwater Lagoon,16-23,0,0,0,0,NaN,NaN
6,0.500,Freshwater Lagoon,23-5,0,0,0,0,NaN,NaN
6,0.500,Unknown Avian,16-23,0,0,0,0,NaN,NaN
6,0.500,Unknown Avian,23-5,0,0,0,0,NaN,NaN
6,0.500,Human UTI,16-23,83,80,0,163,50.920,50.920
6,0.500,Human UTI,23-5,111,96,0,207,53.623,53.623
6,0.500,unknown,16-23,0,3,0,3,0.000,0.000
6,0.500,unknown,23-5,2,6,0,8,25.000,25.000
6,0.500,SLO Creek Water,16-23,0,0,0,0,NaN,NaN
6,0.500,SLO Creek Water,23-5,0,0,0,0,NaN,NaN
6,0.500,Pig/Swine,16-23,14,12,0,26,53.846,53.846
6,0.500,Pig/Swine,23-5,13,9,0,22,59.091,59.091
6,0.500,Klebsiella,16-23,0,0,0,0,NaN,NaN
6,0.500,Klebsiella,23-5,0,0,0,0,NaN,NaN
6,0.500,Hu Cw and Dg,16-23,11,24,0,35,31.429,31.429
6,0.500,Hu Cw and Dg,23-5,18,27,0,45,40.000,40.000
6,0.500,Ground Squirrel,16-23,104,80,0,184,56.522,56.522
6,0.500,Ground Squirrel,23-5,90,105,0,195,46.154,46.154
6,0.500,Opossum,16-23,0,2,0,2,0.000,0.000
6,0.500,Opossum,23-5,0,8,0,8,0.000,0.000
6,0.500,Cow,16-23,1529,1002,0,2531,60.411,60.411
6,0.500,Cow,23-5,1475,1282,0,2757,53.500,53.500
6,0.500,Deer Mouse,16-23,0,0,0,0,NaN,NaN
6,0.500,Deer Mouse,23-5,0,0,0,0,NaN,NaN
6,0.500,OVERALL,16-23,3859,2489,0,6348,60.791,60.791
6,0.500,OVERALL,23-5,4441,3169,0,7610,58.357,58.357
6,0.900,Chicken,16-23,4,15,0,19,21.053,21.053
6,0.900,Chicken,23-5,12,11,0,23,52.174,52.174
6,0.900,Sea Lion,16-23,0,1,0,1,0.000,0.000
6,0.900,Sea Lion,23-5,3,12,0,15,20.000,20.000
6,0.900,Hu and Cw,16-23,8,18,0,26,30.769,30.769
6,0.900,Hu and Cw,23-5,8,21,0,29,27.586,27.586
6,0.900,Sheep,16-23,56,52,0,108,51.852,51.852
6,0.900,Sheep,23-5,71,41,0,112,63.393,63.393
6,0.900,Hu and Dg,16-23,10,18,0,28,35.714,35.714
6,0.900,Hu and Dg,23-5,19,14,0,33,57.576,57.576
6,0.900,Common Loon,16-23,0,0,0,0,NaN,NaN
6,0.900,Common Loon,23-5,0,4,0,4,0.000,0.000
6,0.900,Red-Winged Blackbird,16-23,0,12,0,12,0.000,0.000
6,0.900,Red-Winged Blackbird,23-5,0,6,0,6,0.000,0.000
6,0.900,Cw,16-23,12,12,0,24,50.000,50.000
6,0.900,Cw,23-5,27,45,0,72,37.500,37.500
6,0.900,Cliff Sparrow,16-23,3,30,0,33,9.091,9.091
6,0.900,Cliff Sparrow,23-5,2,8,0,10,20.000,20.000
6,0.900,Pig,16-23,11,10,0,21,52.381,52.381
6,0.900,Pig,23-5,4,12,0,16,25.000,25.000
6,0.900,Barn Owl,16-23,0,0,0,0,NaN,NaN
6,0.900,Barn Owl,23-5,0,0,0,0,NaN,NaN
6,0.900,Wild Pig,16-23,5,3,0,8,62.500,62.500
6,0.900,Wild Pig,23-5,3,4,0,7,42.857,42.857
6,0.900,Pennington Creek Water,16-23,0,0,0,0,NaN,NaN
6,0.900,Pennington Creek Water,23-5,0,0,0,0,NaN,NaN
6,0.900,Guinni,16-23,0,0,0,0,NaN,NaN
6,0.900,Guinni,23-5,0,0,0,0,NaN,NaN
6,0.900,Racoon,16-23,0,3,0,3,0.000,0.000
6,0.900,Racoon,23-5,0,0,0,0,NaN,NaN
6,0.900,Hu,16-23,17,18,0,35,48.571,48.571
6,0.900,Hu,23-5,19,10,0,29,65.517,65.517
6,0.900,Cw and Dg,16-23,4,16,0,20,20.000,20.000
6,0.900,Cw and Dg,23-5,16,23,0,39,41.026,41.026
6,0.900,Red Wind Blackbird,16-23,0,0,0,0,NaN,NaN
6,0.900,Red Wind Blackbird,23-5,0,0,0,0,NaN,NaN
6,0.900,Tree Swallow,16-23,0,2,0,2,0.000,0.000
6,0.900,Tree Swallow,23-5,0,4,0,4,0.000,0.000
6,0.900,Turkey Vulture,16-23,0,0,0,0,NaN,NaN
6,0.900,Turkey Vulture,23-5,0,0,0,0,NaN,NaN
6,0.900,Dg,16-23,8,16,0,24,33.333,33.333
6,0.900,Dg,23-5,30,30,0,60,50.000,50.000
6,0.900,Western Kingbird,16-23,0,0,0,0,NaN,NaN
6,0.900,Western Kingbird,23-5,0,0,0,0,NaN,NaN
6,0.900,White Crowned Sparrow,16-23,1,7,0,8,12.500,12.500
6,0.900,White Crowned Sparrow,23-5,3,19,0,22,13.636,13.636
6,0.900,Eared Grebe,16-23,0,0,0,0,NaN,NaN
6,0.900,Eared Grebe,23-5,2,18,0,20,10.000,10.000
6,0.900,cougar,16-23,0,0,0,0,NaN,NaN
6,0.900,cougar,23-5,0,0,0,0,NaN,NaN
6,0.900,Ocean Water,16-23,0,0,0,0,NaN,NaN
6,0.900,Ocean Water,23-5,0,0,0,0,NaN,NaN
6,0.900,Red Tailed Hawk,16-23,0,4,0,4,0.000,0.000
6,0.900,Red Tailed Hawk,23-5,0,9,0,9,0.000,0.000
6,0.900,Dog,16-23,72,82,0,154,46.753,46.753
6,0.900,Dog,23-5,109,143,0,252,43.254,43.254
6,0.900,Human,16-23,1729,646,0,2375,72.800,72.800
6,0.900,Human,23-5,2165,541,0,2706,80.007,80.007
6,0.900,Wild Turkey,16-23,13,24,0,37,35.135,35.135
6,0.900,Wild Turkey,23-5,2,31,0,33,6.061,6.061
6,0.900,Clark Grebe,16-23,0,0,0,0,NaN,NaN
6,0.900,Clark Grebe,23-5,0,1,0,1,0.000,0.000
6,0.900,Seagull,16-23,0,0,0,0,NaN,NaN
6,0.900,Seagull,23-5,13,7,0,20,65.000,65.000
6,0.900,Surf Scoter,16-23,0,0,0,0,NaN,NaN
6,0.900,Surf Scoter,23-5,0,2,0,2,0.000,0.000
6,0.900,Pigeon,16-23,78,181,0,259,30.116,30.116
6,0.900,Pigeon,23-5,106,265,0,371,28.571,28.571
6,0.900,Pacific Ocean Water,16-23,0,0,0,0,NaN,NaN
6,0.900,Pacific Ocean Water,23-5,0,0,0,0,NaN,NaN
6,0.900,Cat,16-23,25,39,0,64,39.063,39.063
6,0.900,Cat,23-5,28,42,0,70,40.000,40.000
6,0.900,Horse,16-23,10,22,0,32,31.250,31.250
6,0.900,Horse,23-5,35,191,0,226,15.487,15.487
6,0.900,orangutan,16-23,0,0,0,0,NaN,NaN
6,0.900,orangutan,23-5,0,0,0,0,NaN,NaN
6,0.900,Bat,16-23,36,22,0,58,62.069,62.069
6,0.900,Bat,23-5,37,24,0,61,60.656,60.656
6,0.900,Deer,16-23,16,29,0,45,35.556,35.556
6,0.900,Deer,23-5,18,86,0,104,17.308,17.308
6,0.900,Great Horned Owl,16-23,0,0,0,0,NaN,NaN
6,0.900,Great Horned Owl,23-5,0,6,0,6,0.000,0.000
6,0.900,Freshwater Lagoon,16-23,0,0,0,0,NaN,NaN
6,0.900,Freshwater Lagoon,23-5,0,0,0,0,NaN,NaN
6,0.900,Unknown Avian,16-23,0,0,0,0,NaN,NaN
6,0.900,Unknown Avian,23-5,0,0,0,0,NaN,NaN
6,0.900,Human UTI,16-23,83,80,0,163,50.920,50.920
6,0.900,Human UTI,23-5,111,96,0,207,53.623,53.623
6,0.900,unknown,16-23,0,3,0,3,0.000,0.000
6,0.900,unknown,23-5,2,6,0,8,25.000,25.000
6,0.900,SLO Creek Water,16-23,0,0,0,0,NaN,NaN
6,0.900,SLO Creek Water,23-5,0,0,0,0,NaN,NaN
6,0.900,Pig/Swine,16-23,14,12,0,26,53.846,53.846
6,0.900,Pig/Swine,23-5,13,9,0,22,59.091,59.091
6,0.900,Klebsiella,16-23,0,0,0,0,NaN,NaN
6,0.900,Klebsiella,23-5,0,0,0,0,NaN,NaN
6,0.900,Hu Cw and Dg,16-23,11,24,0,35,31.429,31.429
6,0.900,Hu Cw and Dg,23-5,18,27,0,45,40.000,40.000
6,0.900,Ground Squirrel,16-23,104,80,0,184,56.522,56.522
6,0.900,Ground Squirrel,23-5,90,105,0,195,46.154,46.154
6,0.900,Opossum,16-23,0,2,0,2,0.000,0.000
6,0.900,Opossum,23-5,0,8,0,8,0.000,0.000
6,0.900,Cow,16-23,1529,1002,0,2531,60.411,60.411
6,0.900,Cow,23-5,1475,1280,0,2755,53.539,53.539
6,0.900,Deer Mouse,16-23,0,0,0,0,NaN,NaN
6,0.900,Deer Mouse,23-5,0,0,0,0,NaN,NaN
6,0.900,OVERALL,16-23,3859,2485,0,6344,60.829,60.829
6,0.900,OVERALL,23-5,4441,3161,0,7602,58.419,58.419
6,0.950,Chicken,16-23,4,15,0,19,21.053,21.053
6,0.950,Chicken,23-5,12,11,0,23,52.174,52.174
6,0.950,Sea Lion,16-23,0,1,0,1,0.000,0.000
6,0.950,Sea Lion,23-5,3,12,0,15,20.000,20.000
6,0.950,Hu and Cw,16-23,8,18,0,26,30.769,30.769
6,0.950,Hu and Cw,23-5,8,21,0,29,27.586,27.586
6,0.950,Sheep,16-23,56,52,0,108,51.852,51.852
6,0.950,Sheep,23-5,71,41,0,112,63.393,63.393
6,0.950,Hu and Dg,16-23,10,18,0,28,35.714,35.714
6,0.950,Hu and Dg,23-5,19,14,0,33,57.576,57.576
6,0.950,Common Loon,16-23,0,0,0,0,NaN,NaN
6,0.950,Common Loon,23-5,0,4,0,4,0.000,0.000
6,0.950,Red-Winged Blackbird,16-23,0,12,0,12,0.000,0.000
6,0.950,Red-Winged Blackbird,23-5,0,6,0,6,0.000,0.000
6,0.950,Cw,16-23,12,12,0,24,50.000,50.000
6,0.950,Cw,23-5,27,45,0,72,37.500,37.500
6,0.950,Cliff Sparrow,16-23,3,30,0,33,9.091,9.091
6,0.950,Cliff Sparrow,23-5,2,8,0,10,20.000,20.000
6,0.950,Pig,16-23,11,10,0,21,52.381,52.381
6,0.950,Pig,23-5,4,12,0,16,25.000,25.000
6,0.950,Barn Owl,16-23,0,0,0,0,NaN,NaN
6,0.950,Barn Owl,23-5,0,0,0,0,NaN,NaN
6,0.950,Wild Pig,16-23,5,3,0,8,62.500,62.500
6,0.950,Wild Pig,23-5,3,3,0,6,50.000,50.000
6,0.950,Pennington Creek Water,16-23,0,0,0,0,NaN,NaN
6,0.950,Pennington Creek Water,23-5,0,0,0,0,NaN,NaN
6,0.950,Guinni,16-23,0,0,0,0,NaN,NaN
6,0.950,Guinni,23-5,0,0,0,0,NaN,NaN
6,0.950,Racoon,16-23,0,3,0,3,0.000,0.000
6,0.950,Racoon,23-5,0,0,0,0,NaN,NaN
6,0.950,Hu,16-23,17,18,0,35,48.571,48.571
6,0.950,Hu,23-5,19,10,0,29,65.517,65.517
6,0.950,Cw and Dg,16-23,4,16,0,20,20.000,20.000
6,0.950,Cw and Dg,23-5,16,23,0,39,41.026,41.026
6,0.950,Red Wind Blackbird,16-23,0,0,0,0,NaN,NaN
6,0.950,Red Wind Blackbird,23-5,0,0,0,0,NaN,NaN
6,0.950,Tree Swallow,16-23,0,2,0,2,0.000,0.000
6,0.950,Tree Swallow,23-5,0,4,0,4,0.000,0.000
6,0.950,Turkey Vulture,16-23,0,0,0,0,NaN,NaN
6,0.950,Turkey Vulture,23-5,0,0,0,0,NaN,NaN
6,0.950,Dg,16-23,8,16,0,24,33.333,33.333
6,0.950,Dg,23-5,30,30,0,60,50.000,50.000
6,0.950,Western Kingbird,16-23,0,0,0,0,NaN,NaN
6,0.950,Western Kingbird,23-5,0,0,0,0,NaN,NaN
6,0.950,White Crowned Sparrow,16-23,1,7,0,8,12.500,12.500
6,0.950,White Crowned Sparrow,23-5,3,19,0,22,13.636,13.636
6,0.950,Eared Grebe,16-23,0,0,0,0,NaN,NaN
6,0.950,Eared Grebe,23-5,2,18,0,20,10.000,10.000
6,0.950,cougar,16-23,0,0,0,0,NaN,NaN
6,0.950,cougar,23-5,0,0,0,0,NaN,NaN
6,0.950,Ocean Water,16-23,0,0,0,0,NaN,NaN
6,0.950,Ocean Water,23-5,0,0,0,0,NaN,NaN
6,0.950,Red Tailed Hawk,16-23,0,4,0,4,0.000,0.000
6,0.950,Red Tailed Hawk,23-5,0,9,0,9,0.000,0.000
6,0.950,Dog,16-23,72,82,0,154,46.753,46.753
6,0.950,Dog,23-5,109,142,0,251,43.426,43.426
6,0.950,Human,16-23,1729,646,0,2375,72.800,72.800
6,0.950,Human,23-5,2165,536,0,2701,80.155,80.155
6,0.950,Wild Turkey,16-23,13,24,0,37,35.135,35.135
6,0.950,Wild Turkey,23-5,2,31,0,33,6.061,6.061
6,0.950,Clark Grebe,16-23,0,0,0,0,NaN,NaN
6,0.950,Clark Grebe,23-5,0,1,0,1,0.000,0.000
6,0.950,Seagull,16-23,0,0,0,0,NaN,NaN
6,0.950,Seagull,23-5,13,6,0,19,68.421,68.421
6,0.950,Surf Scoter,16-23,0,0,0,0,NaN,NaN
6,0.950,Surf Scoter,23-5,0,1,0,1,0.000,0.000
6,0.950,Pigeon,16-23,78,181,0,259,30.116,30.116
6,0.950,Pigeon,23-5,106,266,0,372,28.495,28.495
6,0.950,Pacific Ocean Water,16-23,0,0,0,0,NaN,NaN
6,0.950,Pacific Ocean Water,23-5,0,0,0,0,NaN,NaN
6,0.950,Cat,16-23,25,39,0,64,39.063,39.063
6,0.950,Cat,23-5,28,42,0,70,40.000,40.000
6,0.950,Horse,16-23,10,22,0,32,31.250,31.250
6,0.950,Horse,23-5,35,191,0,226,15.487,15.487
6,0.950,orangutan,16-23,0,0,0,0,NaN,NaN
6,0.950,orangutan,23-5,0,0,0,0,NaN,NaN
6,0.950,Bat,16-23,36,22,0,58,62.069,62.069
6,0.950,Bat,23-5,37,23,0,60,61.667,61.667
6,0.950,Deer,16-23,16,29,0,45,35.556,35.556
6,0.950,Deer,23-5,18,86,0,104,17.308,17.308
6,0.950,Great Horned Owl,16-23,0,0,0,0,NaN,NaN
6,0.950,Great Horned Owl,23-5,0,6,0,6,0.000,0.000
6,0.950,Freshwater Lagoon,16-23,0,0,0,0,NaN,NaN
6,0.950,Freshwater Lagoon,23-5,0,0,0,0,NaN,NaN
6,0.950,Unknown Avian,16-23,0,0,0,0,NaN,NaN
6,0.950,Unknown Avian,23-5,0,0,0,0,NaN,NaN
6,0.950,Human UTI,16-23,86,80,0,166,51.807,51.807
6,0.950,Human UTI,23-5,110,97,0,207,53.140,53.140
6,0.950,unknown,16-23,0,3,0,3,0.000,0.000
6,0.950,unknown,23-5,2,6,0,8,25.000,25.000
6,0.950,SLO Creek Water,16-23,0,0,0,0,NaN,NaN
6,0.950,SLO Creek Water,23-5,0,0,0,0,NaN,NaN
6,0.950,Pig/Swine,16-23,14,12,0,26,53.846,53.846
6,0.950,Pig/Swine,23-5,13,9,0,22,59.091,59.091
6,0.950,Klebsiella,16-23,0,0,0,0,NaN,NaN
6,0.950,Klebsiella,23-5,0,0,0,0,NaN,NaN
6,0.950,Hu Cw and Dg,16-23,11,24,0,35,31.429,31.429
6,0.950,Hu Cw and Dg,23-5,18,27,0,45,40.000,40.000
6,0.950,Ground Squirrel,16-23,104,80,0,184,56.522,56.522
6,0.950,Ground Squirrel,23-5,90,104,0,194,46.392,46.392
6,0.950,Opossum,16-23,0,2,0,2,0.000,0.000
6,0.950,Opossum,23-5,0,8,0,8,0.000,0.000
6,0.950,Cow,16-23,1529,982,0,2511,60.892,60.892
6,0.950,Cow,23-5,1474,1277,0,2751,53.581,53.581
6,0.950,Deer Mouse,16-23,0,0,0,0,NaN,NaN
6,0.950,Deer Mouse,23-5,0,0,0,0,NaN,NaN
6,0.950,OVERALL,16-23,3862,2465,0,6327,61.040,61.040
6,0.950,OVERALL,23-5,4439,3149,0,7588,58.500,58.500
6,0.960,Chicken,16-23,4,15,0,19,21.053,21.053
6,0.960,Chicken,23-5,12,11,0,23,52.174,52.174
6,0.960,Sea Lion,16-23,0,1,0,1,0.000,0.000
6,0.960,Sea Lion,23-5,3,12,0,15,20.000,20.000
6,0.960,Hu and Cw,16-23,8,18,0,26,30.769,30.769
6,0.960,Hu and Cw,23-5,8,21,0,29,27.586,27.586
6,0.960,Sheep,16-23,56,52,0,108,51.852,51.852
6,0.960,Sheep,23-5,71,42,0,113,62.832,62.832
6,0.960,Hu and Dg,16-23,10,18,0,28,35.714,35.714
6,0.960,Hu and Dg,23-5,19,14,0,33,57.576,57.576
6,0.960,Common Loon,16-23,0,0,0,0,NaN,NaN
6,0.960,Common Loon,23-5,0,4,0,4,0.000,0.000
6,0.960,Red-Winged Blackbird,16-23,0,12,0,12,0.000,0.000
6,0.960,Red-Winged Blackbird,23-5,0,6,0,6,0.000,0.000
6,0.960,Cw,16-23,12,12,0,24,50.000,50.000
6,0.960,Cw,23-5,27,45,0,72,37.500,37.500
6,0.960,Cliff Sparrow,16-23,3,30,0,33,9.091,9.091
6,0.960,Cliff Sparrow,23-5,2,8,0,10,20.000,20.000
6,0.960,Pig,16-23,11,10,0,21,52.381,52.381
6,0.960,Pig,23-5,4,12,0,16,25.000,25.000
6,0.960,Barn Owl,16-23,0,0,0,0,NaN,NaN
6,0.960,Barn Owl,23-5,0,0,0,0,NaN,NaN
6,0.960,Wild Pig,16-23,5,3,0,8,62.500,62.500
6,0.960,Wild Pig,23-5,4,3,0,7,57.143,57.143
6,0.960,Pennington Creek Water,16-23,0,0,0,0,NaN,NaN
6,0.960,Pennington Creek Water,23-5,0,0,0,0,NaN,NaN
6,0.960,Guinni,16-23,0,0,0,0,NaN,NaN
6,0.960,Guinni,23-5,0,0,0,0,NaN,NaN
6,0.960,Racoon,16-23,0,3,0,3,0.000,0.000
6,0.960,Racoon,23-5,0,0,0,0,NaN,NaN
6,0.960,Hu,16-23,17,18,0,35,48.571,48.571
6,0.960,Hu,23-5,19,10,0,29,65.517,65.517
6,0.960,Cw and Dg,16-23,4,16,0,20,20.000,20.000
6,0.960,Cw and Dg,23-5,16,23,0,39,41.026,41.026
6,0.960,Red Wind Blackbird,16-23,0,0,0,0,NaN,NaN
6,0.960,Red Wind Blackbird,23-5,0,0,0,0,NaN,NaN
6,0.960,Tree Swallow,16-23,0,2,0,2,0.000,0.000
6,0.960,Tree Swallow,23-5,0,4,0,4,0.000,0.000
6,0.960,Turkey Vulture,16-23,0,0,0,0,NaN,NaN
6,0.960,Turkey Vulture,23-5,0,0,0,0,NaN,NaN
6,0.960,Dg,16-23,8,16,0,24,33.333,33.333
6,0.960,Dg,23-5,30,30,0,60,50.000,50.000
6,0.960,Western Kingbird,16-23,0,0,0,0,NaN,NaN
6,0.960,Western Kingbird,23-5,0,0,0,0,NaN,NaN
6,0.960,White Crowned Sparrow,16-23,1,7,0,8,12.500,12.500
6,0.960,White Crowned Sparrow,23-5,3,19,0,22,13.636,13.636
6,0.960,Eared Grebe,16-23,0,0,0,0,NaN,NaN
6,0.960,Eared Grebe,23-5,2,18,0,20,10.000,10.000
6,0.960,cougar,16-23,0,0,0,0,NaN,NaN
6,0.960,cougar,23-5,0,0,0,0,NaN,NaN
6,0.960,Ocean Water,16-23,0,0,0,0,NaN,NaN
6,0.960,Ocean Water,23-5,0,0,0,0,NaN,NaN
6,0.960,Red Tailed Hawk,16-23,0,4,0,4,0.000,0.000
6,0.960,Red Tailed Hawk,23-5,0,9,0,9,0.000,0.000
6,0.960,Dog,16-23,72,82,0,154,46.753,46.753
6,0.960,Dog,23-5,109,139,0,248,43.952,43.952
6,0.960,Human,16-23,1729,645,0,2374,72.831,72.831
6,0.960,Human,23-5,2170,523,0,2693,80.579,80.579
6,0.960,Wild Turkey,16-23,13,24,0,37,35.135,35.135
6,0.960,Wild Turkey,23-5,2,34,0,36,5.556,5.556
6,0.960,Clark Grebe,16-23,0,0,0,0,NaN,NaN
6,0.960,Clark Grebe,23-5,0,1,0,1,0.000,0.000
6,0.960,Seagull,16-23,0,0,0,0,NaN,NaN
6,0.960,Seagull,23-5,13,7,0,20,65.000,65.000
6,0.960,Surf Scoter,16-23,0,0,0,0,NaN,NaN
6,0.960,Surf Scoter,23-5,0,2,0,2,0.000,0.000
6,0.960,Pigeon,16-23,77,181,0,258,29.845,29.845
6,0.960,Pigeon,23-5,107,279,0,386,27.720,27.720
6,0.960,Pacific Ocean Water,16-23,0,0,0,0,NaN,NaN
6,0.960,Pacific Ocean Water,23-5,0,0,0,0,NaN,NaN
6,0.960,Cat,16-23,25,39,0,64,39.063,39.063
6,0.960,Cat,23-5,28,42,0,70,40.000,40.000
6,0.960,Horse,16-23,10,22,0,32,31.250,31.250
6,0.960,Horse,23-5,35,191,0,226,15.487,15.487
6,0.960,orangutan,16-23,0,0,0,0,NaN,NaN
6,0.960,orangutan,23-5,0,0,0,0,NaN,NaN
6,0.960,Bat,16-23,36,22,0,58,62.069,62.069
6,0.960,Bat,23-5,37,23,0,60,61.667,61.667
6,0.960,Deer,16-23,16,29,0,45,35.556,35.556
6,0.960,Deer,23-5,18,86,0,104,17.308,17.308
6,0.960,Great Horned Owl,16-23,0,0,0,0,NaN,NaN
6,0.960,Great Horned Owl,23-5,0,6,0,6,0.000,0.000
6,0.960,Freshwater Lagoon,16-23,0,0,0,0,NaN,NaN
6,0.960,Freshwater Lagoon,23-5,0,0,0,0,NaN,NaN
6,0.960,Unknown Avian,16-23,0,0,0,0,NaN,NaN
6,0.960,Unknown Avian,23-5,0,0,0,0,NaN,NaN
6,0.960,Human UTI,16-23,86,80,0,166,51.807,51.807
6,0.960,Human UTI,23-5,110,96,0,206,53.398,53.398
6,0.960,unknown,16-23,0,3,0,3,0.000,0.000
6,0.960,unknown,23-5,2,6,0,8,25.000,25.000
6,0.960,SLO Creek Water,16-23,0,0,0,0,NaN,NaN
6,0.960,SLO Creek Water,23-5,0,0,0,0,NaN,NaN
6,0.960,Pig/Swine,16-23,14,12,0,26,53.846,53.846
6,0.960,Pig/Swine,23-5,13,9,0,22,59.091,59.091
6,0.960,Klebsiella,16-23,0,0,0,0,NaN,NaN
6,0.960,Klebsiella,23-5,0,0,0,0,NaN,NaN
6,0.960,Hu Cw and Dg,16-23,11,24,0,35,31.429,31.429
6,0.960,Hu Cw and Dg,23-5,18,27,0,45,40.000,40.000
6,0.960,Ground Squirrel,16-23,104,80,0,184,56.522,56.522
6,0.960,Ground Squirrel,23-5,90,105,0,195,46.154,46.154
6,0.960,Opossum,16-23,0,2,0,2,0.000,0.000
6,0.960,Opossum,23-5,0,8,0,8,0.000,0.000
6,0.960,Cow,16-23,1527,975,0,2502,61.031,61.031
6,0.960,Cow,23-5,1474,1256,0,2730,53.993,53.993
6,0.960,Deer Mouse,16-23,0,0,0,0,NaN,NaN
6,0.960,Deer Mouse,23-5,0,0,0,0,NaN,NaN
6,0.960,OVERALL,16-23,3859,2457,0,6316,61.099,61.099
6,0.960,OVERALL,23-5,4446,3131,0,7577,58.678,58.678
6,0.970,Chicken,16-23,4,15,0,19,21.053,21.053
6,0.970,Chicken,23-5,12,11,0,23,52.174,52.174
6,0.970,Sea Lion,16-23,0,1,0,1,0.000,0.000
6,0.970,Sea Lion,23-5,3,12,0,15,20.000,20.000
6,0.970,Hu and Cw,16-23,8,18,0,26,30.769,30.769
6,0.970,Hu and Cw,23-5,8,21,0,29,27.586,27.586
6,0.970,Sheep,16-23,56,53,0,109,51.376,51.376
6,0.970,Sheep,23-5,71,41,0,112,63.393,63.393
6,0.970,Hu and Dg,16-23,10,18,0,28,35.714,35.714
6,0.970,Hu and Dg,23-5,19,14,0,33,57.576,57.576
6,0.970,Common Loon,16-23,0,0,0,0,NaN,NaN
6,0.970,Common Loon,23-5,0,4,0,4,0.000,0.000
6,0.970,Red-Winged Blackbird,16-23,0,12,0,12,0.000,0.000
6,0.970,Red-Winged Blackbird,23-5,0,6,0,6,0.000,0.000
6,0.970,Cw,16-23,12,13,0,25,48.000,48.000
6,0.970,Cw,23-5,27,45,0,72,37.500,37.500
6,0.970,Cliff Sparrow,16-23,3,30,0,33,9.091,9.091
6,0.970,Cliff Sparrow,23-5,2,8,0,10,20.000,20.000
6,0.970,Pig,16-23,11,10,0,21,52.381,52.381
6,0.970,Pig,23-5,4,12,0,16,25.000,25.000
6,0.970,Barn Owl,16-23,0,0,0,0,NaN,NaN
6,0.970,Barn Owl,23-5,0,0,0,0,NaN,NaN
6,0.970,Wild Pig,16-23,5,3,0,8,62.500,62.500
6,0.970,Wild Pig,23-5,3,3,0,6,50.000,50.000
6,0.970,Pennington Creek Water,16-23,0,0,0,0,NaN,NaN
6,0.970,Pennington Creek Water,23-5,0,0,0,0,NaN,NaN
6,0.970,Guinni,16-23,0,0,0,0,NaN,NaN
6,0.970,Guinni,23-5,0,0,0,0,NaN,NaN
6,0.970,Racoon,16-23,0,3,0,3,0.000,0.000
6,0.970,Racoon,23-5,0,0,0,0,NaN,NaN
6,0.970,Hu,16-23,17,18,0,35,48.571,48.571
6,0.970,Hu,23-5,19,10,0,29,65.517,65.517
6,0.970,Cw and Dg,16-23,4,16,0,20,20.000,20.000
6,0.970,Cw and Dg,23-5,16,23,0,39,41.026,41.026
6,0.970,Red Wind Blackbird,16-23,0,0,0,0,NaN,NaN
6,0.970,Red Wind Blackbird,23-5,0,0,0,0,NaN,NaN
6,0.970,Tree Swallow,16-23,0,2,0,2,0.000,0.000
6,0.970,Tree Swallow,23-5,0,4,0,4,0.000,0.000
6,0.970,Turkey Vulture,16-23,0,0,0,0,NaN,NaN
6,0.970,Turkey Vulture,23-5,0,0,0,0,NaN,NaN
6,0.970,Dg,16-23,8,16,0,24,33.333,33.333
6,0.970,Dg,23-5,30,29,0,59,50.847,50.847
6,0.970,Western Kingbird,16-23,0,0,0,0,NaN,NaN
6,0.970,Western Kingbird,23-5,0,0,0,0,NaN,NaN
6,0.970,White Crowned Sparrow,16-23,1,7,0,8,12.500,12.500
6,0.970,White Crowned Sparrow,23-5,3,19,0,22,13.636,13.636
6,0.970,Eared Grebe,16-23,0,0,0,0,NaN,NaN
6,0.970,Eared Grebe,23-5,2,18,0,20,10.000,10.000
6,0.970,cougar,16-23,0,0,0,0,NaN,NaN
6,0.970,cougar,23-5,0,0,0,0,NaN,NaN
6,0.970,Ocean Water,16-23,0,0,0,0,NaN,NaN
6,0.970,Ocean Water,23-5,0,0,0,0,NaN,NaN
6,0.970,Red Tailed Hawk,16-23,0,4,0,4,0.000,0.000
6,0.970,Red Tailed Hawk,23-5,0,9,0,9,0.000,0.000
6,0.970,Dog,16-23,72,82,0,154,46.753,46.753
6,0.970,Dog,23-5,109,138,0,247,44.130,44.130
6,0.970,Human,16-23,1729,644,0,2373,72.861,72.861
6,0.970,Human,23-5,2166,522,0,2688,80.580,80.580
6,0.970,Wild Turkey,16-23,13,25,0,38,34.211,34.211
6,0.970,Wild Turkey,23-5,4,33,0,37,10.811,10.811
6,0.970,Clark Grebe,16-23,0,0,0,0,NaN,NaN
6,0.970,Clark Grebe,23-5,0,1,0,1,0.000,0.000
6,0.970,Seagull,16-23,0,0,0,0,NaN,NaN
6,0.970,Seagull,23-5,13,8,0,21,61.905,61.905
6,0.970,Surf Scoter,16-23,0,0,0,0,NaN,NaN
6,0.970,Surf Scoter,23-5,0,2,0,2,0.000,0.000
6,0.970,Pigeon,16-23,75,180,0,255,29.412,29.412
6,0.970,Pigeon,23-5,107,297,0,404,26.485,26.485
6,0.970,Pacific Ocean Water,16-23,0,0,0,0,NaN,NaN
6,0.970,Pacific Ocean Water,23-5,0,0,0,0,NaN,NaN
6,0.970,Cat,16-23,25,39,0,64,39.063,39.063
6,0.970,Cat,23-5,28,42,0,70,40.000,40.000
6,0.970,Horse,16-23,10,22,0,32,31.250,31.250
6,0.970,Horse,23-5,35,191,0,226,15.487,15.487
6,0.970,orangutan,16-23,0,0,0,0,NaN,NaN
6,0.970,orangutan,23-5,0,0,0,0,NaN,NaN
6,0.970,Bat,16-23,36,22,0,58,62.069,62.069
6,0.970,Bat,23-5,37,23,0,60,61.667,61.667
6,0.970,Deer,16-23,16,29,0,45,35.556,35.556
6,0.970,Deer,23-5,18,86,0,104,17.308,17.308
6,0.970,Great Horned Owl,16-23,0,0,0,0,NaN,NaN
6,0.970,Great Horned Owl,23-5,0,6,0,6,0.000,0.000
6,0.970,Freshwater Lagoon,16-23,0,0,0,0,NaN,NaN
6,0.970,Freshwater Lagoon,23-5,0,0,0,0,NaN,NaN
6,0.970,Unknown Avian,16-23,0,0,0,0,NaN,NaN
6,0.970,Unknown Avian,23-5,0,0,0,0,NaN,NaN
6,0.970,Human UTI,16-23,86,81,0,167,51.497,51.497
6,0.970,Human UTI,23-5,109,95,0,204,53.431,53.431
6,0.970,unknown,16-23,0,3,0,3,0.000,0.000
6,0.970,unknown,23-5,2,6,0,8,25.000,25.000
6,0.970,SLO Creek Water,16-23,0,0,0,0,NaN,NaN
6,0.970,SLO Creek Water,23-5,0,0,0,0,NaN,NaN
6,0.970,Pig/Swine,16-23,14,12,0,26,53.846,53.846
6,0.970,Pig/Swine,23-5,13,9,0,22,59.091,59.091
6,0.970,Klebsiella,16-23,0,0,0,0,NaN,NaN
6,0.970,Klebsiella,23-5,0,0,0,0,NaN,NaN
6,0.970,Hu Cw and Dg,16-23,11,24,0,35,31.429,31.429
6,0.970,Hu Cw and Dg,23-5,18,27,0,45,40.000,40.000
6,0.970,Ground Squirrel,16-23,103,76,0,179,57.542,57.542
6,0.970,Ground Squirrel,23-5,90,103,0,193,46.632,46.632
6,0.970,Opossum,16-23,0,2,0,2,0.000,0.000
6,0.970,Opossum,23-5,0,8,0,8,0.000,0.000
6,0.970,Cow,16-23,1522,975,0,2497,60.953,60.953
6,0.970,Cow,23-5,1471,1231,0,2702,54.441,54.441
6,0.970,Deer Mouse,16-23,0,0,0,0,NaN,NaN
6,0.970,Deer Mouse,23-5,0,0,0,0,NaN,NaN
6,0.970,OVERALL,16-23,3851,2455,0,6306,61.069,61.069
6,0.970,OVERALL,23-5,4439,3117,0,7556,58.748,58.748
6,0.980,Chicken,16-23,4,15,0,19,21.053,21.053
6,0.980,Chicken,23-5,13,10,0,23,56.522,56.522
6,0.980,Sea Lion,16-23,0,1,0,1,0.000,0.000
6,0.980,Sea Lion,23-5,3,11,0,14,21.429,21.429
6,0.980,Hu and Cw,16-23,8,18,0,26,30.769,30.769
6,0.980,Hu and Cw,23-5,8,30,0,38,21.053,21.053
6,0.980,Sheep,16-23,56,51,0,107,52.336,52.336
6,0.980,Sheep,23-5,70,40,0,110,63.636,63.636
6,0.980,Hu and Dg,16-23,10,18,0,28,35.714,35.714
6,0.980,Hu and Dg,23-5,19,12,0,31,61.290,61.290
6,0.980,Common Loon,16-23,0,0,0,0,NaN,NaN
6,0.980,Common Loon,23-5,0,4,0,4,0.000,0.000
6,0.980,Red-Winged Blackbird,16-23,0,12,0,12,0.000,0.000
6,0.980,Red-Winged Blackbird,23-5,0,6,0,6,0.000,0.000
6,0.980,Cw,16-23,12,12,0,24,50.000,50.000
6,0.980,Cw,23-5,27,46,0,73,36.986,36.986
6,0.980,Cliff Sparrow,16-23,3,28,0,31,9.677,9.677
6,0.980,Cliff Sparrow,23-5,2,8,0,10,20.000,20.000
6,0.980,Pig,16-23,11,10,0,21,52.381,52.381
6,0.980,Pig,23-5,4,12,0,16,25.000,25.000
6,0.980,Barn Owl,16-23,0,0,0,0,NaN,NaN
6,0.980,Barn Owl,23-5,0,0,0,0,NaN,NaN
6,0.980,Wild Pig,16-23,5,3,0,8,62.500,62.500
6,0.980,Wild Pig,23-5,3,2,0,5,60.000,60.000
6,0.980,Pennington Creek Water,16-23,0,0,0,0,NaN,NaN
6,0.980,Pennington Creek Water,23-5,0,0,0,0,NaN,NaN
6,0.980,Guinni,16-23,0,0,0,0,NaN,NaN
6,0.980,Guinni,23-5,0,0,0,0,NaN,NaN
6,0.980,Racoon,16-23,0,3,0,3,0.000,0.000
6,0.980,Racoon,23-5,0,0,0,0,NaN,NaN
6,0.980,Hu,16-23,17,18,0,35,48.571,48.571
6,0.980,Hu,23-5,19,11,0,30,63.333,63.333
6,0.980,Cw and Dg,16-23,4,16,0,20,20.000,20.000
6,0.980,Cw and Dg,23-5,16,22,0,38,42.105,42.105
6,0.980,Red Wind Blackbird,16-23,0,0,0,0,NaN,NaN
6,0.980,Red Wind Blackbird,23-5,0,0,0,0,NaN,NaN
6,0.980,Tree Swallow,16-23,0,2,0,2,0.000,0.000
6,0.980,Tree Swallow,23-5,0,4,0,4,0.000,0.000
6,0.980,Turkey Vulture,16-23,0,0,0,0,NaN,NaN
6,0.980,Turkey Vulture,23-5,0,0,0,0,NaN,NaN
6,0.980,Dg,16-23,8,16,0,24,33.333,33.333
6,0.980,Dg,23-5,30,24,0,54,55.556,55.556
6,0.980,Western Kingbird,16-23,0,0,0,0,NaN,NaN
6,0.980,Western Kingbird,23-5,0,0,0,0,NaN,NaN
6,0.980,White Crowned Sparrow,16-23,1,6,0,7,14.286,14.286
6,0.980,White Crowned Sparrow,23-5,3,19,0,22,13.636,13.636
6,0.980,Eared Grebe,16-23,0,0,0,0,NaN,NaN
6,0.980,Eared Grebe,23-5,2,18,0,20,10.000,10.000
6,0.980,cougar,16-23,0,0,0,0,NaN,NaN
6,0.980,cougar,23-5,0,0,0,0,NaN,NaN
6,0.980,Ocean Water,16-23,0,0,0,0,NaN,NaN
6,0.980,Ocean Water,23-5,0,0,0,0,NaN,NaN
6,0.980,Red Tailed Hawk,16-23,0,4,0,4,0.000,0.000
6,0.980,Red Tailed Hawk,23-5,0,8,0,8,0.000,0.000
6,0.980,Dog,16-23,71,85,0,156,45.513,45.513
6,0.980,Dog,23-5,109,136,0,245,44.490,44.490
6,0.980,Human,16-23,1728,636,0,2364,73.096,73.096
6,0.980,Human,23-5,2162,513,0,2675,80.822,80.822
6,0.980,Wild Turkey,16-23,13,25,0,38,34.211,34.211
6,0.980,Wild Turkey,23-5,6,37,0,43,13.953,13.953
6,0.980,Clark Grebe,16-23,0,0,0,0,NaN,NaN
6,0.980,Clark Grebe,23-5,0,1,0,1,0.000,0.000
6,0.980,Seagull,16-23,0,0,0,0,NaN,NaN
6,0.980,Seagull,23-5,15,6,0,21,71.429,71.429
6,0.980,Surf Scoter,16-23,0,0,0,0,NaN,NaN
6,0.980,Surf Scoter,23-5,2,0,0,2,100.000,100.000
6,0.980,Pigeon,16-23,75,179,0,254,29.528,29.528
6,0.980,Pigeon,23-5,106,302,0,408,25.980,25.980
6,0.980,Pacific Ocean Water,16-23,0,0,0,0,NaN,NaN
6,0.980,Pacific Ocean Water,23-5,0,0,0,0,NaN,NaN
6,0.980,Cat,16-23,25,35,0,60,41.667,41.667
6,0.980,Cat,23-5,28,40,0,68,41.176,41.176
6,0.980,Horse,16-23,10,22,0,32,31.250,31.250
6,0.980,Horse,23-5,35,188,0,223,15.695,15.695
6,0.980,orangutan,16-23,0,0,0,0,NaN,NaN
6,0.980,orangutan,23-5,0,0,0,0,NaN,NaN
6,0.980,Bat,16-23,36,22,0,58,62.069,62.069
6,0.980,Bat,23-5,37,22,0,59,62.712,62.712
6,0.980,Deer,16-23,16,29,0,45,35.556,35.556
6,0.980,Deer,23-5,18,86,0,104,17.308,17.308
6,0.980,Great Horned Owl,16-23,0,0,0,0,NaN,NaN
6,0.980,Great Horned Owl,23-5,0,6,0,6,0.000,0.000
6,0.980,Freshwater Lagoon,16-23,0,0,0,0,NaN,NaN
6,0.980,Freshwater Lagoon,23-5,0,0,0,0,NaN,NaN
6,0.980,Unknown Avian,16-23,0,0,0,0,NaN,NaN
6,0.980,Unknown Avian,23-5,0,0,0,0,NaN,NaN
6,0.980,Human UTI,16-23,86,83,0,169,50.888,50.888
6,0.980,Human UTI,23-5,109,93,0,202,53.960,53.960
6,0.980,unknown,16-23,0,3,0,3,0.000,0.000
6,0.980,unknown,23-5,2,7,0,9,22.222,22.222
6,0.980,SLO Creek Water,16-23,0,0,0,0,NaN,NaN
6,0.980,SLO Creek Water,23-5,0,0,0,0,NaN,NaN
6,0.980,Pig/Swine,16-23,14,12,0,26,53.846,53.846
6,0.980,Pig/Swine,23-5,13,9,0,22,59.091,59.091
6,0.980,Klebsiella,16-23,0,0,0,0,NaN,NaN
6,0.980,Klebsiella,23-5,0,0,0,0,NaN,NaN
6,0.980,Hu Cw and Dg,16-23,11,24,0,35,31.429,31.429
6,0.980,Hu Cw and Dg,23-5,18,25,0,43,41.860,41.860
6,0.980,Ground Squirrel,16-23,103,78,0,181,56.906,56.906
6,0.980,Ground Squirrel,23-5,90,100,0,190,47.368,47.368
6,0.980,Opossum,16-23,0,2,0,2,0.000,0.000
6,0.980,Opossum,23-5,0,8,0,8,0.000,0.000
6,0.980,Cow,16-23,1516,965,0,2481,61.104,61.104
6,0.980,Cow,23-5,1467,1209,0,2676,54.821,54.821
6,0.980,Deer Mouse,16-23,0,0,0,0,NaN,NaN
6,0.980,Deer Mouse,23-5,0,0,0,0,NaN,NaN
6,0.980,OVERALL,16-23,3843,2433,0,6276,61.233,61.233
6,0.980,OVERALL,23-5,4436,3075,0,7511,59.060,59.060
6,0.990,Chicken,16-23,4,19,0,23,17.391,17.391
6,0.990,Chicken,23-5,14,10,0,24,58.333,58.333
6,0.990,Sea Lion,16-23,0,1,0,1,0.000,0.000
6,0.990,Sea Lion,23-5,4,7,0,11,36.364,36.364
6,0.990,Hu and Cw,16-23,9,18,0,27,33.333,33.333
6,0.990,Hu and Cw,23-5,9,30,0,39,23.077,23.077
6,0.990,Sheep,16-23,55,50,0,105,52.381,52.381
6,0.990,Sheep,23-5,70,39,0,109,64.220,64.220
6,0.990,Hu and Dg,16-23,10,18,0,28,35.714,35.714
6,0.990,Hu and Dg,23-5,19,11,0,30,63.333,63.333
6,0.990,Common Loon,16-23,0,0,0,0,NaN,NaN
6,0.990,Common Loon,23-5,0,5,0,5,0.000,0.000
6,0.990,Red-Winged Blackbird,16-23,0,11,0,11,0.000,0.000
6,0.990,Red-Winged Blackbird,23-5,0,6,0,6,0.000,0.000
6,0.990,Cw,16-23,12,12,0,24,50.000,50.000
6,0.990,Cw,23-5,27,45,0,72,37.500,37.500
6,0.990,Cliff Sparrow,16-23,3,28,0,31,9.677,9.677
6,0.990,Cliff Sparrow,23-5,2,11,0,13,15.385,15.385
6,0.990,Pig,16-23,11,11,0,22,50.000,50.000
6,0.990,Pig,23-5,8,13,0,21,38.095,38.095
6,0.990,Barn Owl,16-23,0,0,0,0,NaN,NaN
6,0.990,Barn Owl,23-5,0,0,0,0,NaN,NaN
6,0.990,Wild Pig,16-23,5,5,0,10,50.000,50.000
6,0.990,Wild Pig,23-5,3,1,0,4,75.000,75.000
6,0.990,Pennington Creek Water,16-23,0,0,0,0,NaN,NaN
6,0.990,Pennington Creek Water,23-5,0,0,0,0,NaN,NaN
6,0.990,Guinni,16-23,0,0,0,0,NaN,NaN
6,0.990,Guinni,23-5,0,0,0,0,NaN,NaN
6,0.990,Racoon,16-23,0,3,0,3,0.000,0.000
6,0.990,Racoon,23-5,0,1,0,1,0.000,0.000
6,0.990,Hu,16-23,17,17,0,34,50.000,50.000
6,0.990,Hu,23-5,19,8,0,27,70.370,70.370
6,0.990,Cw and Dg,16-23,4,16,0,20,20.000,20.000
6,0.990,Cw and Dg,23-5,15,14,0,29,51.724,51.724
6,0.990,Red Wind Blackbird,16-23,0,0,0,0,NaN,NaN
6,0.990,Red Wind Blackbird,23-5,0,0,0,0,NaN,NaN
6,0.990,Tree Swallow,16-23,0,2,0,2,0.000,0.000
6,0.990,Tree Swallow,23-5,0,4,0,4,0.000,0.000
6,0.990,Turkey Vulture,16-23,0,0,0,0,NaN,NaN
6,0.990,Turkey Vulture,23-5,0,0,0,0,NaN,NaN
6,0.990,Dg,16-23,8,16,0,24,33.333,33.333
6,0.990,Dg,23-5,30,20,0,50,60.000,60.000
6,0.990,Western Kingbird,16-23,0,0,0,0,NaN,NaN
6,0.990,Western Kingbird,23-5,0,0,0,0,NaN,NaN
6,0.990,White Crowned Sparrow,16-23,1,6,0,7,14.286,14.286
6,0.990,White Crowned Sparrow,23-5,3,19,0,22,13.636,13.636
6,0.990,Eared Grebe,16-23,0,0,0,0,NaN,NaN
6,0.990,Eared Grebe,23-5,2,15,0,17,11.765,11.765
6,0.990,cougar,16-23,0,1,0,1,0.000,0.000
6,0.990,cougar,23-5,0,0,0,0,NaN,NaN
6,0.990,Ocean Water,16-23,0,0,0,0,NaN,NaN
6,0.990,Ocean Water,23-5,0,0,0,0,NaN,NaN
6,0.990,Red Tailed Hawk,16-23,0,4,0,4,0.000,0.000
6,0.990,Red Tailed Hawk,23-5,0,9,0,9,0.000,0.000
6,0.990,Dog,16-23,73,81,0,154,47.403,47.403
6,0.990,Dog,23-5,111,124,0,235,47.234,47.234
6,0.990,Human,16-23,1709,610,0,2319,73.696,73.696
6,0.990,Human,23-5,2147,476,0,2623,81.853,81.853
6,0.990,Wild Turkey,16-23,14,28,0,42,33.333,33.333
6,0.990,Wild Turkey,23-5,6,35,0,41,14.634,14.634
6,0.990,Clark Grebe,16-23,0,0,0,0,NaN,NaN
6,0.990,Clark Grebe,23-5,2,3,0,5,40.000,40.000
6,0.990,Seagull,16-23,0,0,0,0,NaN,NaN
6,0.990,Seagull,23-5,18,6,0,24,75.000,75.000
6,0.990,Surf Scoter,16-23,0,0,0,0,NaN,NaN
6,0.990,Surf Scoter,23-5,2,0,0,2,100.000,100.000
6,0.990,Pigeon,16-23,76,172,0,248,30.645,30.645
6,0.990,Pigeon,23-5,110,286,0,396,27.778,27.778
6,0.990,Pacific Ocean Water,16-23,0,0,0,0,NaN,NaN
6,0.990,Pacific Ocean Water,23-5,0,0,0,0,NaN,NaN
6,0.990,Cat,16-23,24,32,0,56,42.857,42.857
6,0.990,Cat,23-5,28,41,0,69,40.580,40.580
6,0.990,Horse,16-23,12,22,0,34,35.294,35.294
6,0.990,Horse,23-5,34,188,0,222,15.315,15.315
6,0.990,orangutan,16-23,0,0,0,0,NaN,NaN
6,0.990,orangutan,23-5,0,0,0,0,NaN,NaN
6,0.990,Bat,16-23,36,21,0,57,63.158,63.158
6,0.990,Bat,23-5,37,22,0,59,62.712,62.712
6,0.990,Deer,16-23,16,30,0,46,34.783,34.783
6,0.990,Deer,23-5,18,85,0,103,17.476,17.476
6,0.990,Great Horned Owl,16-23,0,0,0,0,NaN,NaN
6,0.990,Great Horned Owl,23-5,0,6,0,6,0.000,0.000
6,0.990,Freshwater Lagoon,16-23,0,0,0,0,NaN,NaN
6,0.990,Freshwater Lagoon,23-5,0,0,0,0,NaN,NaN
6,0.990,Unknown Avian,16-23,0,0,0,0,NaN,NaN
6,0.990,Unknown Avian,23-5,0,0,0,0,NaN,NaN
6,0.990,Human UTI,16-23,90,79,0,169,53.254,53.254
6,0.990,Human UTI,23-5,110,82,0,192,57.292,57.292
6,0.990,unknown,16-23,0,3,0,3,0.000,0.000
6,0.990,unknown,23-5,2,8,0,10,20.000,20.000
6,0.990,SLO Creek Water,16-23,0,0,0,0,NaN,NaN
6,0.990,SLO Creek Water,23-5,0,0,0,0,NaN,NaN
6,0.990,Pig/Swine,16-23,13,13,0,26,50.000,50.000
6,0.990,Pig/Swine,23-5,13,10,0,23,56.522,56.522
6,0.990,Klebsiella,16-23,0,0,0,0,NaN,NaN
6,0.990,Klebsiella,23-5,0,0,0,0,NaN,NaN
6,0.990,Hu Cw and Dg,16-23,11,24,0,35,31.429,31.429
6,0.990,Hu Cw and Dg,23-5,18,27,0,45,40.000,40.000
6,0.990,Ground Squirrel,16-23,104,74,0,178,58.427,58.427
6,0.990,Ground Squirrel,23-5,91,99,0,190,47.895,47.895
6,0.990,Opossum,16-23,1,2,0,3,33.333,33.333
6,0.990,Opossum,23-5,2,8,0,10,20.000,20.000
6,0.990,Cow,16-23,1479,888,0,2367,62.484,62.484
6,0.990,Cow,23-5,1438,1119,0,2557,56.238,56.238
6,0.990,Deer Mouse,16-23,0,0,0,0,NaN,NaN
6,0.990,Deer Mouse,23-5,0,0,0,0,NaN,NaN
6,0.990,OVERALL,16-23,3797,2317,0,6114,62.103,62.103
6,0.990,OVERALL,23-5,4412,2893,0,7305,60.397,60.397
6,1.000,Chicken,16-23,0,0,0,0,NaN,NaN
6,1.000,Chicken,23-5,0,0,0,0,NaN,NaN
6,1.000,Sea Lion,16-23,0,0,0,0,NaN,NaN
6,1.000,Sea Lion,23-5,0,0,0,0,NaN,NaN
6,1.000,Hu and Cw,16-23,0,0,0,0,NaN,NaN
6,1.000,Hu and Cw,23-5,0,0,0,0,NaN,NaN
6,1.000,Sheep,16-23,0,0,0,0,NaN,NaN
6,1.000,Sheep,23-5,0,0,0,0,NaN,NaN
6,1.000,Hu and Dg,16-23,0,0,0,0,NaN,NaN
6,1.000,Hu and Dg,23-5,0,0,0,0,NaN,NaN
6,1.000,Common Loon,16-23,0,0,0,0,NaN,NaN
6,1.000,Common Loon,23-5,0,0,0,0,NaN,NaN
6,1.000,Red-Winged Blackbird,16-23,0,0,0,0,NaN,NaN
6,1.000,Red-Winged Blackbird,23-5,0,0,0,0,NaN,NaN
6,1.000,Cw,16-23,0,0,0,0,NaN,NaN
6,1.000,Cw,23-5,0,0,0,0,NaN,NaN
6,1.000,Cliff Sparrow,16-23,0,0,0,0,NaN,NaN
6,1.000,Cliff Sparrow,23-5,0,0,0,0,NaN,NaN
6,1.000,Pig,16-23,0,0,0,0,NaN,NaN
6,1.000,Pig,23-5,0,0,0,0,NaN,NaN
6,1.000,Barn Owl,16-23,0,0,0,0,NaN,NaN
6,1.000,Barn Owl,23-5,0,0,0,0,NaN,NaN
6,1.000,Wild Pig,16-23,0,0,0,0,NaN,NaN
6,1.000,Wild Pig,23-5,0,0,0,0,NaN,NaN
6,1.000,Pennington Creek Water,16-23,0,0,0,0,NaN,NaN
6,1.000,Pennington Creek Water,23-5,0,0,0,0,NaN,NaN
6,1.000,Guinni,16-23,0,0,0,0,NaN,NaN
6,1.000,Guinni,23-5,0,0,0,0,NaN,NaN
6,1.000,Racoon,16-23,0,0,0,0,NaN,NaN
6,1.000,Racoon,23-5,0,0,0,0,NaN,NaN
6,1.000,Hu,16-23,0,0,0,0,NaN,NaN
6,1.000,Hu,23-5,0,0,0,0,NaN,NaN
6,1.000,Cw and Dg,16-23,0,0,0,0,NaN,NaN
6,1.000,Cw and Dg,23-5,0,0,0,0,NaN,NaN
6,1.000,Red Wind Blackbird,16-23,0,0,0,0,NaN,NaN
6,1.000,Red Wind Blackbird,23-5,0,0,0,0,NaN,NaN
6,1.000,Tree Swallow,16-23,0,0,0,0,NaN,NaN
6,1.000,Tree Swallow,23-5,0,0,0,0,NaN,NaN
6,1.000,Turkey Vulture,16-23,0,0,0,0,NaN,NaN
6,1.000,Turkey Vulture,23-5,0,0,0,0,NaN,NaN
6,1.000,Dg,16-23,0,0,0,0,NaN,NaN
6,1.000,Dg,23-5,0,0,0,0,NaN,NaN
6,1.000,Western Kingbird,16-23,0,0,0,0,NaN,NaN
6,1.000,Western Kingbird,23-5,0,0,0,0,NaN,NaN
6,1.000,White Crowned Sparrow,16-23,0,0,0,0,NaN,NaN
6,1.000,White Crowned Sparrow,23-5,0,0,0,0,NaN,NaN
6,1.000,Eared Grebe,16-23,0,0,0,0,NaN,NaN
6,1.000,Eared Grebe,23-5,0,0,0,0,NaN,NaN
6,1.000,cougar,16-23,0,0,0,0,NaN,NaN
6,1.000,cougar,23-5,0,0,0,0,NaN,NaN
6,1.000,Ocean Water,16-23,0,0,0,0,NaN,NaN
6,1.000,Ocean Water,23-5,0,0,0,0,NaN,NaN
6,1.000,Red Tailed Hawk,16-23,0,0,0,0,NaN,NaN
6,1.000,Red Tailed Hawk,23-5,0,0,0,0,NaN,NaN
6,1.000,Dog,16-23,0,0,0,0,NaN,NaN
6,1.000,Dog,23-5,0,0,0,0,NaN,NaN
6,1.000,Human,16-23,0,0,0,0,NaN,NaN
6,1.000,Human,23-5,0,0,0,0,NaN,NaN
6,1.000,Wild Turkey,16-23,0,0,0,0,NaN,NaN
6,1.000,Wild Turkey,23-5,0,0,0,0,NaN,NaN
6,1.000,Clark Grebe,16-23,0,0,0,0,NaN,NaN
6,1.000,Clark Grebe,23-5,0,0,0,0,NaN,NaN
6,1.000,Seagull,16-23,0,0,0,0,NaN,NaN
6,1.000,Seagull,23-5,0,0,0,0,NaN,NaN
6,1.000,Surf Scoter,16-23,0,0,0,0,NaN,NaN
6,1.000,Surf Scoter,23-5,0,0,0,0,NaN,NaN
6,1.000,Pigeon,16-23,0,0,0,0,NaN,NaN
6,1.000,Pigeon,23-5,0,0,0,0,NaN,NaN
6,1.000,Pacific Ocean Water,16-23,0,0,0,0,NaN,NaN
6,1.000,Pacific Ocean Water,23-5,0,0,0,0,NaN,NaN
6,1.000,Cat,16-23,0,0,0,0,NaN,NaN
6,1.000,Cat,23-5,0,0,0,0,NaN,NaN
6,1.000,Horse,16-23,0,0,0,0,NaN,NaN
6,1.000,Horse,23-5,0,0,0,0,NaN,NaN
6,1.000,orangutan,16-23,0,0,0,0,NaN,NaN
6,1.000,orangutan,23-5,0,0,0,0,NaN,NaN
6,1.000,Bat,16-23,0,0,0,0,NaN,NaN
6,1.000,Bat,23-5,0,0,0,0,NaN,NaN
6,1.000,Deer,16-23,0,0,0,0,NaN,NaN
6,1.000,Deer,23-5,0,0,0,0,NaN,NaN
6,1.000,Great Horned Owl,16-23,0,0,0,0,NaN,NaN
6,1.000,Great Horned Owl,23-5,0,0,0,0,NaN,NaN
6,1.000,Freshwater Lagoon,16-23,0,0,0,0,NaN,NaN
6,1.000,Freshwater Lagoon,23-5,0,0,0,0,NaN,NaN
6,1.000,Unknown Avian,16-23,0,0,0,0,NaN,NaN
6,1.000,Unknown Avian,23-5,0,0,0,0,NaN,NaN
6,1.000,Human UTI,16-23,0,0,0,0,NaN,NaN
6,1.000,Human UTI,23-5,0,0,0,0,NaN,NaN
6,1.000,unknown,16-23,0,0,0,0,NaN,NaN
6,1.000,unknown,23-5,0,0,0,0,NaN,NaN
6,1.000,SLO Creek Water,16-23,0,0,0,0,NaN,NaN
6,1.000,SLO Creek Water,23-5,0,0,0,0,NaN,NaN
6,1.000,Pig/Swine,16-23,0,0,0,0,NaN,NaN
6,1.000,Pig/Swine,23-5,0,0,0,0,NaN,NaN
6,1.000,Klebsiella,16-23,0,0,0,0,NaN,NaN
6,1.000,Klebsiella,23-5,0,0,0,0,NaN,NaN
6,1.000,Hu Cw and Dg,16-23,0,0,0,0,NaN,NaN
6,1.000,Hu Cw and Dg,23-5,0,0,0,0,NaN,NaN
6,1.000,Ground Squirrel,16-23,0,0,0,0,NaN,NaN
6,1.000,Ground Squirrel,23-5,0,0,0,0,NaN,NaN
6,1.000,Opossum,16-23,0,0,0,0,NaN,NaN
6,1.000,Opossum,23-5,0,0,0,0,NaN,NaN
6,1.000,Cow,16-23,0,0,0,0,NaN,NaN
6,1.000,Cow,23-5,0,0,0,0,NaN,NaN
6,1.000,Deer Mouse,16-23,0,0,0,0,NaN,NaN
6,1.000,Deer Mouse,23-5,0,0,0,0,NaN,NaN
6,1.000,OVERALL,16-23,0,0,0,0,NaN,NaN
6,1.000,OVERALL,23-5,0,0,0,0,NaN,NaN
7,0.000,Chicken,16-23,3,15,0,18,16.667,16.667
7,0.000,Chicken,23-5,13,9,0,22,59.091,59.091
7,0.000,Sea Lion,16-23,0,1,0,1,0.000,0.000
7,0.000,Sea Lion,23-5,3,12,0,15,20.000,20.000
7,0.000,Hu and Cw,16-23,9,13,0,22,40.909,40.909
7,0.000,Hu and Cw,23-5,4,22,0,26,15.385,15.385
7,0.000,Sheep,16-23,54,53,0,107,50.467,50.467
7,0.000,Sheep,23-5,63,40,0,103,61.165,61.165
7,0.000,Hu and Dg,16-23,10,15,0,25,40.000,40.000
7,0.000,Hu and Dg,23-5,19,17,0,36,52.778,52.778
7,0.000,Common Loon,16-23,0,0,0,0,NaN,NaN
7,0.000,Common Loon,23-5,0,4,0,4,0.000,0.000
7,0.000,Red-Winged Blackbird,16-23,0,10,0,10,0.000,0.000
7,0.000,Red-Winged Blackbird,23-5,0,1,0,1,0.000,0.000
7,0.000,Cw,16-23,11,10,0,21,52.381,52.381
7,0.000,Cw,23-5,22,43,0,65,33.846,33.846
7,0.000,Cliff Sparrow,16-23,3,25,0,28,10.714,10.714
7,0.000,Cliff Sparrow,23-5,2,8,0,10,20.000,20.000
7,0.000,Pig,16-23,10,11,0,21,47.619,47.619
7,0.000,Pig,23-5,5,11,0,16,31.250,31.250
7,0.000,Barn Owl,16-23,0,0,0,0,NaN,NaN
7,0.000,Barn Owl,23-5,0,0,0,0,NaN,NaN
7,0.000,Wild Pig,16-23,1,1,0,2,50.000,50.000
7,0.000,Wild Pig,23-5,3,3,0,6,50.000,50.000
7,0.000,Pennington Creek Water,16-23,0,0,0,0,NaN,NaN
7,0.000,Pennington Creek Water,23-5,0,0,0,0,NaN,NaN
7,0.000,Guinni,16-23,0,0,0,0,NaN,NaN
7,0.000,Guinni,23-5,0,0,0,0,NaN,NaN
7,0.000,Racoon,16-23,0,0,0,0,NaN,NaN
7,0.000,Racoon,23-5,0,0,0,0,NaN,NaN
7,0.000,Hu,16-23,16,17,0,33,48.485,48.485
7,0.000,Hu,23-5,21,11,0,32,65.625,65.625
7,0.000,Cw and Dg,16-23,4,14,0,18,22.222,22.222
7,0.000,Cw and Dg,23-5,18,21,0,39,46.154,46.154
7,0.000,Red Wind Blackbird,16-23,0,0,0,0,NaN,NaN
7,0.000,Red Wind Blackbird,23-5,0,0,0,0,NaN,NaN
7,0.000,Tree Swallow,16-23,0,1,0,1,0.000,0.000
7,0.000,Tree Swallow,23-5,0,4,0,4,0.000,0.000
7,0.000,Turkey Vulture,16-23,0,0,0,0,NaN,NaN
7,0.000,Turkey Vulture,23-5,0,0,0,0,NaN,NaN
7,0.000,Dg,16-23,8,12,0,20,40.000,40.000
7,0.000,Dg,23-5,31,31,0,62,50.000,50.000
7,0.000,Western Kingbird,16-23,0,0,0,0,NaN,NaN
7,0.000,Western Kingbird,23-5,0,0,0,0,NaN,NaN
7,0.000,White Crowned Sparrow,16-23,0,6,0,6,0.000,0.000
7,0.000,White Crowned Sparrow,23-5,3,22,0,25,12.000,12.000
7,0.000,Eared Grebe,16-23,0,0,0,0,NaN,NaN
7,0.000,Eared Grebe,23-5,0,16,0,16,0.000,0.000
7,0.000,cougar,16-23,0,0,0,0,NaN,NaN
7,0.000,cougar,23-5,0,0,0,0,NaN,NaN
7,0.000,Ocean Water,16-23,0,0,0,0,NaN,NaN
7,0.000,Ocean Water,23-5,0,0,0,0,NaN,NaN
7,0.000,Red Tailed Hawk,16-23,0,2,0,2,0.000,0.000
7,0.000,Red Tailed Hawk,23-5,0,5,0,5,0.000,0.000
7,0.000,Dog,16-23,66,75,0,141,46.809,46.809
7,0.000,Dog,23-5,105,149,0,254,41.339,41.339
7,0.000,Human,16-23,1727,672,0,2399,71.988,71.988
7,0.000,Human,23-5,2159,566,0,2725,79.229,79.229
7,0.000,Wild Turkey,16-23,10,19,0,29,34.483,34.483
7,0.000,Wild Turkey,23-5,1,30,0,31,3.226,3.226
7,0.000,Clark Grebe,16-23,0,0,0,0,NaN,NaN
7,0.000,Clark Grebe,23-5,0,0,0,0,NaN,NaN
7,0.000,Seagull,16-23,0,0,0,0,NaN,NaN
7,0.000,Seagull,23-5,8,6,0,14,57.143,57.143
7,0.000,Surf Scoter,16-23,0,0,0,0,NaN,NaN
7,0.000,Surf Scoter,23-5,0,1,0,1,0.000,0.000
7,0.000,Pigeon,16-23,66,169,0,235,28.085,28.085
7,0.000,Pigeon,23-5,94,225,0,319,29.467,29.467
7,0.000,Pacific Ocean Water,16-23,0,0,0,0,NaN,NaN
7,0.000,Pacific Ocean Water,23-5,0,0,0,0,NaN,NaN
7,0.000,Cat,16-23,26,36,0,62,41.935,41.935
7,0.000,Cat,23-5,26,36,0,62,41.935,41.935
7,0.000,Horse,16-23,8,26,0,34,23.529,23.529
7,0.000,Horse,23-5,34,173,0,207,16.425,16.425
7,0.000,orangutan,16-23,0,0,0,0,NaN,NaN
7,0.000,orangutan,23-5,0,0,0,0,NaN,NaN
7,0.000,Bat,16-23,36,21,0,57,63.158,63.158
7,0.000,Bat,23-5,37,29,0,66,56.061,56.061
7,0.000,Deer,16-23,16,31,0,47,34.043,34.043
7,0.000,Deer,23-5,18,92,0,110,16.364,16.364
7,0.000,Great Horned Owl,16-23,0,0,0,0,NaN,NaN
7,0.000,Great Horned Owl,23-5,0,6,0,6,0.000,0.000
7,0.000,Freshwater Lagoon,16-23,0,0,0,0,NaN,NaN
7,0.000,Freshwater Lagoon,23-5,0,0,0,0,NaN,NaN
7,0.000,Unknown Avian,16-23,0,0,0,0,NaN,NaN
7,0.000,Unknown Avian,23-5,0,0,0,0,NaN,NaN
7,0.000,Human UTI,16-23,80,79,0,159,50.314,50.314
7,0.000,Human UTI,23-5,109,94,0,203,53.695,53.695
7,0.000,unknown,16-23,0,1,0,1,0.000,0.000
7,0.000,unknown,23-5,3,3,0,6,50.000,50.000
7,0.000,SLO Creek Water,16-23,0,0,0,0,NaN,NaN
7,0.000,SLO Creek Water,23-5,0,0,0,0,NaN,NaN
7,0.000,Pig/Swine,16-23,9,10,0,19,47.368,47.368
7,0.000,Pig/Swine,23-5,12,9,0,21,57.143,57.143
7,0.000,Klebsiella,16-23,0,0,0,0,NaN,NaN
7,0.000,Klebsiella,23-5,0,0,0,0,NaN,NaN
7,0.000,Hu Cw and Dg,16-23,11,23,0,34,32.353,32.353
7,0.000,Hu Cw and Dg,23-5,15,22,0,37,40.541,40.541
7,0.000,Ground Squirrel,16-23,97,72,0,169,57.396,57.396
7,0.000,Ground Squirrel,23-5,89,84,0,173,51.445,51.445
7,0.000,Opossum,16-23,0,2,0,2,0.000,0.000
7,0.000,Opossum,23-5,0,4,0,4,0.000,0.000
7,0.000,Cow,16-23,1561,1064,0,2625,59.467,59.467
7,0.000,Cow,23-5,1509,1375,0,2884,52.323,52.323
7,0.000,Deer Mouse,16-23,0,0,0,0,NaN,NaN
7,0.000,Deer Mouse,23-5,0,0,0,0,NaN,NaN
7,0.000,OVERALL,16-23,3842,2506,0,6348,60.523,60.523
7,0.000,OVERALL,23-5,4426,3184,0,7610,58.160,58.160
7,0.500,Chicken,16-23,3,15,0,18,16.667,16.667
7,0.500,Chicken,23-5,13,9,0,22,59.091,59.091
7,0.500,Sea Lion,16-23,0,1,0,1,0.000,0.000
7,0.500,Sea Lion,23-5,3,12,0,15,20.000,20.000
7,0.500,Hu and Cw,16-23,9,13,0,22,40.909,40.909
7,0.500,Hu and Cw,23-5,4,22,0,26,15.385,15.385
7,0.500,Sheep,16-23,54,53,0,107,50.467,50.467
7,0.500,Sheep,23-5,63,40,0,103,61.165,61.165
7,0.500,Hu and Dg,16-23,10,15,0,25,40.000,40.000
7,0.500,Hu and Dg,23-5,19,17,0,36,52.778,52.778
7,0.500,Common Loon,16-23,0,0,0,0,NaN,NaN
7,0.500,Common Loon,23-5,0,4,0,4,0.000,0.000
7,0.500,Red-Winged Blackbird,16-23,0,10,0,10,0.000,0.000
7,0.500,Red-Winged Blackbird,23-5,0,1,0,1,0.000,0.000
7,0.500,Cw,16-23,11,10,0,21,52.381,52.381
7,0.500,Cw,23-5,22,43,0,65,33.846,33.846
7,0.500,Cliff Sparrow,16-23,3,25,0,28,10.714,10.714
7,0.500,Cliff Sparrow,23-5,2,8,0,10,20.000,20.000
7,0.500,Pig,16-23,10,11,0,21,47.619,47.619
7,0.500,Pig,23-5,5,11,0,16,31.250,31.250
7,0.500,Barn Owl,16-23,0,0,0,0,NaN,NaN
7,0.500,Barn Owl,23-5,0,0,0,0,NaN,NaN
7,0.500,Wild Pig,16-23,1,1,0,2,50.000,50.000
7,0.500,Wild Pig,23-5,3,3,0,6,50.000,50.000
7,0.500,Pennington Creek Water,16-23,0,0,0,0,NaN,NaN
7,0.500,Pennington Creek Water,23-5,0,0,0,0,NaN,NaN
7,0.500,Guinni,16-23,0,0,0,0,NaN,NaN
7,0.500,Guinni,23-5,0,0,0,0,NaN,NaN
7,0.500,Racoon,16-23,0,0,0,0,NaN,NaN
7,0.500,Racoon,23-5,0,0,0,0,NaN,NaN
7,0.500,Hu,16-23,16,17,0,33,48.485,48.485
7,0.500,Hu,23-5,21,11,0,32,65.625,65.625
7,0.500,Cw and Dg,16-23,4,14,0,18,22.222,22.222
7,0.500,Cw and Dg,23-5,18,21,0,39,46.154,46.154
7,0.500,Red Wind Blackbird,16-23,0,0,0,0,NaN,NaN
7,0.500,Red Wind Blackbird,23-5,0,0,0,0,NaN,NaN
7,0.500,Tree Swallow,16-23,0,1,0,1,0.000,0.000
7,0.500,Tree Swallow,23-5,0,4,0,4,0.000,0.000
7,0.500,Turkey Vulture,16-23,0,0,0,0,NaN,NaN
7,0.500,Turkey Vulture,23-5,0,0,0,0,NaN,NaN
7,0.500,Dg,16-23,8,12,0,20,40.000,40.000
7,0.500,Dg,23-5,31,31,0,62,50.000,50.000
7,0.500,Western Kingbird,16-23,0,0,0,0,NaN,NaN
7,0.500,Western Kingbird,23-5,0,0,0,0,NaN,NaN
7,0.500,White Crowned Sparrow,16-23,0,6,0,6,0.000,0.000
7,0.500,White Crowned Sparrow,23-5,3,22,0,25,12.000,12.000
7,0.500,Eared Grebe,16-23,0,0,0,0,NaN,NaN
7,0.500,Eared Grebe,23-5,0,16,0,16,0.000,0.000
7,0.500,cougar,16-23,0,0,0,0,NaN,NaN
7,0.500,cougar,23-5,0,0,0,0,NaN,NaN
7,0.500,Ocean Water,16-23,0,0,0,0,NaN,NaN
7,0.500,Ocean Water,23-5,0,0,0,0,NaN,NaN
7,0.500,Red Tailed Hawk,16-23,0,2,0,2,0.000,0.000
7,0.500,Red Tailed Hawk,23-5,0,5,0,5,0.000,0.000
7,0.500,Dog,16-23,66,75,0,141,46.809,46.809
7,0.500,Dog,23-5,105,149,0,254,41.339,41.339
7,0.500,Human,16-23,1727,672,0,2399,71.988,71.988
7,0.500,Human,23-5,2159,566,0,2725,79.229,79.229
7,0.500,Wild Turkey,16-23,10,19,0,29,34.483,34.483
7,0.500,Wild Turkey,23-5,1,30,0,31,3.226,3.226
7,0.500,Clark Grebe,16-23,0,0,0,0,NaN,NaN
7,0.500,Clark Grebe,23-5,0,0,0,0,NaN,NaN
7,0.500,Seagull,16-23,0,0,0,0,NaN,NaN
7,0.500,Seagull,23-5,8,6,0,14,57.143,57.143
7,0.500,Surf Scoter,16-23,0,0,0,0,NaN,NaN
7,0.500,Surf Scoter,23-5,0,1,0,1,0.000,0.000
7,0.500,Pigeon,16-23,66,169,0,235,28.085,28.085
7,0.500,Pigeon,23-5,94,225,0,319,29.467,29.467
7,0.500,Pacific Ocean Water,16-23,0,0,0,0,NaN,NaN
7,0.500,Pacific Ocean Water,23-5,0,0,0,0,NaN,NaN
7,0.500,Cat,16-23,26,36,0,62,41.935,41.935
7,0.500,Cat,23-5,26,36,0,62,41.935,41.935
7,0.500,Horse,16-23,8,26,0,34,23.529,23.529
7,0.500,Horse,23-5,34,173,0,207,16.425,16.425
7,0.500,orangutan,16-23,0,0,0,0,NaN,NaN
7,0.500,orangutan,23-5,0,0,0,0,NaN,NaN
7,0.500,Bat,16-23,36,21,0,57,63.158,63.158
7,0.500,Bat,23-5,37,29,0,66,56.061,56.061
7,0.500,Deer,16-23,16,31,0,47,34.043,34.043
7,0.500,Deer,23-5,18,92,0,110,16.364,16.364
7,0.500,Great Horned Owl,16-23,0,0,0,0,NaN,NaN
7,0.500,Great Horned Owl,23-5,0,6,0,6,0.000,0.000
7,0.500,Freshwater Lagoon,16-23,0,0,0,0,NaN,NaN
7,0.500,Freshwater Lagoon,23-5,0,0,0,0,NaN,NaN
7,0.500,Unknown Avian,16-23,0,0,0,0,NaN,NaN
7,0.500,Unknown Avian,23-5,0,0,0,0,NaN,NaN
7,0.500,Human UTI,16-23,80,79,0,159,50.314,50.314
7,0.500,Human UTI,23-5,109,94,0,203,53.695,53.695
7,0.500,unknown,16-23,0,1,0,1,0.000,0.000
7,0.500,unknown,23-5,3,3,0,6,50.000,50.000
7,0.500,SLO Creek Water,16-23,0,0,0,0,NaN,NaN
7,0.500,SLO Creek Water,23-5,0,0,0,0,NaN,NaN
7,0.500,Pig/Swine,16-23,9,10,0,19,47.368,47.368
7,0.500,Pig/Swine,23-5,12,9,0,21,57.143,57.143
7,0.500,Klebsiella,16-23,0,0,0,0,NaN,NaN
7,0.500,Klebsiella,23-5,0,0,0,0,NaN,NaN
7,0.500,Hu Cw and Dg,16-23,11,23,0,34,32.353,32.353
7,0.500,Hu Cw and Dg,23-5,15,22,0,37,40.541,40.541
7,0.500,Ground Squirrel,16-23,97,72,0,169,57.396,57.396
7,0.500,Ground Squirrel,23-5,89,84,0,173,51.445,51.445
7,0.500,Opossum,16-23,0,2,0,2,0.000,0.000
7,0.500,Opossum,23-5,0,4,0,4,0.000,0.000
7,0.500,Cow,16-23,1561,1064,0,2625,59.467,59.467
7,0.500,Cow,23-5,1509,1375,0,2884,52.323,52.323
7,0.500,Deer Mouse,16-23,0,0,0,0,NaN,NaN
7,0.500,Deer Mouse,23-5,0,0,0,0,NaN,NaN
7,0.500,OVERALL,16-23,3842,2506,0,6348,60.523,60.523
7,0.500,OVERALL,23-5,4426,3184,0,7610,58.160,58.160
7,0.900,Chicken,16-23,3,15,0,18,16.667,16.667
7,0.900,Chicken,23-5,13,9,0,22,59.091,59.091
7,0.900,Sea Lion,16-23,0,1,0,1,0.000,0.000
7,0.900,Sea Lion,23-5,3,12,0,15,20.000,20.000
7,0.900,Hu and Cw,16-23,9,13,0,22,40.909,40.909
7,0.900,Hu and Cw,23-5,4,22,0,26,15.385,15.385
7,0.900,Sheep,16-23,54,53,0,107,50.467,50.467
7,0.900,Sheep,23-5,63,40,0,103,61.165,61.165
7,0.900,Hu and Dg,16-23,10,15,0,25,40.000,40.000
7,0.900,Hu and Dg,23-5,19,17,0,36,52.778,52.778
7,0.900,Common Loon,16-23,0,0,0,0,NaN,NaN
7,0.900,Common Loon,23-5,0,4,0,4,0.000,0.000
7,0.900,Red-Winged Blackbird,16-23,0,10,0,10,0.000,0.000
7,0.900,Red-Winged Blackbird,23-5,0,1,0,1,0.000,0.000
7,0.900,Cw,16-23,11,10,0,21,52.381,52.381
7,0.900,Cw,23-5,22,43,0,65,33.846,33.846
7,0.900,Cliff Sparrow,16-23,3,25,0,28,10.714,10.714
7,0.900,Cliff Sparrow,23-5,2,8,0,10,20.000,20.000
7,0.900,Pig,16-23,10,11,0,21,47.619,47.619
7,0.900,Pig,23-5,5,11,0,16,31.250,31.250
7,0.900,Barn Owl,16-23,0,0,0,0,NaN,NaN
7,0.900,Barn Owl,23-5,0,0,0,0,NaN,NaN
7,0.900,Wild Pig,16-23,1,1,0,2,50.000,50.000
7,0.900,Wild Pig,23-5,3,3,0,6,50.000,50.000
7,0.900,Pennington Creek Water,16-23,0,0,0,0,NaN,NaN
7,0.900,Pennington Creek Water,23-5,0,0,0,0,NaN,NaN
7,0.900,Guinni,16-23,0,0,0,0,NaN,NaN
7,0.900,Guinni,23-5,0,0,0,0,NaN,NaN
7,0.900,Racoon,16-23,0,0,0,0,NaN,NaN
7,0.900,Racoon,23-5,0,0,0,0,NaN,NaN
7,0.900,Hu,16-23,16,17,0,33,48.485,48.485
7,0.900,Hu,23-5,21,11,0,32,65.625,65.625
7,0.900,Cw and Dg,16-23,4,14,0,18,22.222,22.222
7,0.900,Cw and Dg,23-5,18,21,0,39,46.154,46.154
7,0.900,Red Wind Blackbird,16-23,0,0,0,0,NaN,NaN
7,0.900,Red Wind Blackbird,23-5,0,0,0,0,NaN,NaN
7,0.900,Tree Swallow,16-23,0,1,0,1,0.000,0.000
7,0.900,Tree Swallow,23-5,0,4,0,4,0.000,0.000
7,0.900,Turkey Vulture,16-23,0,0,0,0,NaN,NaN
7,0.900,Turkey Vulture,23-5,0,0,0,0,NaN,NaN
7,0.900,Dg,16-23,8,12,0,20,40.000,40.000
7,0.900,Dg,23-5,31,31,0,62,50.000,50.000
7,0.900,Western Kingbird,16-23,0,0,0,0,NaN,NaN
7,0.900,Western Kingbird,23-5,0,0,0,0,NaN,NaN
7,0.900,White Crowned Sparrow,16-23,0,6,0,6,0.000,0.000
7,0.900,White Crowned Sparrow,23-5,3,22,0,25,12.000,12.000
7,0.900,Eared Grebe,16-23,0,0,0,0,NaN,NaN
7,0.900,Eared Grebe,23-5,0,16,0,16,0.000,0.000
7,0.900,cougar,16-23,0,0,0,0,NaN,NaN
7,0.900,cougar,23-5,0,0,0,0,NaN,NaN
7,0.900,Ocean Water,16-23,0,0,0,0,NaN,NaN
7,0.900,Ocean Water,23-5,0,0,0,0,NaN,NaN
7,0.900,Red Tailed Hawk,16-23,0,2,0,2,0.000,0.000
7,0.900,Red Tailed Hawk,23-5,0,5,0,5,0.000,0.000
7,0.900,Dog,16-23,66,75,0,141,46.809,46.809
7,0.900,Dog,23-5,105,146,0,251,41.833,41.833
7,0.900,Human,16-23,1727,671,0,2398,72.018,72.018
7,0.900,Human,23-5,2159,561,0,2720,79.375,79.375
7,0.900,Wild Turkey,16-23,10,19,0,29,34.483,34.483
7,0.900,Wild Turkey,23-5,1,30,0,31,3.226,3.226
7,0.900,Clark Grebe,16-23,0,0,0,0,NaN,NaN
7,0.900,Clark Grebe,23-5,0,0,0,0,NaN,NaN
7,0.900,Seagull,16-23,0,0,0,0,NaN,NaN
7,0.900,Seagull,23-5,8,7,0,15,53.333,53.333
7,0.900,Surf Scoter,16-23,0,0,0,0,NaN,NaN
7,0.900,Surf Scoter,23-5,0,1,0,1,0.000,0.000
7,0.900,Pigeon,16-23,66,169,0,235,28.085,28.085
7,0.900,Pigeon,23-5,94,225,0,319,29.467,29.467
7,0.900,Pacific Ocean Water,16-23,0,0,0,0,NaN,NaN
7,0.900,Pacific Ocean Water,23-5,0,0,0,0,NaN,NaN
7,0.900,Cat,16-23,26,36,0,62,41.935,41.935
7,0.900,Cat,23-5,26,36,0,62,41.935,41.935
7,0.900,Horse,16-23,8,26,0,34,23.529,23.529
7,0.900,Horse,23-5,34,173,0,207,16.425,16.425
7,0.900,orangutan,16-23,0,0,0,0,NaN,NaN
7,0.900,orangutan,23-5,0,0,0,0,NaN,NaN
7,0.900,Bat,16-23,36,21,0,57,63.158,63.158
7,0.900,Bat,23-5,37,29,0,66,56.061,56.061
7,0.900,Deer,16-23,16,31,0,47,34.043,34.043
7,0.900,Deer,23-5,18,92,0,110,16.364,16.364
7,0.900,Great Horned Owl,16-23,0,0,0,0,NaN,NaN
7,0.900,Great Horned Owl,23-5,0,6,0,6,0.000,0.000
7,0.900,Freshwater Lagoon,16-23,0,0,0,0,NaN,NaN
7,0.900,Freshwater Lagoon,23-5,0,0,0,0,NaN,NaN
7,0.900,Unknown Avian,16-23,0,0,0,0,NaN,NaN
7,0.900,Unknown Avian,23-5,0,0,0,0,NaN,NaN
7,0.900,Human UTI,16-23,80,79,0,159,50.314,50.314
7,0.900,Human UTI,23-5,110,94,0,204,53.922,53.922
7,0.900,unknown,16-23,0,1,0,1,0.000,0.000
7,0.900,unknown,23-5,3,3,0,6,50.000,50.000
7,0.900,SLO Creek Water,16-23,0,0,0,0,NaN,NaN
7,0.900,SLO Creek Water,23-5,0,0,0,0,NaN,NaN
7,0.900,Pig/Swine,16-23,9,10,0,19,47.368,47.368
7,0.900,Pig/Swine,23-5,12,9,0,21,57.143,57.143
7,0.900,Klebsiella,16-23,0,0,0,0,NaN,NaN
7,0.900,Klebsiella,23-5,0,0,0,0,NaN,NaN
7,0.900,Hu Cw and Dg,16-23,11,23,0,34,32.353,32.353
7,0.900,Hu Cw and Dg,23-5,15,22,0,37,40.541,40.541
7,0.900,Ground Squirrel,16-23,97,72,0,169,57.396,57.396
7,0.900,Ground Squirrel,23-5,89,84,0,173,51.445,51.445
7,0.900,Opossum,16-23,0,2,0,2,0.000,0.000
7,0.900,Opossum,23-5,0,4,0,4,0.000,0.000
7,0.900,Cow,16-23,1561,1061,0,2622,59.535,59.535
7,0.900,Cow,23-5,1509,1373,0,2882,52.359,52.359
7,0.900,Deer Mouse,16-23,0,0,0,0,NaN,NaN
7,0.900,Deer Mouse,23-5,0,0,0,0,NaN,NaN
7,0.900,OVERALL,16-23,3842,2502,0,6344,60.561,60.561
7,0.900,OVERALL,23-5,4427,3175,0,7602,58.235,58.235
7,0.950,Chicken,16-23,3,15,0,18,16.667,16.667
7,0.950,Chicken,23-5,13,9,0,22,59.091,59.091
7,0.950,Sea Lion,16-23,0,1,0,1,0.000,0.000
7,0.950,Sea Lion,23-5,3,12,0,15,20.000,20.000
7,0.950,Hu and Cw,16-23,9,13,0,22,40.909,40.909
7,0.950,Hu and Cw,23-5,4,22,0,26,15.385,15.385
7,0.950,Sheep,16-23,54,53,0,107,50.467,50.467
7,0.950,Sheep,23-5,63,40,0,103,61.165,61.165
7,0.950,Hu and Dg,16-23,10,15,0,25,40.000,40.000
7,0.950,Hu and Dg,23-5,19,17,0,36,52.778,52.778
7,0.950,Common Loon,16-23,0,0,0,0,NaN,NaN
7,0.950,Common Loon,23-5,0,4,0,4,0.000,0.000
7,0.950,Red-Winged Blackbird,16-23,0,10,0,10,0.000,0.000
7,0.950,Red-Winged Blackbird,23-5,0,1,0,1,0.000,0.000
7,0.950,Cw,16-23,11,10,0,21,52.381,52.381
7,0.950,Cw,23-5,22,43,0,65,33.846,33.846
7,0.950,Cliff Sparrow,16-23,3,25,0,28,10.714,10.714
7,0.950,Cliff Sparrow,23-5,2,8,0,10,20.000,20.000
7,0.950,Pig,16-23,10,11,0,21,47.619,47.619
7,0.950,Pig,23-5,5,11,0,16,31.250,31.250
7,0.950,Barn Owl,16-23,0,0,0,0,NaN,NaN
7,0.950,Barn Owl,23-5,0,0,0,0,NaN,NaN
7,0.950,Wild Pig,16-23,1,1,0,2,50.000,50.000
7,0.950,Wild Pig,23-5,3,2,0,5,60.000,60.000
7,0.950,Pennington Creek Water,16-23,0,0,0,0,NaN,NaN
7,0.950,Pennington Creek Water,23-5,0,0,0,0,NaN,NaN
7,0.950,Guinni,16-23,0,0,0,0,NaN,NaN
7,0.950,Guinni,23-5,0,0,0,0,NaN,NaN
7,0.950,Racoon,16-23,0,0,0,0,NaN,NaN
7,0.950,Racoon,23-5,0,0,0,0,NaN,NaN
7,0.950,Hu,16-23,16,17,0,33,48.485,48.485
7,0.950,Hu,23-5,21,11,0,32,65.625,65.625
7,0.950,Cw and Dg,16-23,4,14,0,18,22.222,22.222
7,0.950,Cw and Dg,23-5,18,21,0,39,46.154,46.154
7,0.950,Red Wind Blackbird,16-23,0,0,0,0,NaN,NaN
7,0.950,Red Wind Blackbird,23-5,0,0,0,0,NaN,NaN
7,0.950,Tree Swallow,16-23,0,1,0,1,0.000,0.000
7,0.950,Tree Swallow,23-5,0,4,0,4,0.000,0.000
7,0.950,Turkey Vulture,16-23,0,0,0,0,NaN,NaN
7,0.950,Turkey Vulture,23-5,0,0,0,0,NaN,NaN
7,0.950,Dg,16-23,8,12,0,20,40.000,40.000
7,0.950,Dg,23-5,31,31,0,62,50.000,50.000
7,0.950,Western Kingbird,16-23,0,0,0,0,NaN,NaN
7,0.950,Western Kingbird,23-5,0,0,0,0,NaN,NaN
7,0.950,White Crowned Sparrow,16-23,0,6,0,6,0.000,0.000
7,0.950,White Crowned Sparrow,23-5,3,22,0,25,12.000,12.000
7,0.950,Eared Grebe,16-23,0,0,0,0,NaN,NaN
7,0.950,Eared Grebe,23-5,0,16,0,16,0.000,0.000
7,0.950,cougar,16-23,0,0,0,0,NaN,NaN
7,0.950,cougar,23-5,0,0,0,0,NaN,NaN
7,0.950,Ocean Water,16-23,0,0,0,0,NaN,NaN
7,0.950,Ocean Water,23-5,0,0,0,0,NaN,NaN
7,0.950,Red Tailed Hawk,16-23,0,2,0,2,0.000,0.000
7,0.950,Red Tailed Hawk,23-5,0,5,0,5,0.000,0.000
7,0.950,Dog,16-23,66,75,0,141,46.809,46.809
7,0.950,Dog,23-5,105,144,0,249,42.169,42.169
7,0.950,Human,16-23,1727,671,0,2398,72.018,72.018
7,0.950,Human,23-5,2159,555,0,2714,79.550,79.550
7,0.950,Wild Turkey,16-23,10,19,0,29,34.483,34.483
7,0.950,Wild Turkey,23-5,1,30,0,31,3.226,3.226
7,0.950,Clark Grebe,16-23,0,0,0,0,NaN,NaN
7,0.950,Clark Grebe,23-5,0,0,0,0,NaN,NaN
7,0.950,Seagull,16-23,0,0,0,0,NaN,NaN
7,0.950,Seagull,23-5,8,6,0,14,57.143,57.143
7,0.950,Surf Scoter,16-23,0,0,0,0,NaN,NaN
7,0.950,Surf Scoter,23-5,0,1,0,1,0.000,0.000
7,0.950,Pigeon,16-23,66,168,0,234,28.205,28.205
7,0.950,Pigeon,23-5,94,226,0,320,29.375,29.375
7,0.950,Pacific Ocean Water,16-23,0,0,0,0,NaN,NaN
7,0.950,Pacific Ocean Water,23-5,0,0,0,0,NaN,NaN
7,0.950,Cat,16-23,26,36,0,62,41.935,41.935
7,0.950,Cat,23-5,26,36,0,62,41.935,41.935
7,0.950,Horse,16-23,8,26,0,34,23.529,23.529
7,0.950,Horse,23-5,34,173,0,207,16.425,16.425
7,0.950,orangutan,16-23,0,0,0,0,NaN,NaN
7,0.950,orangutan,23-5,0,0,0,0,NaN,NaN
7,0.950,Bat,16-23,36,21,0,57,63.158,63.158
7,0.950,Bat,23-5,37,28,0,65,56.923,56.923
7,0.950,Deer,16-23,16,31,0,47,34.043,34.043
7,0.950,Deer,23-5,18,92,0,110,16.364,16.364
7,0.950,Great Horned Owl,16-23,0,0,0,0,NaN,NaN
7,0.950,Great Horned Owl,23-5,0,6,0,6,0.000,0.000
7,0.950,Freshwater Lagoon,16-23,0,0,0,0,NaN,NaN
7,0.950,Freshwater Lagoon,23-5,0,0,0,0,NaN,NaN
7,0.950,Unknown Avian,16-23,0,0,0,0,NaN,NaN
7,0.950,Unknown Avian,23-5,0,0,0,0,NaN,NaN
7,0.950,Human UTI,16-23,83,79,0,162,51.235,51.235
7,0.950,Human UTI,23-5,109,96,0,205,53.171,53.171
7,0.950,unknown,16-23,0,1,0,1,0.000,0.000
7,0.950,unknown,23-5,3,3,0,6,50.000,50.000
7,0.950,SLO Creek Water,16-23,0,0,0,0,NaN,NaN
7,0.950,SLO Creek Water,23-5,0,0,0,0,NaN,NaN
7,0.950,Pig/Swine,16-23,9,10,0,19,47.368,47.368
7,0.950,Pig/Swine,23-5,12,9,0,21,57.143,57.143
7,0.950,Klebsiella,16-23,0,0,0,0,NaN,NaN
7,0.950,Klebsiella,23-5,0,0,0,0,NaN,NaN
7,0.950,Hu Cw and Dg,16-23,11,23,0,34,32.353,32.353
7,0.950,Hu Cw and Dg,23-5,15,22,0,37,40.541,40.541
7,0.950,Ground Squirrel,16-23,97,72,0,169,57.396,57.396
7,0.950,Ground Squirrel,23-5,89,82,0,171,52.047,52.047
7,0.950,Opossum,16-23,0,2,0,2,0.000,0.000
7,0.950,Opossum,23-5,0,4,0,4,0.000,0.000
7,0.950,Cow,16-23,1561,1042,0,2603,59.969,59.969
7,0.950,Cow,23-5,1508,1371,0,2879,52.379,52.379
7,0.950,Deer Mouse,16-23,0,0,0,0,NaN,NaN
7,0.950,Deer Mouse,23-5,0,0,0,0,NaN,NaN
7,0.950,OVERALL,16-23,3845,2482,0,6327,60.771,60.771
7,0.950,OVERALL,23-5,4425,3163,0,7588,58.316,58.316
7,0.960,Chicken,16-23,3,15,0,18,16.667,16.667
7,0.960,Chicken,23-5,13,9,0,22,59.091,59.091
7,0.960,Sea Lion,16-23,0,1,0,1,0.000,0.000
7,0.960,Sea Lion,23-5,3,12,0,15,20.000,20.000
7,0.960,Hu and Cw,16-23,9,13,0,22,40.909,40.909
7,0.960,Hu and Cw,23-5,4,22,0,26,15.385,15.385
7,0.960,Sheep,16-23,54,53,0,107,50.467,50.467
7,0.960,Sheep,23-5,63,41,0,104,60.577,60.577
7,0.960,Hu and Dg,16-23,10,15,0,25,40.000,40.000
7,0.960,Hu and Dg,23-5,19,17,0,36,52.778,52.778
7,0.960,Common Loon,16-23,0,0,0,0,NaN,NaN
7,0.960,Common Loon,23-5,0,4,0,4,0.000,0.000
7,0.960,Red-Winged Blackbird,16-23,0,10,0,10,0.000,0.000
7,0.960,Red-Winged Blackbird,23-5,0,1,0,1,0.000,0.000
7,0.960,Cw,16-23,11,10,0,21,52.381,52.381
7,0.960,Cw,23-5,22,43,0,65,33.846,33.846
7,0.960,Cliff Sparrow,16-23,3,25,0,28,10.714,10.714
7,0.960,Cliff Sparrow,23-5,2,8,0,10,20.000,20.000
7,0.960,Pig,16-23,10,11,0,21,47.619,47.619
7,0.960,Pig,23-5,5,11,0,16,31.250,31.250
7,0.960,Barn Owl,16-23,0,0,0,0,NaN,NaN
7,0.960,Barn Owl,23-5,0,0,0,0,NaN,NaN
7,0.960,Wild Pig,16-23,1,1,0,2,50.000,50.000
7,0.960,Wild Pig,23-5,3,2,0,5,60.000,60.000
7,0.960,Pennington Creek Water,16-23,0,0,0,0,NaN,NaN
7,0.960,Pennington Creek Water,23-5,0,0,0,0,NaN,NaN
7,0.960,Guinni,16-23,0,0,0,0,NaN,NaN
7,0.960,Guinni,23-5,0,0,0,0,NaN,NaN
7,0.960,Racoon,16-23,0,0,0,0,NaN,NaN
7,0.960,Racoon,23-5,0,0,0,0,NaN,NaN
7,0.960,Hu,16-23,16,17,0,33,48.485,48.485
7,0.960,Hu,23-5,21,11,0,32,65.625,65.625
7,0.960,Cw and Dg,16-23,4,14,0,18,22.222,22.222
7,0.960,Cw and Dg,23-5,18,21,0,39,46.154,46.154
7,0.960,Red Wind Blackbird,16-23,0,0,0,0,NaN,NaN
7,0.960,Red Wind Blackbird,23-5,0,0,0,0,NaN,NaN
7,0.960,Tree Swallow,16-23,0,1,0,1,0.000,0.000
7,0.960,Tree Swallow,23-5,0,4,0,4,0.000,0.000
7,0.960,Turkey Vulture,16-23,0,0,0,0,NaN,NaN
7,0.960,Turkey Vulture,23-5,0,0,0,0,NaN,NaN
7,0.960,Dg,16-23,8,12,0,20,40.000,40.000
7,0.960,Dg,23-5,31,31,0,62,50.000,50.000
7,0.960,Western Kingbird,16-23,0,0,0,0,NaN,NaN
7,0.960,Western Kingbird,23-5,0,0,0,0,NaN,NaN
7,0.960,White Crowned Sparrow,16-23,0,6,0,6,0.000,0.000
7,0.960,White Crowned Sparrow,23-5,3,22,0,25,12.000,12.000
7,0.960,Eared Grebe,16-23,0,0,0,0,NaN,NaN
7,0.960,Eared Grebe,23-5,0,16,0,16,0.000,0.000
7,0.960,cougar,16-23,0,0,0,0,NaN,NaN
7,0.960,cougar,23-5,0,0,0,0,NaN,NaN
7,0.960,Ocean Water,16-23,0,0,0,0,NaN,NaN
7,0.960,Ocean Water,23-5,0,0,0,0,NaN,NaN
7,0.960,Red Tailed Hawk,16-23,0,2,0,2,0.000,0.000
7,0.960,Red Tailed Hawk,23-5,0,5,0,5,0.000,0.000
7,0.960,Dog,16-23,66,75,0,141,46.809,46.809
7,0.960,Dog,23-5,105,141,0,246,42.683,42.683
7,0.960,Human,16-23,1728,670,0,2398,72.060,72.060
7,0.960,Human,23-5,2164,542,0,2706,79.970,79.970
7,0.960,Wild Turkey,16-23,10,19,0,29,34.483,34.483
7,0.960,Wild Turkey,23-5,1,34,0,35,2.857,2.857
7,0.960,Clark Grebe,16-23,0,0,0,0,NaN,NaN
7,0.960,Clark Grebe,23-5,0,0,0,0,NaN,NaN
7,0.960,Seagull,16-23,0,0,0,0,NaN,NaN
7,0.960,Seagull,23-5,8,7,0,15,53.333,53.333
7,0.960,Surf Scoter,16-23,0,0,0,0,NaN,NaN
7,0.960,Surf Scoter,23-5,0,2,0,2,0.000,0.000
7,0.960,Pigeon,16-23,64,168,0,232,27.586,27.586
7,0.960,Pigeon,23-5,95,239,0,334,28.443,28.443
7,0.960,Pacific Ocean Water,16-23,0,0,0,0,NaN,NaN
7,0.960,Pacific Ocean Water,23-5,0,0,0,0,NaN,NaN
7,0.960,Cat,16-23,26,36,0,62,41.935,41.935
7,0.960,Cat,23-5,26,36,0,62,41.935,41.935
7,0.960,Horse,16-23,8,26,0,34,23.529,23.529
7,0.960,Horse,23-5,34,173,0,207,16.425,16.425
7,0.960,orangutan,16-23,0,0,0,0,NaN,NaN
7,0.960,orangutan,23-5,0,0,0,0,NaN,NaN
7,0.960,Bat,16-23,36,21,0,57,63.158,63.158
7,0.960,Bat,23-5,37,28,0,65,56.923,56.923
7,0.960,Deer,16-23,16,31,0,47,34.043,34.043
7,0.960,Deer,23-5,18,92,0,110,16.364,16.364
7,0.960,Great Horned Owl,16-23,0,0,0,0,NaN,NaN
7,0.960,Great Horned Owl,23-5,0,6,0,6,0.000,0.000
7,0.960,Freshwater Lagoon,16-23,0,0,0,0,NaN,NaN
7,0.960,Freshwater Lagoon,23-5,0,0,0,0,NaN,NaN
7,0.960,Unknown Avian,16-23,0,0,0,0,NaN,NaN
7,0.960,Unknown Avian,23-5,0,0,0,0,NaN,NaN
7,0.960,Human UTI,16-23,83,80,0,163,50.920,50.920
7,0.960,Human UTI,23-5,109,95,0,204,53.431,53.431
7,0.960,unknown,16-23,0,1,0,1,0.000,0.000
7,0.960,unknown,23-5,3,3,0,6,50.000,50.000
7,0.960,SLO Creek Water,16-23,0,0,0,0,NaN,NaN
7,0.960,SLO Creek Water,23-5,0,0,0,0,NaN,NaN
7,0.960,Pig/Swine,16-23,9,10,0,19,47.368,47.368
7,0.960,Pig/Swine,23-5,12,9,0,21,57.143,57.143
7,0.960,Klebsiella,16-23,0,0,0,0,NaN,NaN
7,0.960,Klebsiella,23-5,0,0,0,0,NaN,NaN
7,0.960,Hu Cw and Dg,16-23,11,23,0,34,32.353,32.353
7,0.960,Hu Cw and Dg,23-5,15,22,0,37,40.541,40.541
7,0.960,Ground Squirrel,16-23,97,72,0,169,57.396,57.396
7,0.960,Ground Squirrel,23-5,89,84,0,173,51.445,51.445
7,0.960,Opossum,16-23,0,2,0,2,0.000,0.000
7,0.960,Opossum,23-5,0,4,0,4,0.000,0.000
7,0.960,Cow,16-23,1559,1034,0,2593,60.123,60.123
7,0.960,Cow,23-5,1508,1349,0,2857,52.783,52.783
7,0.960,Deer Mouse,16-23,0,0,0,0,NaN,NaN
7,0.960,Deer Mouse,23-5,0,0,0,0,NaN,NaN
7,0.960,OVERALL,16-23,3842,2474,0,6316,60.830,60.830
7,0.960,OVERALL,23-5,4431,3146,0,7577,58.480,58.480
7,0.970,Chicken,16-23,3,15,0,18,16.667,16.667
7,0.970,Chicken,23-5,13,9,0,22,59.091,59.091
7,0.970,Sea Lion,16-23,0,1,0,1,0.000,0.000
7,0.970,Sea Lion,23-5,3,12,0,15,20.000,20.000
7,0.970,Hu and Cw,16-23,9,13,0,22,40.909,40.909
7,0.970,Hu and Cw,23-5,4,22,0,26,15.385,15.385
7,0.970,Sheep,16-23,54,54,0,108,50.000,50.000
7,0.970,Sheep,23-5,63,40,0,103,61.165,61.165
7,0.970,Hu and Dg,16-23,10,15,0,25,40.000,40.000
7,0.970,Hu and Dg,23-5,19,17,0,36,52.778,52.778
7,0.970,Common Loon,16-23,0,0,0,0,NaN,NaN
7,0.970,Common Loon,23-5,0,4,0,4,0.000,0.000
7,0.970,Red-Winged Blackbird,16-23,0,10,0,10,0.000,0.000
7,0.970,Red-Winged Blackbird,23-5,0,1,0,1,0.000,0.000
7,0.970,Cw,16-23,11,11,0,22,50.000,50.000
7,0.970,Cw,23-5,22,43,0,65,33.846,33.846
7,0.970,Cliff Sparrow,16-23,3,25,0,28,10.714,10.714
7,0.970,Cliff Sparrow,23-5,2,8,0,10,20.000,20.000
7,0.970,Pig,16-23,10,11,0,21,47.619,47.619
7,0.970,Pig,23-5,5,11,0,16,31.250,31.250
7,0.970,Barn Owl,16-23,0,0,0,0,NaN,NaN
7,0.970,Barn Owl,23-5,0,0,0,0,NaN,NaN
7,0.970,Wild Pig,16-23,1,1,0,2,50.000,50.000
7,0.970,Wild Pig,23-5,2,2,0,4,50.000,50.000
7,0.970,Pennington Creek Water,16-23,0,0,0,0,NaN,NaN
7,0.970,Pennington Creek Water,23-5,0,0,0,0,NaN,NaN
7,0.970,Guinni,16-23,0,0,0,0,NaN,NaN
7,0.970,Guinni,23-5,0,0,0,0,NaN,NaN
7,0.970,Racoon,16-23,0,0,0,0,NaN,NaN
7,0.970,Racoon,23-5,0,0,0,0,NaN,NaN
7,0.970,Hu,16-23,16,17,0,33,48.485,48.485
7,0.970,Hu,23-5,21,11,0,32,65.625,65.625
7,0.970,Cw and Dg,16-23,4,14,0,18,22.222,22.222
7,0.970,Cw and Dg,23-5,18,21,0,39,46.154,46.154
7,0.970,Red Wind Blackbird,16-23,0,0,0,0,NaN,NaN
7,0.970,Red Wind Blackbird,23-5,0,0,0,0,NaN,NaN
7,0.970,Tree Swallow,16-23,0,1,0,1,0.000,0.000
7,0.970,Tree Swallow,23-5,0,4,0,4,0.000,0.000
7,0.970,Turkey Vulture,16-23,0,0,0,0,NaN,NaN
7,0.970,Turkey Vulture,23-5,0,0,0,0,NaN,NaN
7,0.970,Dg,16-23,8,12,0,20,40.000,40.000
7,0.970,Dg,23-5,31,30,0,61,50.820,50.820
7,0.970,Western Kingbird,16-23,0,0,0,0,NaN,NaN
7,0.970,Western Kingbird,23-5,0,0,0,0,NaN,NaN
7,0.970,White Crowned Sparrow,16-23,0,6,0,6,0.000,0.000
7,0.970,White Crowned Sparrow,23-5,3,22,0,25,12.000,12.000
7,0.970,Eared Grebe,16-23,0,0,0,0,NaN,NaN
7,0.970,Eared Grebe,23-5,0,16,0,16,0.000,0.000
7,0.970,cougar,16-23,0,0,0,0,NaN,NaN
7,0.970,cougar,23-5,0,0,0,0,NaN,NaN
7,0.970,Ocean Water,16-23,0,0,0,0,NaN,NaN
7,0.970,Ocean Water,23-5,0,0,0,0,NaN,NaN
7,0.970,Red Tailed Hawk,16-23,0,2,0,2,0.000,0.000
7,0.970,Red Tailed Hawk,23-5,0,5,0,5,0.000,0.000
7,0.970,Dog,16-23,66,75,0,141,46.809,46.809
7,0.970,Dog,23-5,105,140,0,245,42.857,42.857
7,0.970,Human,16-23,1727,670,0,2397,72.048,72.048
7,0.970,Human,23-5,2160,541,0,2701,79.970,79.970
7,0.970,Wild Turkey,16-23,10,20,0,30,33.333,33.333
7,0.970,Wild Turkey,23-5,3,33,0,36,8.333,8.333
7,0.970,Clark Grebe,16-23,0,0,0,0,NaN,NaN
7,0.970,Clark Grebe,23-5,0,0,0,0,NaN,NaN
7,0.970,Seagull,16-23,0,0,0,0,NaN,NaN
7,0.970,Seagull,23-5,8,8,0,16,50.000,50.000
7,0.970,Surf Scoter,16-23,0,0,0,0,NaN,NaN
7,0.970,Surf Scoter,23-5,0,2,0,2,0.000,0.000
7,0.970,Pigeon,16-23,62,167,0,229,27.074,27.074
7,0.970,Pigeon,23-5,95,257,0,352,26.989,26.989
7,0.970,Pacific Ocean Water,16-23,0,0,0,0,NaN,NaN
7,0.970,Pacific Ocean Water,23-5,0,0,0,0,NaN,NaN
7,0.970,Cat,16-23,26,36,0,62,41.935,41.935
7,0.970,Cat,23-5,26,36,0,62,41.935,41.935
7,0.970,Horse,16-23,8,26,0,34,23.529,23.529
7,0.970,Horse,23-5,34,173,0,207,16.425,16.425
7,0.970,orangutan,16-23,0,0,0,0,NaN,NaN
7,0.970,orangutan,23-5,0,0,0,0,NaN,NaN
7,0.970,Bat,16-23,36,21,0,57,63.158,63.158
7,0.970,Bat,23-5,37,28,0,65,56.923,56.923
7,0.970,Deer,16-23,16,31,0,47,34.043,34.043
7,0.970,Deer,23-5,18,92,0,110,16.364,16.364
7,0.970,Great Horned Owl,16-23,0,0,0,0,NaN,NaN
7,0.970,Great Horned Owl,23-5,0,6,0,6,0.000,0.000
7,0.970,Freshwater Lagoon,16-23,0,0,0,0,NaN,NaN
7,0.970,Freshwater Lagoon,23-5,0,0,0,0,NaN,NaN
7,0.970,Unknown Avian,16-23,0,0,0,0,NaN,NaN
7,0.970,Unknown Avian,23-5,0,0,0,0,NaN,NaN
7,0.970,Human UTI,16-23,83,81,0,164,50.610,50.610
7,0.970,Human UTI,23-5,108,94,0,202,53.465,53.465
7,0.970,unknown,16-23,0,1,0,1,0.000,0.000
7,0.970,unknown,23-5,3,3,0,6,50.000,50.000
7,0.970,SLO Creek Water,16-23,0,0,0,0,NaN,NaN
7,0.970,SLO Creek Water,23-5,0,0,0,0,NaN,NaN
7,0.970,Pig/Swine,16-23,9,10,0,19,47.368,47.368
7,0.970,Pig/Swine,23-5,12,9,0,21,57.143,57.143
7,0.970,Klebsiella,16-23,0,0,0,0,NaN,NaN
7,0.970,Klebsiella,23-5,0,0,0,0,NaN,NaN
7,0.970,Hu Cw and Dg,16-23,11,23,0,34,32.353,32.353
7,0.970,Hu Cw and Dg,23-5,15,22,0,37,40.541,40.541
7,0.970,Ground Squirrel,16-23,96,69,0,165,58.182,58.182
7,0.970,Ground Squirrel,23-5,89,82,0,171,52.047,52.047
7,0.970,Opossum,16-23,0,2,0,2,0.000,0.000
7,0.970,Opossum,23-5,0,4,0,4,0.000,0.000
7,0.970,Cow,16-23,1553,1034,0,2587,60.031,60.031
7,0.970,Cow,23-5,1505,1324,0,2829,53.199,53.199
7,0.970,Deer Mouse,16-23,0,0,0,0,NaN,NaN
7,0.970,Deer Mouse,23-5,0,0,0,0,NaN,NaN
7,0.970,OVERALL,16-23,3832,2474,0,6306,60.768,60.768
7,0.970,OVERALL,23-5,4424,3132,0,7556,58.549,58.549
7,0.980,Chicken,16-23,3,15,0,18,16.667,16.667
7,0.980,Chicken,23-5,14,9,0,23,60.870,60.870
7,0.980,Sea Lion,16-23,0,1,0,1,0.000,0.000
7,0.980,Sea Lion,23-5,3,11,0,14,21.429,21.429
7,0.980,Hu and Cw,16-23,9,13,0,22,40.909,40.909
7,0.980,Hu and Cw,23-5,4,32,0,36,11.111,11.111
7,0.980,Sheep,16-23,54,52,0,106,50.943,50.943
7,0.980,Sheep,23-5,62,39,0,101,61.386,61.386
7,0.980,Hu and Dg,16-23,10,15,0,25,40.000,40.000
7,0.980,Hu and Dg,23-5,19,15,0,34,55.882,55.882
7,0.980,Common Loon,16-23,0,0,0,0,NaN,NaN
7,0.980,Common Loon,23-5,0,4,0,4,0.000,0.000
7,0.980,Red-Winged Blackbird,16-23,0,10,0,10,0.000,0.000
7,0.980,Red-Winged Blackbird,23-5,0,1,0,1,0.000,0.000
7,0.980,Cw,16-23,11,10,0,21,52.381,52.381
7,0.980,Cw,23-5,22,43,0,65,33.846,33.846
7,0.980,Cliff Sparrow,16-23,3,24,0,27,11.111,11.111
7,0.980,Cliff Sparrow,23-5,2,8,0,10,20.000,20.000
7,0.980,Pig,16-23,10,11,0,21,47.619,47.619
7,0.980,Pig,23-5,5,11,0,16,31.250,31.250
7,0.980,Barn Owl,16-23,0,0,0,0,NaN,NaN
7,0.980,Barn Owl,23-5,0,0,0,0,NaN,NaN
7,0.980,Wild Pig,16-23,1,1,0,2,50.000,50.000
7,0.980,Wild Pig,23-5,2,2,0,4,50.000,50.000
7,0.980,Pennington Creek Water,16-23,0,0,0,0,NaN,NaN
7,0.980,Pennington Creek Water,23-5,0,0,0,0,NaN,NaN
7,0.980,Guinni,16-23,0,0,0,0,NaN,NaN
7,0.980,Guinni,23-5,0,0,0,0,NaN,NaN
7,0.980,Racoon,16-23,0,0,0,0,NaN,NaN
7,0.980,Racoon,23-5,0,0,0,0,NaN,NaN
7,0.980,Hu,16-23,16,17,0,33,48.485,48.485
7,0.980,Hu,23-5,21,12,0,33,63.636,63.636
7,0.980,Cw and Dg,16-23,4,14,0,18,22.222,22.222
7,0.980,Cw and Dg,23-5,18,20,0,38,47.368,47.368
7,0.980,Red Wind Blackbird,16-23,0,0,0,0,NaN,NaN
7,0.980,Red Wind Blackbird,23-5,0,0,0,0,NaN,NaN
7,0.980,Tree Swallow,16-23,0,1,0,1,0.000,0.000
7,0.980,Tree Swallow,23-5,0,4,0,4,0.000,0.000
7,0.980,Turkey Vulture,16-23,0,0,0,0,NaN,NaN
7,0.980,Turkey Vulture,23-5,0,0,0,0,NaN,NaN
7,0.980,Dg,16-23,8,12,0,20,40.000,40.000
7,0.980,Dg,23-5,31,24,0,55,56.364,56.364
7,0.980,Western Kingbird,16-23,0,0,0,0,NaN,NaN
7,0.980,Western Kingbird,23-5,0,0,0,0,NaN,NaN
7,0.980,White Crowned Sparrow,16-23,0,4,0,4,0.000,0.000
7,0.980,White Crowned Sparrow,23-5,3,22,0,25,12.000,12.000
7,0.980,Eared Grebe,16-23,0,0,0,0,NaN,NaN
7,0.980,Eared Grebe,23-5,0,16,0,16,0.000,0.000
7,0.980,cougar,16-23,0,0,0,0,NaN,NaN
7,0.980,cougar,23-5,0,0,0,0,NaN,NaN
7,0.980,Ocean Water,16-23,0,0,0,0,NaN,NaN
7,0.980,Ocean Water,23-5,0,0,0,0,NaN,NaN
7,0.980,Red Tailed Hawk,16-23,0,2,0,2,0.000,0.000
7,0.980,Red Tailed Hawk,23-5,0,4,0,4,0.000,0.000
7,0.980,Dog,16-23,65,79,0,144,45.139,45.139
7,0.980,Dog,23-5,105,137,0,242,43.388,43.388
7,0.980,Human,16-23,1726,660,0,2386,72.339,72.339
7,0.980,Human,23-5,2156,531,0,2687,80.238,80.238
7,0.980,Wild Turkey,16-23,10,20,0,30,33.333,33.333
7,0.980,Wild Turkey,23-5,5,37,0,42,11.905,11.905
7,0.980,Clark Grebe,16-23,0,0,0,0,NaN,NaN
7,0.980,Clark Grebe,23-5,0,0,0,0,NaN,NaN
7,0.980,Seagull,16-23,0,0,0,0,NaN,NaN
7,0.980,Seagull,23-5,10,6,0,16,62.500,62.500
7,0.980,Surf Scoter,16-23,0,0,0,0,NaN,NaN
7,0.980,Surf Scoter,23-5,2,0,0,2,100.000,100.000
7,0.980,Pigeon,16-23,62,165,0,227,27.313,27.313
7,0.980,Pigeon,23-5,94,263,0,357,26.331,26.331
7,0.980,Pacific Ocean Water,16-23,0,0,0,0,NaN,NaN
7,0.980,Pacific Ocean Water,23-5,0,0,0,0,NaN,NaN
7,0.980,Cat,16-23,26,34,0,60,43.333,43.333
7,0.980,Cat,23-5,26,34,0,60,43.333,43.333
7,0.980,Horse,16-23,8,26,0,34,23.529,23.529
7,0.980,Horse,23-5,34,170,0,204,16.667,16.667
7,0.980,orangutan,16-23,0,0,0,0,NaN,NaN
7,0.980,orangutan,23-5,0,0,0,0,NaN,NaN
7,0.980,Bat,16-23,36,21,0,57,63.158,63.158
7,0.980,Bat,23-5,37,27,0,64,57.813,57.813
7,0.980,Deer,16-23,16,31,0,47,34.043,34.043
7,0.980,Deer,23-5,18,92,0,110,16.364,16.364
7,0.980,Great Horned Owl,16-23,0,0,0,0,NaN,NaN
7,0.980,Great Horned Owl,23-5,0,6,0,6,0.000,0.000
7,0.980,Freshwater Lagoon,16-23,0,0,0,0,NaN,NaN
7,0.980,Freshwater Lagoon,23-5,0,0,0,0,NaN,NaN
7,0.980,Unknown Avian,16-23,0,0,0,0,NaN,NaN
7,0.980,Unknown Avian,23-5,0,0,0,0,NaN,NaN
7,0.980,Human UTI,16-23,83,84,0,167,49.701,49.701
7,0.980,Human UTI,23-5,108,92,0,200,54.000,54.000
7,0.980,unknown,16-23,0,1,0,1,0.000,0.000
7,0.980,unknown,23-5,3,4,0,7,42.857,42.857
7,0.980,SLO Creek Water,16-23,0,0,0,0,NaN,NaN
7,0.980,SLO Creek Water,23-5,0,0,0,0,NaN,NaN
7,0.980,Pig/Swine,16-23,9,10,0,19,47.368,47.368
7,0.980,Pig/Swine,23-5,12,9,0,21,57.143,57.143
7,0.980,Klebsiella,16-23,0,0,0,0,NaN,NaN
7,0.980,Klebsiella,23-5,0,0,0,0,NaN,NaN
7,0.980,Hu Cw and Dg,16-23,11,23,0,34,32.353,32.353
7,0.980,Hu Cw and Dg,23-5,15,20,0,35,42.857,42.857
7,0.980,Ground Squirrel,16-23,97,71,0,168,57.738,57.738
7,0.980,Ground Squirrel,23-5,89,81,0,170,52.353,52.353
7,0.980,Opossum,16-23,0,2,0,2,0.000,0.000
7,0.980,Opossum,23-5,0,4,0,4,0.000,0.000
7,0.980,Cow,16-23,1546,1023,0,2569,60.179,60.179
7,0.980,Cow,23-5,1499,1302,0,2801,53.517,53.517
7,0.980,Deer Mouse,16-23,0,0,0,0,NaN,NaN
7,0.980,Deer Mouse,23-5,0,0,0,0,NaN,NaN
7,0.980,OVERALL,16-23,3824,2452,0,6276,60.931,60.931
7,0.980,OVERALL,23-5,4419,3092,0,7511,58.834,58.834
7,0.990,Chicken,16-23,4,19,0,23,17.391,17.391
7,0.990,Chicken,23-5,15,8,0,23,65.217,65.217
7,0.990,Sea Lion,16-23,0,1,0,1,0.000,0.000
7,0.990,Sea Lion,23-5,4,7,0,11,36.364,36.364
7,0.990,Hu and Cw,16-23,10,13,0,23,43.478,43.478
7,0.990,Hu and Cw,23-5,5,33,0,38,13.158,13.158
7,0.990,Sheep,16-23,53,51,0,104,50.962,50.962
7,0.990,Sheep,23-5,63,38,0,101,62.376,62.376
7,0.990,Hu and Dg,16-23,10,16,0,26,38.462,38.462
7,0.990,Hu and Dg,23-5,19,10,0,29,65.517,65.517
7,0.990,Common Loon,16-23,0,0,0,0,NaN,NaN
7,0.990,Common Loon,23-5,0,5,0,5,0.000,0.000
7,0.990,Red-Winged Blackbird,16-23,0,9,0,9,0.000,0.000
7,0.990,Red-Winged Blackbird,23-5,0,1,0,1,0.000,0.000
7,0.990,Cw,16-23,11,10,0,21,52.381,52.381
7,0.990,Cw,23-5,22,41,0,63,34.921,34.921
7,0.990,Cliff Sparrow,16-23,3,24,0,27,11.111,11.111
7,0.990,Cliff Sparrow,23-5,2,11,0,13,15.385,15.385
7,0.990,Pig,16-23,10,12,0,22,45.455,45.455
7,0.990,Pig,23-5,9,11,0,20,45.000,45.000
7,0.990,Barn Owl,16-23,0,0,0,0,NaN,NaN
7,0.990,Barn Owl,23-5,0,0,0,0,NaN,NaN
7,0.990,Wild Pig,16-23,1,3,0,4,25.000,25.000
7,0.990,Wild Pig,23-5,2,2,0,4,50.000,50.000
7,0.990,Pennington Creek Water,16-23,0,0,0,0,NaN,NaN
7,0.990,Pennington Creek Water,23-5,0,0,0,0,NaN,NaN
7,0.990,Guinni,16-23,0,0,0,0,NaN,NaN
7,0.990,Guinni,23-5,0,0,0,0,NaN,NaN
7,0.990,Racoon,16-23,0,0,0,0,NaN,NaN
7,0.990,Racoon,23-5,0,1,0,1,0.000,0.000
7,0.990,Hu,16-23,16,15,0,31,51.613,51.613
7,0.990,Hu,23-5,21,9,0,30,70.000,70.000
7,0.990,Cw and Dg,16-23,4,14,0,18,22.222,22.222
7,0.990,Cw and Dg,23-5,18,14,0,32,56.250,56.250
7,0.990,Red Wind Blackbird,16-23,0,0,0,0,NaN,NaN
7,0.990,Red Wind Blackbird,23-5,0,0,0,0,NaN,NaN
7,0.990,Tree Swallow,16-23,0,1,0,1,0.000,0.000
7,0.990,Tree Swallow,23-5,0,4,0,4,0.000,0.000
7,0.990,Turkey Vulture,16-23,0,0,0,0,NaN,NaN
7,0.990,Turkey Vulture,23-5,0,0,0,0,NaN,NaN
7,0.990,Dg,16-23,8,13,0,21,38.095,38.095
7,0.990,Dg,23-5,31,20,0,51,60.784,60.784
7,0.990,Western Kingbird,16-23,0,0,0,0,NaN,NaN
7,0.990,Western Kingbird,23-5,0,0,0,0,NaN,NaN
7,0.990,White Crowned Sparrow,16-23,0,4,0,4,0.000,0.000
7,0.990,White Crowned Sparrow,23-5,3,21,0,24,12.500,12.500
7,0.990,Eared Grebe,16-23,0,0,0,0,NaN,NaN
7,0.990,Eared Grebe,23-5,0,14,0,14,0.000,0.000
7,0.990,cougar,16-23,0,1,0,1,0.000,0.000
7,0.990,cougar,23-5,0,0,0,0,NaN,NaN
7,0.990,Ocean Water,16-23,0,0,0,0,NaN,NaN
7,0.990,Ocean Water,23-5,0,0,0,0,NaN,NaN
7,0.990,Red Tailed Hawk,16-23,0,2,0,2,0.000,0.000
7,0.990,Red Tailed Hawk,23-5,0,5,0,5,0.000,0.000
7,0.990,Dog,16-23,67,77,0,144,46.528,46.528
7,0.990,Dog,23-5,107,128,0,235,45.532,45.532
7,0.990,Human,16-23,1705,632,0,2337,72.957,72.957
7,0.990,Human,23-5,2140,492,0,2632,81.307,81.307
7,0.990,Wild Turkey,16-23,11,24,0,35,31.429,31.429
7,0.990,Wild Turkey,23-5,5,35,0,40,12.500,12.500
7,0.990,Clark Grebe,16-23,0,0,0,0,NaN,NaN
7,0.990,Clark Grebe,23-5,2,3,0,5,40.000,40.000
7,0.990,Seagull,16-23,0,0,0,0,NaN,NaN
7,0.990,Seagull,23-5,15,5,0,20,75.000,75.000
7,0.990,Surf Scoter,16-23,0,0,0,0,NaN,NaN
7,0.990,Surf Scoter,23-5,2,0,0,2,100.000,100.000
7,0.990,Pigeon,16-23,65,158,0,223,29.148,29.148
7,0.990,Pigeon,23-5,99,253,0,352,28.125,28.125
7,0.990,Pacific Ocean Water,16-23,0,0,0,0,NaN,NaN
7,0.990,Pacific Ocean Water,23-5,0,0,0,0,NaN,NaN
7,0.990,Cat,16-23,25,30,0,55,45.455,45.455
7,0.990,Cat,23-5,26,36,0,62,41.935,41.935
7,0.990,Horse,16-23,11,26,0,37,29.730,29.730
7,0.990,Horse,23-5,33,176,0,209,15.789,15.789
7,0.990,orangutan,16-23,0,0,0,0,NaN,NaN
7,0.990,orangutan,23-5,0,0,0,0,NaN,NaN
7,0.990,Bat,16-23,36,20,0,56,64.286,64.286
7,0.990,Bat,23-5,37,27,0,64,57.813,57.813
7,0.990,Deer,16-23,16,32,0,48,33.333,33.333
7,0.990,Deer,23-5,18,90,0,108,16.667,16.667
7,0.990,Great Horned Owl,16-23,0,0,0,0,NaN,NaN
7,0.990,Great Horned Owl,23-5,0,6,0,6,0.000,0.000
7,0.990,Freshwater Lagoon,16-23,0,0,0,0,NaN,NaN
7,0.990,Freshwater Lagoon,23-5,0,0,0,0,NaN,NaN
7,0.990,Unknown Avian,16-23,0,0,0,0,NaN,NaN
7,0.990,Unknown Avian,23-5,0,0,0,0,NaN,NaN
7,0.990,Human UTI,16-23,87,80,0,167,52.096,52.096
7,0.990,Human UTI,23-5,109,79,0,188,57.979,57.979
7,0.990,unknown,16-23,0,1,0,1,0.000,0.000
7,0.990,unknown,23-5,3,5,0,8,37.500,37.500
7,0.990,SLO Creek Water,16-23,0,0,0,0,NaN,NaN
7,0.990,SLO Creek Water,23-5,0,0,0,0,NaN,NaN
7,0.990,Pig/Swine,16-23,8,11,0,19,42.105,42.105
7,0.990,Pig/Swine,23-5,12,9,0,21,57.143,57.143
7,0.990,Klebsiella,16-23,0,0,0,0,NaN,NaN
7,0.990,Klebsiella,23-5,0,0,0,0,NaN,NaN
7,0.990,Hu Cw and Dg,16-23,11,23,0,34,32.353,32.353
7,0.990,Hu Cw and Dg,23-5,15,21,0,36,41.667,41.667
7,0.990,Ground Squirrel,16-23,98,67,0,165,59.394,59.394
7,0.990,Ground Squirrel,23-5,90,82,0,172,52.326,52.326
7,0.990,Opossum,16-23,1,2,0,3,33.333,33.333
7,0.990,Opossum,23-5,2,4,0,6,33.333,33.333
7,0.990,Cow,16-23,1511,941,0,2452,61.623,61.623
7,0.990,Cow,23-5,1468,1202,0,2670,54.981,54.981
7,0.990,Deer Mouse,16-23,0,0,0,0,NaN,NaN
7,0.990,Deer Mouse,23-5,0,0,0,0,NaN,NaN
7,0.990,OVERALL,16-23,3782,2332,0,6114,61.858,61.858
7,0.990,OVERALL,23-5,4397,2908,0,7305,60.192,60.192
7,1.000,Chicken,16-23,0,0,0,0,NaN,NaN
7,1.000,Chicken,23-5,0,0,0,0,NaN,NaN
7,1.000,Sea Lion,16-23,0,0,0,0,NaN,NaN
7,1.000,Sea Lion,23-5,0,0,0,0,NaN,NaN
7,1.000,Hu and Cw,16-23,0,0,0,0,NaN,NaN
7,1.000,Hu and Cw,23-5,0,0,0,0,NaN,NaN
7,1.000,Sheep,16-23,0,0,0,0,NaN,NaN
7,1.000,Sheep,23-5,0,0,0,0,NaN,NaN
7,1.000,Hu and Dg,16-23,0,0,0,0,NaN,NaN
7,1.000,Hu and Dg,23-5,0,0,0,0,NaN,NaN
7,1.000,Common Loon,16-23,0,0,0,0,NaN,NaN
7,1.000,Common Loon,23-5,0,0,0,0,NaN,NaN
7,1.000,Red-Winged Blackbird,16-23,0,0,0,0,NaN,NaN
7,1.000,Red-Winged Blackbird,23-5,0,0,0,0,NaN,NaN
7,1.000,Cw,16-23,0,0,0,0,NaN,NaN
7,1.000,Cw,23-5,0,0,0,0,NaN,NaN
7,1.000,Cliff Sparrow,16-23,0,0,0,0,NaN,NaN
7,1.000,Cliff Sparrow,23-5,0,0,0,0,NaN,NaN
7,1.000,Pig,16-23,0,0,0,0,NaN,NaN
7,1.000,Pig,23-5,0,0,0,0,NaN,NaN
7,1.000,Barn Owl,16-23,0,0,0,0,NaN,NaN
7,1.000,Barn Owl,23-5,0,0,0,0,NaN,NaN
7,1.000,Wild Pig,16-23,0,0,0,0,NaN,NaN
7,1.000,Wild Pig,23-5,0,0,0,0,NaN,NaN
7,1.000,Pennington Creek Water,16-23,0,0,0,0,NaN,NaN
7,1.000,Pennington Creek Water,23-5,0,0,0,0,NaN,NaN
7,1.000,Guinni,16-23,0,0,0,0,NaN,NaN
7,1.000,Guinni,23-5,0,0,0,0,NaN,NaN
7,1.000,Racoon,16-23,0,0,0,0,NaN,NaN
7,1.000,Racoon,23-5,0,0,0,0,NaN,NaN
7,1.000,Hu,16-23,0,0,0,0,NaN,NaN
7,1.000,Hu,23-5,0,0,0,0,NaN,NaN
7,1.000,Cw and Dg,16-23,0,0,0,0,NaN,NaN
7,1.000,Cw and Dg,23-5,0,0,0,0,NaN,NaN
7,1.000,Red Wind Blackbird,16-23,0,0,0,0,NaN,NaN
7,1.000,Red Wind Blackbird,23-5,0,0,0,0,NaN,NaN
7,1.000,Tree Swallow,16-23,0,0,0,0,NaN,NaN
7,1.000,Tree Swallow,23-5,0,0,0,0,NaN,NaN
7,1.000,Turkey Vulture,16-23,0,0,0,0,NaN,NaN
7,1.000,Turkey Vulture,23-5,0,0,0,0,NaN,NaN
7,1.000,Dg,16-23,0,0,0,0,NaN,NaN
7,1.000,Dg,23-5,0,0,0,0,NaN,NaN
7,1.000,Western Kingbird,16-23,0,0,0,0,NaN,NaN
7,1.000,Western Kingbird,23-5,0,0,0,0,NaN,NaN
7,1.000,White Crowned Sparrow,16-23,0,0,0,0,NaN,NaN
7,1.000,White Crowned Sparrow,23-5,0,0,0,0,NaN,NaN
7,1.000,Eared Grebe,16-23,0,0,0,0,NaN,NaN
7,1.000,Eared Grebe,23-5,0,0,0,0,NaN,NaN
7,1.000,cougar,16-23,0,0,0,0,NaN,NaN
7,1.000,cougar,23-5,0,0,0,0,NaN,NaN
7,1.000,Ocean Water,16-23,0,0,0,0,NaN,NaN
7,1.000,Ocean Water,23-5,0,0,0,0,NaN,NaN
7,1.000,Red Tailed Hawk,16-23,0,0,0,0,NaN,NaN
7,1.000,Red Tailed Hawk,23-5,0,0,0,0,NaN,NaN
7,1.000,Dog,16-23,0,0,0,0,NaN,NaN
7,1.000,Dog,23-5,0,0,0,0,NaN,NaN
7,1.000,Human,16-23,0,0,0,0,NaN,NaN
7,1.000,Human,23-5,0,0,0,0,NaN,NaN
7,1.000,Wild Turkey,16-23,0,0,0,0,NaN,NaN
7,1.000,Wild Turkey,23-5,0,0,0,0,NaN,NaN
7,1.000,Clark Grebe,16-23,0,0,0,0,NaN,NaN
7,1.000,Clark Grebe,23-5,0,0,0,0,NaN,NaN
7,1.000,Seagull,16-23,0,0,0,0,NaN,NaN
7,1.000,Seagull,23-5,0,0,0,0,NaN,NaN
7,1.000,Surf Scoter,16-23,0,0,0,0,NaN,NaN
7,1.000,Surf Scoter,23-5,0,0,0,0,NaN,NaN
7,1.000,Pigeon,16-23,0,0,0,0,NaN,NaN
7,1.000,Pigeon,23-5,0,0,0,0,NaN,NaN
7,1.000,Pacific Ocean Water,16-23,0,0,0,0,NaN,NaN
7,1.000,Pacific Ocean Water,23-5,0,0,0,0,NaN,NaN
7,1.000,Cat,16-23,0,0,0,0,NaN,NaN
7,1.000,Cat,23-5,0,0,0,0,NaN,NaN
7,1.000,Horse,16-23,0,0,0,0,NaN,NaN
7,1.000,Horse,23-5,0,0,0,0,NaN,NaN
7,1.000,orangutan,16-23,0,0,0,0,NaN,NaN
7,1.000,orangutan,23-5,0,0,0,0,NaN,NaN
7,1.000,Bat,16-23,0,0,0,0,NaN,NaN
7,1.000,Bat,23-5,0,0,0,0,NaN,NaN
7,1.000,Deer,16-23,0,0,0,0,NaN,NaN
7,1.000,Deer,23-5,0,0,0,0,NaN,NaN
7,1.000,Great Horned Owl,16-23,0,0,0,0,NaN,NaN
7,1.000,Great Horned Owl,23-5,0,0,0,0,NaN,NaN
7,1.000,Freshwater Lagoon,16-23,0,0,0,0,NaN,NaN
7,1.000,Freshwater Lagoon,23-5,0,0,0,0,NaN,NaN
7,1.000,Unknown Avian,16-23,0,0,0,0,NaN,NaN
7,1.000,Unknown Avian,23-5,0,0,0,0,NaN,NaN
7,1.000,Human UTI,16-23,0,0,0,0,NaN,NaN
7,1.000,Human UTI,23-5,0,0,0,0,NaN,NaN
7,1.000,unknown,16-23,0,0,0,0,NaN,NaN
7,1.000,unknown,23-5,0,0,0,0,NaN,NaN
7,1.000,SLO Creek Water,16-23,0,0,0,0,NaN,NaN
7,1.000,SLO Creek Water,23-5,0,0,0,0,NaN,NaN
7,1.000,Pig/Swine,16-23,0,0,0,0,NaN,NaN
7,1.000,Pig/Swine,23-5,0,0,0,0,NaN,NaN
7,1.000,Klebsiella,16-23,0,0,0,0,NaN,NaN
7,1.000,Klebsiella,23-5,0,0,0,0,NaN,NaN
7,1.000,Hu Cw and Dg,16-23,0,0,0,0,NaN,NaN
7,1.000,Hu Cw and Dg,23-5,0,0,0,0,NaN,NaN
7,1.000,Ground Squirrel,16-23,0,0,0,0,NaN,NaN
7,1.000,Ground Squirrel,23-5,0,0,0,0,NaN,NaN
7,1.000,Opossum,16-23,0,0,0,0,NaN,NaN
7,1.000,Opossum,23-5,0,0,0,0,NaN,NaN
7,1.000,Cow,16-23,0,0,0,0,NaN,NaN
7,1.000,Cow,23-5,0,0,0,0,NaN,NaN
7,1.000,Deer Mouse,16-23,0,0,0,0,NaN,NaN
7,1.000,Deer Mouse,23-5,0,0,0,0,NaN,NaN
7,1.000,OVERALL,16-23,0,0,0,0,NaN,NaN
7,1.000,OVERALL,23-5,0,0,0,0,NaN,NaN
8,0.000,Chicken,16-23,0,6,0,6,0.000,0.000
8,0.000,Chicken,23-5,8,8,0,16,50.000,50.000
8,0.000,Sea Lion,16-23,0,1,0,1,0.000,0.000
8,0.000,Sea Lion,23-5,1,11,0,12,8.333,8.333
8,0.000,Hu and Cw,16-23,6,14,0,20,30.000,30.000
8,0.000,Hu and Cw,23-5,3,11,0,14,21.429,21.429
8,0.000,Sheep,16-23,52,53,0,105,49.524,49.524
8,0.000,Sheep,23-5,61,44,0,105,58.095,58.095
8,0.000,Hu and Dg,16-23,9,16,0,25,36.000,36.000
8,0.000,Hu and Dg,23-5,20,17,0,37,54.054,54.054
8,0.000,Common Loon,16-23,0,0,0,0,NaN,NaN
8,0.000,Common Loon,23-5,0,4,0,4,0.000,0.000
8,0.000,Red-Winged Blackbird,16-23,0,4,0,4,0.000,0.000
8,0.000,Red-Winged Blackbird,23-5,0,2,0,2,0.000,0.000
8,0.000,Cw,16-23,12,10,0,22,54.545,54.545
8,0.000,Cw,23-5,17,42,0,59,28.814,28.814
8,0.000,Cliff Sparrow,16-23,3,19,0,22,13.636,13.636
8,0.000,Cliff Sparrow,23-5,0,8,0,8,0.000,0.000
8,0.000,Pig,16-23,8,9,0,17,47.059,47.059
8,0.000,Pig,23-5,5,8,0,13,38.462,38.462
8,0.000,Barn Owl,16-23,0,0,0,0,NaN,NaN
8,0.000,Barn Owl,23-5,0,0,0,0,NaN,NaN
8,0.000,Wild Pig,16-23,1,1,0,2,50.000,50.000
8,0.000,Wild Pig,23-5,2,2,0,4,50.000,50.000
8,0.000,Pennington Creek Water,16-23,0,0,0,0,NaN,NaN
8,0.000,Pennington Creek Water,23-5,0,0,0,0,NaN,NaN
8,0.000,Guinni,16-23,0,0,0,0,NaN,NaN
8,0.000,Guinni,23-5,0,0,0,0,NaN,NaN
8,0.000,Racoon,16-23,0,0,0,0,NaN,NaN
8,0.000,Racoon,23-5,0,0,0,0,NaN,NaN
8,0.000,Hu,16-23,15,17,0,32,46.875,46.875
8,0.000,Hu,23-5,22,16,0,38,57.895,57.895
8,0.000,Cw and Dg,16-23,9,17,0,26,34.615,34.615
8,0.000,Cw and Dg,23-5,15,19,0,34,44.118,44.118
8,0.000,Red Wind Blackbird,16-23,0,0,0,0,NaN,NaN
8,0.000,Red Wind Blackbird,23-5,0,0,0,0,NaN,NaN
8,0.000,Tree Swallow,16-23,0,0,0,0,NaN,NaN
8,0.000,Tree Swallow,23-5,0,0,0,0,NaN,NaN
8,0.000,Turkey Vulture,16-23,0,0,0,0,NaN,NaN
8,0.000,Turkey Vulture,23-5,0,0,0,0,NaN,NaN
8,0.000,Dg,16-23,6,11,0,17,35.294,35.294
8,0.000,Dg,23-5,31,31,0,62,50.000,50.000
8,0.000,Western Kingbird,16-23,0,0,0,0,NaN,NaN
8,0.000,Western Kingbird,23-5,0,0,0,0,NaN,NaN
8,0.000,White Crowned Sparrow,16-23,0,6,0,6,0.000,0.000
8,0.000,White Crowned Sparrow,23-5,1,18,0,19,5.263,5.263
8,0.000,Eared Grebe,16-23,0,0,0,0,NaN,NaN
8,0.000,Eared Grebe,23-5,0,18,0,18,0.000,0.000
8,0.000,cougar,16-23,0,0,0,0,NaN,NaN
8,0.000,cougar,23-5,0,0,0,0,NaN,NaN
8,0.000,Ocean Water,16-23,0,0,0,0,NaN,NaN
8,0.000,Ocean Water,23-5,0,0,0,0,NaN,NaN
8,0.000,Red Tailed Hawk,16-23,0,2,0,2,0.000,0.000
8,0.000,Red Tailed Hawk,23-5,0,5,0,5,0.000,0.000
8,0.000,Dog,16-23,58,71,0,129,44.961,44.961
8,0.000,Dog,23-5,102,142,0,244,41.803,41.803
8,0.000,Human,16-23,1734,724,0,2458,70.545,70.545
8,0.000,Human,23-5,2163,609,0,2772,78.030,78.030
8,0.000,Wild Turkey,16-23,4,15,0,19,21.053,21.053
8,0.000,Wild Turkey,23-5,0,20,0,20,0.000,0.000
8,0.000,Clark Grebe,16-23,0,0,0,0,NaN,NaN
8,0.000,Clark Grebe,23-5,0,0,0,0,NaN,NaN
8,0.000,Seagull,16-23,0,0,0,0,NaN,NaN
8,0.000,Seagull,23-5,6,7,0,13,46.154,46.154
8,0.000,Surf Scoter,16-23,0,0,0,0,NaN,NaN
8,0.000,Surf Scoter,23-5,0,0,0,0,NaN,NaN
8,0.000,Pigeon,16-23,63,161,0,224,28.125,28.125
8,0.000,Pigeon,23-5,95,210,0,305,31.148,31.148
8,0.000,Pacific Ocean Water,16-23,0,0,0,0,NaN,NaN
8,0.000,Pacific Ocean Water,23-5,0,0,0,0,NaN,NaN
8,0.000,Cat,16-23,20,32,0,52,38.462,38.462
8,0.000,Cat,23-5,23,35,0,58,39.655,39.655
8,0.000,Horse,16-23,7,24,0,31,22.581,22.581
8,0.000,Horse,23-5,34,163,0,197,17.259,17.259
8,0.000,orangutan,16-23,0,0,0,0,NaN,NaN
8,0.000,orangutan,23-5,0,0,0,0,NaN,NaN
8,0.000,Bat,16-23,36,23,0,59,61.017,61.017
8,0.000,Bat,23-5,37,29,0,66,56.061,56.061
8,0.000,Deer,16-23,16,35,0,51,31.373,31.373
8,0.000,Deer,23-5,18,104,0,122,14.754,14.754
8,0.000,Great Horned Owl,16-23,0,0,0,0,NaN,NaN
8,0.000,Great Horned Owl,23-5,0,4,0,4,0.000,0.000
8,0.000,Freshwater Lagoon,16-23,0,0,0,0,NaN,NaN
8,0.000,Freshwater Lagoon,23-5,0,0,0,0,NaN,NaN
8,0.000,Unknown Avian,16-23,0,0,0,0,NaN,NaN
8,0.000,Unknown Avian,23-5,0,0,0,0,NaN,NaN
8,0.000,Human UTI,16-23,78,71,0,149,52.349,52.349
8,0.000,Human UTI,23-5,102,94,0,196,52.041,52.041
8,0.000,unknown,16-23,0,0,0,0,NaN,NaN
8,0.000,unknown,23-5,3,2,0,5,60.000,60.000
8,0.000,SLO Creek Water,16-23,0,0,0,0,NaN,NaN
8,0.000,SLO Creek Water,23-5,0,0,0,0,NaN,NaN
8,0.000,Pig/Swine,16-23,10,7,0,17,58.824,58.824
8,0.000,Pig/Swine,23-5,10,9,0,19,52.632,52.632
8,0.000,Klebsiella,16-23,0,0,0,0,NaN,NaN
8,0.000,Klebsiella,23-5,0,0,0,0,NaN,NaN
8,0.000,Hu Cw and Dg,16-23,12,17,0,29,41.379,41.379
8,0.000,Hu Cw and Dg,23-5,15,24,0,39,38.462,38.462
8,0.000,Ground Squirrel,16-23,95,66,0,161,59.006,59.006
8,0.000,Ground Squirrel,23-5,88,90,0,178,49.438,49.438
8,0.000,Opossum,16-23,0,1,0,1,0.000,0.000
8,0.000,Opossum,23-5,0,0,0,0,NaN,NaN
8,0.000,Cow,16-23,1554,1107,0,2661,58.399,58.399
8,0.000,Cow,23-5,1501,1421,0,2922,51.369,51.369
8,0.000,Deer Mouse,16-23,0,0,0,0,NaN,NaN
8,0.000,Deer Mouse,23-5,0,0,0,0,NaN,NaN
8,0.000,OVERALL,16-23,3808,2540,0,6348,59.987,59.987
8,0.000,OVERALL,23-5,4383,3227,0,7610,57.595,57.595
8,0.500,Chicken,16-23,0,6,0,6,0.000,0.000
8,0.500,Chicken,23-5,8,8,0,16,50.000,50.000
8,0.500,Sea Lion,16-23,0,1,0,1,0.000,0.000
8,0.500,Sea Lion,23-5,1,11,0,12,8.333,8.333
8,0.500,Hu and Cw,16-23,6,14,0,20,30.000,30.000
8,0.500,Hu and Cw,23-5,3,11,0,14,21.429,21.429
8,0.500,Sheep,16-23,52,53,0,105,49.524,49.524
8,0.500,Sheep,23-5,61,44,0,105,58.095,58.095
8,0.500,Hu and Dg,16-23,9,16,0,25,36.000,36.000
8,0.500,Hu and Dg,23-5,20,17,0,37,54.054,54.054
8,0.500,Common Loon,16-23,0,0,0,0,NaN,NaN
8,0.500,Common Loon,23-5,0,4,0,4,0.000,0.000
8,0.500,Red-Winged Blackbird,16-23,0,4,0,4,0.000,0.000
8,0.500,Red-Winged Blackbird,23-5,0,2,0,2,0.000,0.000
8,0.500,Cw,16-23,12,10,0,22,54.545,54.545
8,0.500,Cw,23-5,17,42,0,59,28.814,28.814
8,0.500,Cliff Sparrow,16-23,3,19,0,22,13.636,13.636
8,0.500,Cliff Sparrow,23-5,0,8,0,8,0.000,0.000
8,0.500,Pig,16-23,8,9,0,17,47.059,47.059
8,0.500,Pig,23-5,5,8,0,13,38.462,38.462
8,0.500,Barn Owl,16-23,0,0,0,0,NaN,NaN
8,0.500,Barn Owl,23-5,0,0,0,0,NaN,NaN
8,0.500,Wild Pig,16-23,1,1,0,2,50.000,50.000
8,0.500,Wild Pig,23-5,2,2,0,4,50.000,50.000
8,0.500,Pennington Creek Water,16-23,0,0,0,0,NaN,NaN
8,0.500,Pennington Creek Water,23-5,0,0,0,0,NaN,NaN
8,0.500,Guinni,16-23,0,0,0,0,NaN,NaN
8,0.500,Guinni,23-5,0,0,0,0,NaN,NaN
8,0.500,Racoon,16-23,0,0,0,0,NaN,NaN
8,0.500,Racoon,23-5,0,0,0,0,NaN,NaN
8,0.500,Hu,16-23,15,17,0,32,46.875,46.875
8,0.500,Hu,23-5,22,16,0,38,57.895,57.895
8,0.500,Cw and Dg,16-23,9,17,0,26,34.615,34.615
8,0.500,Cw and Dg,23-5,15,19,0,34,44.118,44.118
8,0.500,Red Wind Blackbird,16-23,0,0,0,0,NaN,NaN
8,0.500,Red Wind Blackbird,23-5,0,0,0,0,NaN,NaN
8,0.500,Tree Swallow,16-23,0,0,0,0,NaN,NaN
8,0.500,Tree Swallow,23-5,0,0,0,0,NaN,NaN
8,0.500,Turkey Vulture,16-23,0,0,0,0,NaN,NaN
8,0.500,Turkey Vulture,23-5,0,0,0,0,NaN,NaN
8,0.500,Dg,16-23,6,11,0,17,35.294,35.294
8,0.500,Dg,23-5,31,31,0,62,50.000,50.000
8,0.500,Western Kingbird,16-23,0,0,0,0,NaN,NaN
8,0.500,Western Kingbird,23-5,0,0,0,0,NaN,NaN
8,0.500,White Crowned Sparrow,16-23,0,6,0,6,0.000,0.000
8,0.500,White Crowned Sparrow,23-5,1,18,0,19,5.263,5.263
8,0.500,Eared Grebe,16-23,0,0,0,0,NaN,NaN
8,0.500,Eared Grebe,23-5,0,18,0,18,0.000,0.000
8,0.500,cougar,16-23,0,0,0,0,NaN,NaN
8,0.500,cougar,23-5,0,0,0,0,NaN,NaN
8,0.500,Ocean Water,16-23,0,0,0,0,NaN,NaN
8,0.500,Ocean Water,23-5,0,0,0,0,NaN,NaN
8,0.500,Red Tailed Hawk,16-23,0,2,0,2,0.000,0.000
8,0.500,Red Tailed Hawk,23-5,0,5,0,5,0.000,0.000
8,0.500,Dog,16-23,58,71,0,129,44.961,44.961
8,0.500,Dog,23-5,102,142,0,244,41.803,41.803
8,0.500,Human,16-23,1734,724,0,2458,70.545,70.545
8,0.500,Human,23-5,2163,609,0,2772,78.030,78.030
8,0.500,Wild Turkey,16-23,4,15,0,19,21.053,21.053
8,0.500,Wild Turkey,23-5,0,20,0,20,0.000,0.000
8,0.500,Clark Grebe,16-23,0,0,0,0,NaN,NaN
8,0.500,Clark Grebe,23-5,0,0,0,0,NaN,NaN
8,0.500,Seagull,16-23,0,0,0,0,NaN,NaN
8,0.500,Seagull,23-5,6,7,0,13,46.154,46.154
8,0.500,Surf Scoter,16-23,0,0,0,0,NaN,NaN
8,0.500,Surf Scoter,23-5,0,0,0,0,NaN,NaN
8,0.500,Pigeon,16-23,63,161,0,224,28.125,28.125
8,0.500,Pigeon,23-5,95,210,0,305,31.148,31.148
8,0.500,Pacific Ocean Water,16-23,0,0,0,0,NaN,NaN
8,0.500,Pacific Ocean Water,23-5,0,0,0,0,NaN,NaN
8,0.500,Cat,16-23,20,32,0,52,38.462,38.462
8,0.500,Cat,23-5,23,35,0,58,39.655,39.655
8,0.500,Horse,16-23,7,24,0,31,22.581,22.581
8,0.500,Horse,23-5,34,163,0,197,17.259,17.259
8,0.500,orangutan,16-23,0,0,0,0,NaN,NaN
8,0.500,orangutan,23-5,0,0,0,0,NaN,NaN
8,0.500,Bat,16-23,36,23,0,59,61.017,61.017
8,0.500,Bat,23-5,37,29,0,66,56.061,56.061
8,0.500,Deer,16-23,16,35,0,51,31.373,31.373
8,0.500,Deer,23-5,18,104,0,122,14.754,14.754
8,0.500,Great Horned Owl,16-23,0,0,0,0,NaN,NaN
8,0.500,Great Horned Owl,23-5,0,4,0,4,0.000,0.000
8,0.500,Freshwater Lagoon,16-23,0,0,0,0,NaN,NaN
8,0.500,Freshwater Lagoon,23-5,0,0,0,0,NaN,NaN
8,0.500,Unknown Avian,16-23,0,0,0,0,NaN,NaN
8,0.500,Unknown Avian,23-5,0,0,0,0,NaN,NaN
8,0.500,Human UTI,16-23,78,71,0,149,52.349,52.349
8,0.500,Human UTI,23-5,102,94,0,196,52.041,52.041
8,0.500,unknown,16-23,0,0,0,0,NaN,NaN
8,0.500,unknown,23-5,3,2,0,5,60.000,60.000
8,0.500,SLO Creek Water,16-23,0,0,0,0,NaN,NaN
8,0.500,SLO Creek Water,23-5,0,0,0,0,NaN,NaN
8,0.500,Pig/Swine,16-23,10,7,0,17,58.824,58.824
8,0.500,Pig/Swine,23-5,10,9,0,19,52.632,52.632
8,0.500,Klebsiella,16-23,0,0,0,0,NaN,NaN
8,0.500,Klebsiella,23-5,0,0,0,0,NaN,NaN
8,0.500,Hu Cw and Dg,16-23,12,17,0,29,41.379,41.379
8,0.500,Hu Cw and Dg,23-5,15,24,0,39,38.462,38.462
8,0.500,Ground Squirrel,16-23,95,66,0,161,59.006,59.006
8,0.500,Ground Squirrel,23-5,88,90,0,178,49.438,49.438
8,0.500,Opossum,16-23,0,1,0,1,0.000,0.000
8,0.500,Opossum,23-5,0,0,0,0,NaN,NaN
8,0.500,Cow,16-23,1554,1107,0,2661,58.399,58.399
8,0.500,Cow,23-5,1501,1421,0,2922,51.369,51.369
8,0.500,Deer Mouse,16-23,0,0,0,0,NaN,NaN
8,0.500,Deer Mouse,23-5,0,0,0,0,NaN,NaN
8,0.500,OVERALL,16-23,3808,2540,0,6348,59.987,59.987
8,0.500,OVERALL,23-5,4383,3227,0,7610,57.595,57.595
8,0.900,Chicken,16-23,0,6,0,6,0.000,0.000
8,0.900,Chicken,23-5,8,8,0,16,50.000,50.000
8,0.900,Sea Lion,16-23,0,1,0,1,0.000,0.000
8,0.900,Sea Lion,23-5,1,11,0,12,8.333,8.333
8,0.900,Hu and Cw,16-23,6,14,0,20,30.000,30.000
8,0.900,Hu and Cw,23-5,3,11,0,14,21.429,21.429
8,0.900,Sheep,16-23,52,53,0,105,49.524,49.524
8,0.900,Sheep,23-5,61,44,0,105,58.095,58.095
8,0.900,Hu and Dg,16-23,9,16,0,25,36.000,36.000
8,0.900,Hu and Dg,23-5,20,17,0,37,54.054,54.054
8,0.900,Common Loon,16-23,0,0,0,0,NaN,NaN
8,0.900,Common Loon,23-5,0,4,0,4,0.000,0.000
8,0.900,Red-Winged Blackbird,16-23,0,4,0,4,0.000,0.000
8,0.900,Red-Winged Blackbird,23-5,0,2,0,2,0.000,0.000
8,0.900,Cw,16-23,12,10,0,22,54.545,54.545
8,0.900,Cw,23-5,17,42,0,59,28.814,28.814
8,0.900,Cliff Sparrow,16-23,3,19,0,22,13.636,13.636
8,0.900,Cliff Sparrow,23-5,0,8,0,8,0.000,0.000
8,0.900,Pig,16-23,8,9,0,17,47.059,47.059
8,0.900,Pig,23-5,5,8,0,13,38.462,38.462
8,0.900,Barn Owl,16-23,0,0,0,0,NaN,NaN
8,0.900,Barn Owl,23-5,0,0,0,0,NaN,NaN
8,0.900,Wild Pig,16-23,1,1,0,2,50.000,50.000
8,0.900,Wild Pig,23-5,2,2,0,4,50.000,50.000
8,0.900,Pennington Creek Water,16-23,0,0,0,0,NaN,NaN
8,0.900,Pennington Creek Water,23-5,0,0,0,0,NaN,NaN
8,0.900,Guinni,16-23,0,0,0,0,NaN,NaN
8,0.900,Guinni,23-5,0,0,0,0,NaN,NaN
8,0.900,Racoon,16-23,0,0,0,0,NaN,NaN
8,0.900,Racoon,23-5,0,0,0,0,NaN,NaN
8,0.900,Hu,16-23,15,17,0,32,46.875,46.875
8,0.900,Hu,23-5,22,16,0,38,57.895,57.895
8,0.900,Cw and Dg,16-23,9,17,0,26,34.615,34.615
8,0.900,Cw and Dg,23-5,15,19,0,34,44.118,44.118
8,0.900,Red Wind Blackbird,16-23,0,0,0,0,NaN,NaN
8,0.900,Red Wind Blackbird,23-5,0,0,0,0,NaN,NaN
8,0.900,Tree Swallow,16-23,0,0,0,0,NaN,NaN
8,0.900,Tree Swallow,23-5,0,0,0,0,NaN,NaN
8,0.900,Turkey Vulture,16-23,0,0,0,0,NaN,NaN
8,0.900,Turkey Vulture,23-5,0,0,0,0,NaN,NaN
8,0.900,Dg,16-23,6,11,0,17,35.294,35.294
8,0.900,Dg,23-5,31,31,0,62,50.000,50.000
8,0.900,Western Kingbird,16-23,0,0,0,0,NaN,NaN
8,0.900,Western Kingbird,23-5,0,0,0,0,NaN,NaN
8,0.900,White Crowned Sparrow,16-23,0,6,0,6,0.000,0.000
8,0.900,White Crowned Sparrow,23-5,1,18,0,19,5.263,5.263
8,0.900,Eared Grebe,16-23,0,0,0,0,NaN,NaN
8,0.900,Eared Grebe,23-5,0,18,0,18,0.000,0.000
8,0.900,cougar,16-23,0,0,0,0,NaN,NaN
8,0.900,cougar,23-5,0,0,0,0,NaN,NaN
8,0.900,Ocean Water,16-23,0,0,0,0,NaN,NaN
8,0.900,Ocean Water,23-5,0,0,0,0,NaN,NaN
8,0.900,Red Tailed Hawk,16-23,0,2,0,2,0.000,0.000
8,0.900,Red Tailed Hawk,23-5,0,5,0,5,0.000,0.000
8,0.900,Dog,16-23,58,71,0,129,44.961,44.961
8,0.900,Dog,23-5,102,137,0,239,42.678,42.678
8,0.900,Human,16-23,1734,723,0,2457,70.574,70.574
8,0.900,Human,23-5,2163,604,0,2767,78.171,78.171
8,0.900,Wild Turkey,16-23,4,15,0,19,21.053,21.053
8,0.900,Wild Turkey,23-5,0,20,0,20,0.000,0.000
8,0.900,Clark Grebe,16-23,0,0,0,0,NaN,NaN
8,0.900,Clark Grebe,23-5,0,0,0,0,NaN,NaN
8,0.900,Seagull,16-23,0,0,0,0,NaN,NaN
8,0.900,Seagull,23-5,6,8,0,14,42.857,42.857
8,0.900,Surf Scoter,16-23,0,0,0,0,NaN,NaN
8,0.900,Surf Scoter,23-5,0,0,0,0,NaN,NaN
8,0.900,Pigeon,16-23,63,161,0,224,28.125,28.125
8,0.900,Pigeon,23-5,95,210,0,305,31.148,31.148
8,0.900,Pacific Ocean Water,16-23,0,0,0,0,NaN,NaN
8,0.900,Pacific Ocean Water,23-5,0,0,0,0,NaN,NaN
8,0.900,Cat,16-23,20,32,0,52,38.462,38.462
8,0.900,Cat,23-5,23,35,0,58,39.655,39.655
8,0.900,Horse,16-23,7,24,0,31,22.581,22.581
8,0.900,Horse,23-5,34,163,0,197,17.259,17.259
8,0.900,orangutan,16-23,0,0,0,0,NaN,NaN
8,0.900,orangutan,23-5,0,0,0,0,NaN,NaN
8,0.900,Bat,16-23,36,23,0,59,61.017,61.017
8,0.900,Bat,23-5,37,29,0,66,56.061,56.061
8,0.900,Deer,16-23,16,35,0,51,31.373,31.373
8,0.900,Deer,23-5,18,104,0,122,14.754,14.754
8,0.900,Great Horned Owl,16-23,0,0,0,0,NaN,NaN
8,0.900,Great Horned Owl,23-5,0,4,0,4,0.000,0.000
8,0.900,Freshwater Lagoon,16-23,0,0,0,0,NaN,NaN
8,0.900,Freshwater Lagoon,23-5,0,0,0,0,NaN,NaN
8,0.900,Unknown Avian,16-23,0,0,0,0,NaN,NaN
8,0.900,Unknown Avian,23-5,0,0,0,0,NaN,NaN
8,0.900,Human UTI,16-23,78,71,0,149,52.349,52.349
8,0.900,Human UTI,23-5,105,94,0,199,52.764,52.764
8,0.900,unknown,16-23,0,0,0,0,NaN,NaN
8,0.900,unknown,23-5,3,2,0,5,60.000,60.000
8,0.900,SLO Creek Water,16-23,0,0,0,0,NaN,NaN
8,0.900,SLO Creek Water,23-5,0,0,0,0,NaN,NaN
8,0.900,Pig/Swine,16-23,10,7,0,17,58.824,58.824
8,0.900,Pig/Swine,23-5,10,9,0,19,52.632,52.632
8,0.900,Klebsiella,16-23,0,0,0,0,NaN,NaN
8,0.900,Klebsiella,23-5,0,0,0,0,NaN,NaN
8,0.900,Hu Cw and Dg,16-23,12,17,0,29,41.379,41.379
8,0.900,Hu Cw and Dg,23-5,15,24,0,39,38.462,38.462
8,0.900,Ground Squirrel,16-23,95,66,0,161,59.006,59.006
8,0.900,Ground Squirrel,23-5,88,90,0,178,49.438,49.438
8,0.900,Opossum,16-23,0,1,0,1,0.000,0.000
8,0.900,Opossum,23-5,0,0,0,0,NaN,NaN
8,0.900,Cow,16-23,1554,1104,0,2658,58.465,58.465
8,0.900,Cow,23-5,1501,1419,0,2920,51.404,51.404
8,0.900,Deer Mouse,16-23,0,0,0,0,NaN,NaN
8,0.900,Deer Mouse,23-5,0,0,0,0,NaN,NaN
8,0.900,OVERALL,16-23,3808,2536,0,6344,60.025,60.025
8,0.900,OVERALL,23-5,4386,3216,0,7602,57.695,57.695
8,0.950,Chicken,16-23,0,6,0,6,0.000,0.000
8,0.950,Chicken,23-5,8,8,0,16,50.000,50.000
8,0.950,Sea Lion,16-23,0,1,0,1,0.000,0.000
8,0.950,Sea Lion,23-5,1,11,0,12,8.333,8.333
8,0.950,Hu and Cw,16-23,6,14,0,20,30.000,30.000
8,0.950,Hu and Cw,23-5,3,11,0,14,21.429,21.429
8,0.950,Sheep,16-23,52,53,0,105,49.524,49.524
8,0.950,Sheep,23-5,61,44,0,105,58.095,58.095
8,0.950,Hu and Dg,16-23,9,16,0,25,36.000,36.000
8,0.950,Hu and Dg,23-5,20,17,0,37,54.054,54.054
8,0.950,Common Loon,16-23,0,0,0,0,NaN,NaN
8,0.950,Common Loon,23-5,0,4,0,4,0.000,0.000
8,0.950,Red-Winged Blackbird,16-23,0,4,0,4,0.000,0.000
8,0.950,Red-Winged Blackbird,23-5,0,2,0,2,0.000,0.000
8,0.950,Cw,16-23,12,10,0,22,54.545,54.545
8,0.950,Cw,23-5,17,42,0,59,28.814,28.814
8,0.950,Cliff Sparrow,16-23,3,19,0,22,13.636,13.636
8,0.950,Cliff Sparrow,23-5,0,8,0,8,0.000,0.000
8,0.950,Pig,16-23,8,9,0,17,47.059,47.059
8,0.950,Pig,23-5,5,8,0,13,38.462,38.462
8,0.950,Barn Owl,16-23,0,0,0,0,NaN,NaN
8,0.950,Barn Owl,23-5,0,0,0,0,NaN,NaN
8,0.950,Wild Pig,16-23,1,1,0,2,50.000,50.000
8,0.950,Wild Pig,23-5,2,2,0,4,50.000,50.000
8,0.950,Pennington Creek Water,16-23,0,0,0,0,NaN,NaN
8,0.950,Pennington Creek Water,23-5,0,0,0,0,NaN,NaN
8,0.950,Guinni,16-23,0,0,0,0,NaN,NaN
8,0.950,Guinni,23-5,0,0,0,0,NaN,NaN
8,0.950,Racoon,16-23,0,0,0,0,NaN,NaN
8,0.950,Racoon,23-5,0,0,0,0,NaN,NaN
8,0.950,Hu,16-23,15,17,0,32,46.875,46.875
8,0.950,Hu,23-5,22,16,0,38,57.895,57.895
8,0.950,Cw and Dg,16-23,9,17,0,26,34.615,34.615
8,0.950,Cw and Dg,23-5,15,19,0,34,44.118,44.118
8,0.950,Red Wind Blackbird,16-23,0,0,0,0,NaN,NaN
8,0.950,Red Wind Blackbird,23-5,0,0,0,0,NaN,NaN
8,0.950,Tree Swallow,16-23,0,0,0,0,NaN,NaN
8,0.950,Tree Swallow,23-5,0,0,0,0,NaN,NaN
8,0.950,Turkey Vulture,16-23,0,0,0,0,NaN,NaN
8,0.950,Turkey Vulture,23-5,0,0,0,0,NaN,NaN
8,0.950,Dg,16-23,6,11,0,17,35.294,35.294
8,0.950,Dg,23-5,31,31,0,62,50.000,50.000
8,0.950,Western Kingbird,16-23,0,0,0,0,NaN,NaN
8,0.950,Western Kingbird,23-5,0,0,0,0,NaN,NaN
8,0.950,White Crowned Sparrow,16-23,0,6,0,6,0.000,0.000
8,0.950,White Crowned Sparrow,23-5,1,18,0,19,5.263,5.263
8,0.950,Eared Grebe,16-23,0,0,0,0,NaN,NaN
8,0.950,Eared Grebe,23-5,0,18,0,18,0.000,0.000
8,0.950,cougar,16-23,0,0,0,0,NaN,NaN
8,0.950,cougar,23-5,0,0,0,0,NaN,NaN
8,0.950,Ocean Water,16-23,0,0,0,0,NaN,NaN
8,0.950,Ocean Water,23-5,0,0,0,0,NaN,NaN
8,0.950,Red Tailed Hawk,16-23,0,2,0,2,0.000,0.000
8,0.950,Red Tailed Hawk,23-5,0,5,0,5,0.000,0.000
8,0.950,Dog,16-23,58,71,0,129,44.961,44.961
8,0.950,Dog,23-5,102,135,0,237,43.038,43.038
8,0.950,Human,16-23,1734,722,0,2456,70.603,70.603
8,0.950,Human,23-5,2163,598,0,2761,78.341,78.341
8,0.950,Wild Turkey,16-23,4,15,0,19,21.053,21.053
8,0.950,Wild Turkey,23-5,0,20,0,20,0.000,0.000
8,0.950,Clark Grebe,16-23,0,0,0,0,NaN,NaN
8,0.950,Clark Grebe,23-5,0,0,0,0,NaN,NaN
8,0.950,Seagull,16-23,0,0,0,0,NaN,NaN
8,0.950,Seagull,23-5,6,7,0,13,46.154,46.154
8,0.950,Surf Scoter,16-23,0,0,0,0,NaN,NaN
8,0.950,Surf Scoter,23-5,0,0,0,0,NaN,NaN
8,0.950,Pigeon,16-23,64,161,0,225,28.444,28.444
8,0.950,Pigeon,23-5,95,211,0,306,31.046,31.046
8,0.950,Pacific Ocean Water,16-23,0,0,0,0,NaN,NaN
8,0.950,Pacific Ocean Water,23-5,0,0,0,0,NaN,NaN
8,0.950,Cat,16-23,20,32,0,52,38.462,38.462
8,0.950,Cat,23-5,23,35,0,58,39.655,39.655
8,0.950,Horse,16-23,7,24,0,31,22.581,22.581
8,0.950,Horse,23-5,34,163,0,197,17.259,17.259
8,0.950,orangutan,16-23,0,0,0,0,NaN,NaN
8,0.950,orangutan,23-5,0,0,0,0,NaN,NaN
8,0.950,Bat,16-23,36,23,0,59,61.017,61.017
8,0.950,Bat,23-5,37,28,0,65,56.923,56.923
8,0.950,Deer,16-23,16,35,0,51,31.373,31.373
8,0.950,Deer,23-5,18,104,0,122,14.754,14.754
8,0.950,Great Horned Owl,16-23,0,0,0,0,NaN,NaN
8,0.950,Great Horned Owl,23-5,0,4,0,4,0.000,0.000
8,0.950,Freshwater Lagoon,16-23,0,0,0,0,NaN,NaN
8,0.950,Freshwater Lagoon,23-5,0,0,0,0,NaN,NaN
8,0.950,Unknown Avian,16-23,0,0,0,0,NaN,NaN
8,0.950,Unknown Avian,23-5,0,0,0,0,NaN,NaN
8,0.950,Human UTI,16-23,81,71,0,152,53.289,53.289
8,0.950,Human UTI,23-5,104,96,0,200,52.000,52.000
8,0.950,unknown,16-23,0,0,0,0,NaN,NaN
8,0.950,unknown,23-5,3,2,0,5,60.000,60.000
8,0.950,SLO Creek Water,16-23,0,0,0,0,NaN,NaN
8,0.950,SLO Creek Water,23-5,0,0,0,0,NaN,NaN
8,0.950,Pig/Swine,16-23,10,7,0,17,58.824,58.824
8,0.950,Pig/Swine,23-5,10,9,0,19,52.632,52.632
8,0.950,Klebsiella,16-23,0,0,0,0,NaN,NaN
8,0.950,Klebsiella,23-5,0,0,0,0,NaN,NaN
8,0.950,Hu Cw and Dg,16-23,12,17,0,29,41.379,41.379
8,0.950,Hu Cw and Dg,23-5,15,24,0,39,38.462,38.462
8,0.950,Ground Squirrel,16-23,95,66,0,161,59.006,59.006
8,0.950,Ground Squirrel,23-5,88,88,0,176,50.000,50.000
8,0.950,Opossum,16-23,0,1,0,1,0.000,0.000
8,0.950,Opossum,23-5,0,0,0,0,NaN,NaN
8,0.950,Cow,16-23,1554,1084,0,2638,58.908,58.908
8,0.950,Cow,23-5,1500,1416,0,2916,51.440,51.440
8,0.950,Deer Mouse,16-23,0,0,0,0,NaN,NaN
8,0.950,Deer Mouse,23-5,0,0,0,0,NaN,NaN
8,0.950,OVERALL,16-23,3812,2515,0,6327,60.250,60.250
8,0.950,OVERALL,23-5,4384,3204,0,7588,57.775,57.775
8,0.960,Chicken,16-23,0,6,0,6,0.000,0.000
8,0.960,Chicken,23-5,8,8,0,16,50.000,50.000
8,0.960,Sea Lion,16-23,0,1,0,1,0.000,0.000
8,0.960,Sea Lion,23-5,1,11,0,12,8.333,8.333
8,0.960,Hu and Cw,16-23,6,14,0,20,30.000,30.000
8,0.960,Hu and Cw,23-5,3,11,0,14,21.429,21.429
8,0.960,Sheep,16-23,52,53,0,105,49.524,49.524
8,0.960,Sheep,23-5,61,45,0,106,57.547,57.547
8,0.960,Hu and Dg,16-23,9,16,0,25,36.000,36.000
8,0.960,Hu and Dg,23-5,20,17,0,37,54.054,54.054
8,0.960,Common Loon,16-23,0,0,0,0,NaN,NaN
8,0.960,Common Loon,23-5,0,4,0,4,0.000,0.000
8,0.960,Red-Winged Blackbird,16-23,0,4,0,4,0.000,0.000
8,0.960,Red-Winged Blackbird,23-5,0,2,0,2,0.000,0.000
8,0.960,Cw,16-23,12,10,0,22,54.545,54.545
8,0.960,Cw,23-5,17,42,0,59,28.814,28.814
8,0.960,Cliff Sparrow,16-23,3,19,0,22,13.636,13.636
8,0.960,Cliff Sparrow,23-5,0,8,0,8,0.000,0.000
8,0.960,Pig,16-23,8,9,0,17,47.059,47.059
8,0.960,Pig,23-5,5,8,0,13,38.462,38.462
8,0.960,Barn Owl,16-23,0,0,0,0,NaN,NaN
8,0.960,Barn Owl,23-5,0,0,0,0,NaN,NaN
8,0.960,Wild Pig,16-23,1,1,0,2,50.000,50.000
8,0.960,Wild Pig,23-5,2,2,0,4,50.000,50.000
8,0.960,Pennington Creek Water,16-23,0,0,0,0,NaN,NaN
8,0.960,Pennington Creek Water,23-5,0,0,0,0,NaN,NaN
8,0.960,Guinni,16-23,0,0,0,0,NaN,NaN
8,0.960,Guinni,23-5,0,0,0,0,NaN,NaN
8,0.960,Racoon,16-23,0,0,0,0,NaN,NaN
8,0.960,Racoon,23-5,0,0,0,0,NaN,NaN
8,0.960,Hu,16-23,15,17,0,32,46.875,46.875
8,0.960,Hu,23-5,22,16,0,38,57.895,57.895
8,0.960,Cw and Dg,16-23,9,17,0,26,34.615,34.615
8,0.960,Cw and Dg,23-5,15,19,0,34,44.118,44.118
8,0.960,Red Wind Blackbird,16-23,0,0,0,0,NaN,NaN
8,0.960,Red Wind Blackbird,23-5,0,0,0,0,NaN,NaN
8,0.960,Tree Swallow,16-23,0,0,0,0,NaN,NaN
8,0.960,Tree Swallow,23-5,0,0,0,0,NaN,NaN
8,0.960,Turkey Vulture,16-23,0,0,0,0,NaN,NaN
8,0.960,Turkey Vulture,23-5,0,0,0,0,NaN,NaN
8,0.960,Dg,16-23,6,11,0,17,35.294,35.294
8,0.960,Dg,23-5,31,31,0,62,50.000,50.000
8,0.960,Western Kingbird,16-23,0,0,0,0,NaN,NaN
8,0.960,Western Kingbird,23-5,0,0,0,0,NaN,NaN
8,0.960,White Crowned Sparrow,16-23,0,6,0,6,0.000,0.000
8,0.960,White Crowned Sparrow,23-5,1,18,0,19,5.263,5.263
8,0.960,Eared Grebe,16-23,0,0,0,0,NaN,NaN
8,0.960,Eared Grebe,23-5,0,18,0,18,0.000,0.000
8,0.960,cougar,16-23,0,0,0,0,NaN,NaN
8,0.960,cougar,23-5,0,0,0,0,NaN,NaN
8,0.960,Ocean Water,16-23,0,0,0,0,NaN,NaN
8,0.960,Ocean Water,23-5,0,0,0,0,NaN,NaN
8,0.960,Red Tailed Hawk,16-23,0,2,0,2,0.000,0.000
8,0.960,Red Tailed Hawk,23-5,0,5,0,5,0.000,0.000
8,0.960,Dog,16-23,58,71,0,129,44.961,44.961
8,0.960,Dog,23-5,102,131,0,233,43.777,43.777
8,0.960,Human,16-23,1735,721,0,2456,70.643,70.643
8,0.960,Human,23-5,2168,585,0,2753,78.750,78.750
8,0.960,Wild Turkey,16-23,4,15,0,19,21.053,21.053
8,0.960,Wild Turkey,23-5,0,24,0,24,0.000,0.000
8,0.960,Clark Grebe,16-23,0,0,0,0,NaN,NaN
8,0.960,Clark Grebe,23-5,0,0,0,0,NaN,NaN
8,0.960,Seagull,16-23,0,0,0,0,NaN,NaN
8,0.960,Seagull,23-5,6,8,0,14,42.857,42.857
8,0.960,Surf Scoter,16-23,0,0,0,0,NaN,NaN
8,0.960,Surf Scoter,23-5,0,2,0,2,0.000,0.000
8,0.960,Pigeon,16-23,62,161,0,223,27.803,27.803
8,0.960,Pigeon,23-5,96,224,0,320,30.000,30.000
8,0.960,Pacific Ocean Water,16-23,0,0,0,0,NaN,NaN
8,0.960,Pacific Ocean Water,23-5,0,0,0,0,NaN,NaN
8,0.960,Cat,16-23,20,32,0,52,38.462,38.462
8,0.960,Cat,23-5,23,35,0,58,39.655,39.655
8,0.960,Horse,16-23,7,24,0,31,22.581,22.581
8,0.960,Horse,23-5,34,163,0,197,17.259,17.259
8,0.960,orangutan,16-23,0,0,0,0,NaN,NaN
8,0.960,orangutan,23-5,0,0,0,0,NaN,NaN
8,0.960,Bat,16-23,36,23,0,59,61.017,61.017
8,0.960,Bat,23-5,37,28,0,65,56.923,56.923
8,0.960,Deer,16-23,16,35,0,51,31.373,31.373
8,0.960,Deer,23-5,18,104,0,122,14.754,14.754
8,0.960,Great Horned Owl,16-23,0,0,0,0,NaN,NaN
8,0.960,Great Horned Owl,23-5,0,4,0,4,0.000,0.000
8,0.960,Freshwater Lagoon,16-23,0,0,0,0,NaN,NaN
8,0.960,Freshwater Lagoon,23-5,0,0,0,0,NaN,NaN
8,0.960,Unknown Avian,16-23,0,0,0,0,NaN,NaN
8,0.960,Unknown Avian,23-5,0,0,0,0,NaN,NaN
8,0.960,Human UTI,16-23,81,72,0,153,52.941,52.941
8,0.960,Human UTI,23-5,104,95,0,199,52.261,52.261
8,0.960,unknown,16-23,0,0,0,0,NaN,NaN
8,0.960,unknown,23-5,3,2,0,5,60.000,60.000
8,0.960,SLO Creek Water,16-23,0,0,0,0,NaN,NaN
8,0.960,SLO Creek Water,23-5,0,0,0,0,NaN,NaN
8,0.960,Pig/Swine,16-23,10,7,0,17,58.824,58.824
8,0.960,Pig/Swine,23-5,10,9,0,19,52.632,52.632
8,0.960,Klebsiella,16-23,0,0,0,0,NaN,NaN
8,0.960,Klebsiella,23-5,0,0,0,0,NaN,NaN
8,0.960,Hu Cw and Dg,16-23,12,17,0,29,41.379,41.379
8,0.960,Hu Cw and Dg,23-5,15,24,0,39,38.462,38.462
8,0.960,Ground Squirrel,16-23,95,66,0,161,59.006,59.006
8,0.960,Ground Squirrel,23-5,88,90,0,178,49.438,49.438
8,0.960,Opossum,16-23,0,1,0,1,0.000,0.000
8,0.960,Opossum,23-5,0,0,0,0,NaN,NaN
8,0.960,Cow,16-23,1552,1076,0,2628,59.056,59.056
8,0.960,Cow,23-5,1500,1394,0,2894,51.831,51.831
8,0.960,Deer Mouse,16-23,0,0,0,0,NaN,NaN
8,0.960,Deer Mouse,23-5,0,0,0,0,NaN,NaN
8,0.960,OVERALL,16-23,3809,2507,0,6316,60.307,60.307
8,0.960,OVERALL,23-5,4390,3187,0,7577,57.938,57.938
8,0.970,Chicken,16-23,0,6,0,6,0.000,0.000
8,0.970,Chicken,23-5,8,8,0,16,50.000,50.000
8,0.970,Sea Lion,16-23,0,1,0,1,0.000,0.000
8,0.970,Sea Lion,23-5,1,11,0,12,8.333,8.333
8,0.970,Hu and Cw,16-23,6,14,0,20,30.000,30.000
8,0.970,Hu and Cw,23-5,3,11,0,14,21.429,21.429
8,0.970,Sheep,16-23,52,54,0,106,49.057,49.057
8,0.970,Sheep,23-5,61,44,0,105,58.095,58.095
8,0.970,Hu and Dg,16-23,9,16,0,25,36.000,36.000
8,0.970,Hu and Dg,23-5,20,17,0,37,54.054,54.054
8,0.970,Common Loon,16-23,0,0,0,0,NaN,NaN
8,0.970,Common Loon,23-5,0,4,0,4,0.000,0.000
8,0.970,Red-Winged Blackbird,16-23,0,4,0,4,0.000,0.000
8,0.970,Red-Winged Blackbird,23-5,0,2,0,2,0.000,0.000
8,0.970,Cw,16-23,12,11,0,23,52.174,52.174
8,0.970,Cw,23-5,17,42,0,59,28.814,28.814
8,0.970,Cliff Sparrow,16-23,3,19,0,22,13.636,13.636
8,0.970,Cliff Sparrow,23-5,0,8,0,8,0.000,0.000
8,0.970,Pig,16-23,8,9,0,17,47.059,47.059
8,0.970,Pig,23-5,5,8,0,13,38.462,38.462
8,0.970,Barn Owl,16-23,0,0,0,0,NaN,NaN
8,0.970,Barn Owl,23-5,0,0,0,0,NaN,NaN
8,0.970,Wild Pig,16-23,1,1,0,2,50.000,50.000
8,0.970,Wild Pig,23-5,1,2,0,3,33.333,33.333
8,0.970,Pennington Creek Water,16-23,0,0,0,0,NaN,NaN
8,0.970,Pennington Creek Water,23-5,0,0,0,0,NaN,NaN
8,0.970,Guinni,16-23,0,0,0,0,NaN,NaN
8,0.970,Guinni,23-5,0,0,0,0,NaN,NaN
8,0.970,Racoon,16-23,0,0,0,0,NaN,NaN
8,0.970,Racoon,23-5,0,0,0,0,NaN,NaN
8,0.970,Hu,16-23,15,17,0,32,46.875,46.875
8,0.970,Hu,23-5,22,16,0,38,57.895,57.895
8,0.970,Cw and Dg,16-23,9,17,0,26,34.615,34.615
8,0.970,Cw and Dg,23-5,15,19,0,34,44.118,44.118
8,0.970,Red Wind Blackbird,16-23,0,0,0,0,NaN,NaN
8,0.970,Red Wind Blackbird,23-5,0,0,0,0,NaN,NaN
8,0.970,Tree Swallow,16-23,0,0,0,0,NaN,NaN
8,0.970,Tree Swallow,23-5,0,0,0,0,NaN,NaN
8,0.970,Turkey Vulture,16-23,0,0,0,0,NaN,NaN
8,0.970,Turkey Vulture,23-5,0,0,0,0,NaN,NaN
8,0.970,Dg,16-23,6,11,0,17,35.294,35.294
8,0.970,Dg,23-5,31,30,0,61,50.820,50.820
8,0.970,Western Kingbird,16-23,0,0,0,0,NaN,NaN
8,0.970,Western Kingbird,23-5,0,0,0,0,NaN,NaN
8,0.970,White Crowned Sparrow,16-23,0,6,0,6,0.000,0.000
8,0.970,White Crowned Sparrow,23-5,1,18,0,19,5.263,5.263
8,0.970,Eared Grebe,16-23,0,0,0,0,NaN,NaN
8,0.970,Eared Grebe,23-5,0,18,0,18,0.000,0.000
8,0.970,cougar,16-23,0,0,0,0,NaN,NaN
8,0.970,cougar,23-5,0,0,0,0,NaN,NaN
8,0.970,Ocean Water,16-23,0,0,0,0,NaN,NaN
8,0.970,Ocean Water,23-5,0,0,0,0,NaN,NaN
8,0.970,Red Tailed Hawk,16-23,0,2,0,2,0.000,0.000
8,0.970,Red Tailed Hawk,23-5,0,5,0,5,0.000,0.000
8,0.970,Dog,16-23,58,71,0,129,44.961,44.961
8,0.970,Dog,23-5,102,130,0,232,43.966,43.966
8,0.970,Human,16-23,1736,721,0,2457,70.655,70.655
8,0.970,Human,23-5,2164,584,0,2748,78.748,78.748
8,0.970,Wild Turkey,16-23,4,17,0,21,19.048,19.048
8,0.970,Wild Turkey,23-5,2,23,0,25,8.000,8.000
8,0.970,Clark Grebe,16-23,0,0,0,0,NaN,NaN
8,0.970,Clark Grebe,23-5,0,0,0,0,NaN,NaN
8,0.970,Seagull,16-23,0,0,0,0,NaN,NaN
8,0.970,Seagull,23-5,6,9,0,15,40.000,40.000
8,0.970,Surf Scoter,16-23,0,0,0,0,NaN,NaN
8,0.970,Surf Scoter,23-5,0,2,0,2,0.000,0.000
8,0.970,Pigeon,16-23,60,160,0,220,27.273,27.273
8,0.970,Pigeon,23-5,96,242,0,338,28.402,28.402
8,0.970,Pacific Ocean Water,16-23,0,0,0,0,NaN,NaN
8,0.970,Pacific Ocean Water,23-5,0,0,0,0,NaN,NaN
8,0.970,Cat,16-23,20,32,0,52,38.462,38.462
8,0.970,Cat,23-5,23,35,0,58,39.655,39.655
8,0.970,Horse,16-23,7,24,0,31,22.581,22.581
8,0.970,Horse,23-5,34,163,0,197,17.259,17.259
8,0.970,orangutan,16-23,0,0,0,0,NaN,NaN
8,0.970,orangutan,23-5,0,0,0,0,NaN,NaN
8,0.970,Bat,16-23,36,23,0,59,61.017,61.017
8,0.970,Bat,23-5,37,28,0,65,56.923,56.923
8,0.970,Deer,16-23,16,35,0,51,31.373,31.373
8,0.970,Deer,23-5,18,104,0,122,14.754,14.754
8,0.970,Great Horned Owl,16-23,0,0,0,0,NaN,NaN
8,0.970,Great Horned Owl,23-5,0,4,0,4,0.000,0.000
8,0.970,Freshwater Lagoon,16-23,0,0,0,0,NaN,NaN
8,0.970,Freshwater Lagoon,23-5,0,0,0,0,NaN,NaN
8,0.970,Unknown Avian,16-23,0,0,0,0,NaN,NaN
8,0.970,Unknown Avian,23-5,0,0,0,0,NaN,NaN
8,0.970,Human UTI,16-23,81,73,0,154,52.597,52.597
8,0.970,Human UTI,23-5,103,95,0,198,52.020,52.020
8,0.970,unknown,16-23,0,0,0,0,NaN,NaN
8,0.970,unknown,23-5,3,2,0,5,60.000,60.000
8,0.970,SLO Creek Water,16-23,0,0,0,0,NaN,NaN
8,0.970,SLO Creek Water,23-5,0,0,0,0,NaN,NaN
8,0.970,Pig/Swine,16-23,10,7,0,17,58.824,58.824
8,0.970,Pig/Swine,23-5,10,9,0,19,52.632,52.632
8,0.970,Klebsiella,16-23,0,0,0,0,NaN,NaN
8,0.970,Klebsiella,23-5,0,0,0,0,NaN,NaN
8,0.970,Hu Cw and Dg,16-23,12,17,0,29,41.379,41.379
8,0.970,Hu Cw and Dg,23-5,15,24,0,39,38.462,38.462
8,0.970,Ground Squirrel,16-23,94,64,0,158,59.494,59.494
8,0.970,Ground Squirrel,23-5,88,88,0,176,50.000,50.000
8,0.970,Opossum,16-23,0,1,0,1,0.000,0.000
8,0.970,Opossum,23-5,0,0,0,0,NaN,NaN
8,0.970,Cow,16-23,1546,1072,0,2618,59.053,59.053
8,0.970,Cow,23-5,1497,1368,0,2865,52.251,52.251
8,0.970,Deer Mouse,16-23,0,0,0,0,NaN,NaN
8,0.970,Deer Mouse,23-5,0,0,0,0,NaN,NaN
8,0.970,OVERALL,16-23,3801,2505,0,6306,60.276,60.276
8,0.970,OVERALL,23-5,4383,3173,0,7556,58.007,58.007
8,0.980,Chicken,16-23,0,6,0,6,0.000,0.000
8,0.980,Chicken,23-5,9,8,0,17,52.941,52.941
8,0.980,Sea Lion,16-23,0,1,0,1,0.000,0.000
8,0.980,Sea Lion,23-5,1,10,0,11,9.091,9.091
8,0.980,Hu and Cw,16-23,6,14,0,20,30.000,30.000
8,0.980,Hu and Cw,23-5,3,21,0,24,12.500,12.500
8,0.980,Sheep,16-23,52,52,0,104,50.000,50.000
8,0.980,Sheep,23-5,60,43,0,103,58.252,58.252
8,0.980,Hu and Dg,16-23,9,16,0,25,36.000,36.000
8,0.980,Hu and Dg,23-5,20,15,0,35,57.143,57.143
8,0.980,Common Loon,16-23,0,0,0,0,NaN,NaN
8,0.980,Common Loon,23-5,0,4,0,4,0.000,0.000
8,0.980,Red-Winged Blackbird,16-23,0,4,0,4,0.000,0.000
8,0.980,Red-Winged Blackbird,23-5,0,2,0,2,0.000,0.000
8,0.980,Cw,16-23,12,10,0,22,54.545,54.545
8,0.980,Cw,23-5,17,42,0,59,28.814,28.814
8,0.980,Cliff Sparrow,16-23,3,19,0,22,13.636,13.636
8,0.980,Cliff Sparrow,23-5,0,8,0,8,0.000,0.000
8,0.980,Pig,16-23,8,9,0,17,47.059,47.059
8,0.980,Pig,23-5,5,7,0,12,41.667,41.667
8,0.980,Barn Owl,16-23,0,0,0,0,NaN,NaN
8,0.980,Barn Owl,23-5,0,0,0,0,NaN,NaN
8,0.980,Wild Pig,16-23,1,1,0,2,50.000,50.000
8,0.980,Wild Pig,23-5,1,2,0,3,33.333,33.333
8,0.980,Pennington Creek Water,16-23,0,0,0,0,NaN,NaN
8,0.980,Pennington Creek Water,23-5,0,0,0,0,NaN,NaN
8,0.980,Guinni,16-23,0,0,0,0,NaN,NaN
8,0.980,Guinni,23-5,0,0,0,0,NaN,NaN
8,0.980,Racoon,16-23,0,0,0,0,NaN,NaN
8,0.980,Racoon,23-5,0,0,0,0,NaN,NaN
8,0.980,Hu,16-23,15,17,0,32,46.875,46.875
8,0.980,Hu,23-5,22,17,0,39,56.410,56.410
8,0.980,Cw and Dg,16-23,9,17,0,26,34.615,34.615
8,0.980,Cw and Dg,23-5,15,20,0,35,42.857,42.857
8,0.980,Red Wind Blackbird,16-23,0,0,0,0,NaN,NaN
8,0.980,Red Wind Blackbird,23-5,0,0,0,0,NaN,NaN
8,0.980,Tree Swallow,16-23,0,0,0,0,NaN,NaN
8,0.980,Tree Swallow,23-5,0,0,0,0,NaN,NaN
8,0.980,Turkey Vulture,16-23,0,0,0,0,NaN,NaN
8,0.980,Turkey Vulture,23-5,0,0,0,0,NaN,NaN
8,0.980,Dg,16-23,6,11,0,17,35.294,35.294
8,0.980,Dg,23-5,31,23,0,54,57.407,57.407
8,0.980,Western Kingbird,16-23,0,0,0,0,NaN,NaN
8,0.980,Western Kingbird,23-5,0,0,0,0,NaN,NaN
8,0.980,White Crowned Sparrow,16-23,0,4,0,4,0.000,0.000
8,0.980,White Crowned Sparrow,23-5,1,18,0,19,5.263,5.263
8,0.980,Eared Grebe,16-23,0,0,0,0,NaN,NaN
8,0.980,Eared Grebe,23-5,0,18,0,18,0.000,0.000
8,0.980,cougar,16-23,0,0,0,0,NaN,NaN
8,0.980,cougar,23-5,0,0,0,0,NaN,NaN
8,0.980,Ocean Water,16-23,0,0,0,0,NaN,NaN
8,0.980,Ocean Water,23-5,0,0,0,0,NaN,NaN
8,0.980,Red Tailed Hawk,16-23,0,2,0,2,0.000,0.000
8,0.980,Red Tailed Hawk,23-5,0,4,0,4,0.000,0.000
8,0.980,Dog,16-23,57,76,0,133,42.857,42.857
8,0.980,Dog,23-5,102,128,0,230,44.348,44.348
8,0.980,Human,16-23,1735,712,0,2447,70.903,70.903
8,0.980,Human,23-5,2160,575,0,2735,78.976,78.976
8,0.980,Wild Turkey,16-23,4,17,0,21,19.048,19.048
8,0.980,Wild Turkey,23-5,4,29,0,33,12.121,12.121
8,0.980,Clark Grebe,16-23,0,0,0,0,NaN,NaN
8,0.980,Clark Grebe,23-5,0,0,0,0,NaN,NaN
8,0.980,Seagull,16-23,0,0,0,0,NaN,NaN
8,0.980,Seagull,23-5,8,7,0,15,53.333,53.333
8,0.980,Surf Scoter,16-23,0,0,0,0,NaN,NaN
8,0.980,Surf Scoter,23-5,2,0,0,2,100.000,100.000
8,0.980,Pigeon,16-23,60,156,0,216,27.778,27.778
8,0.980,Pigeon,23-5,95,250,0,345,27.536,27.536
8,0.980,Pacific Ocean Water,16-23,0,0,0,0,NaN,NaN
8,0.980,Pacific Ocean Water,23-5,0,0,0,0,NaN,NaN
8,0.980,Cat,16-23,20,31,0,51,39.216,39.216
8,0.980,Cat,23-5,23,33,0,56,41.071,41.071
8,0.980,Horse,16-23,7,24,0,31,22.581,22.581
8,0.980,Horse,23-5,34,159,0,193,17.617,17.617
8,0.980,orangutan,16-23,0,0,0,0,NaN,NaN
8,0.980,orangutan,23-5,0,0,0,0,NaN,NaN
8,0.980,Bat,16-23,36,23,0,59,61.017,61.017
8,0.980,Bat,23-5,37,27,0,64,57.813,57.813
8,0.980,Deer,16-23,16,35,0,51,31.373,31.373
8,0.980,Deer,23-5,18,104,0,122,14.754,14.754
8,0.980,Great Horned Owl,16-23,0,0,0,0,NaN,NaN
8,0.980,Great Horned Owl,23-5,0,4,0,4,0.000,0.000
8,0.980,Freshwater Lagoon,16-23,0,0,0,0,NaN,NaN
8,0.980,Freshwater Lagoon,23-5,0,0,0,0,NaN,NaN
8,0.980,Unknown Avian,16-23,0,0,0,0,NaN,NaN
8,0.980,Unknown Avian,23-5,0,0,0,0,NaN,NaN
8,0.980,Human UTI,16-23,81,75,0,156,51.923,51.923
8,0.980,Human UTI,23-5,103,91,0,194,53.093,53.093
8,0.980,unknown,16-23,0,0,0,0,NaN,NaN
8,0.980,unknown,23-5,3,3,0,6,50.000,50.000
8,0.980,SLO Creek Water,16-23,0,0,0,0,NaN,NaN
8,0.980,SLO Creek Water,23-5,0,0,0,0,NaN,NaN
8,0.980,Pig/Swine,16-23,10,7,0,17,58.824,58.824
8,0.980,Pig/Swine,23-5,10,9,0,19,52.632,52.632
8,0.980,Klebsiella,16-23,0,0,0,0,NaN,NaN
8,0.980,Klebsiella,23-5,0,0,0,0,NaN,NaN
8,0.980,Hu Cw and Dg,16-23,12,17,0,29,41.379,41.379
8,0.980,Hu Cw and Dg,23-5,15,22,0,37,40.541,40.541
8,0.980,Ground Squirrel,16-23,95,65,0,160,59.375,59.375
8,0.980,Ground Squirrel,23-5,88,85,0,173,50.867,50.867
8,0.980,Opossum,16-23,0,1,0,1,0.000,0.000
8,0.980,Opossum,23-5,0,0,0,0,NaN,NaN
8,0.980,Cow,16-23,1539,1061,0,2600,59.192,59.192
8,0.980,Cow,23-5,1492,1344,0,2836,52.609,52.609
8,0.980,Deer Mouse,16-23,0,0,0,0,NaN,NaN
8,0.980,Deer Mouse,23-5,0,0,0,0,NaN,NaN
8,0.980,OVERALL,16-23,3793,2483,0,6276,60.437,60.437
8,0.980,OVERALL,23-5,4379,3132,0,7511,58.301,58.301
8,0.990,Chicken,16-23,2,11,0,13,15.385,15.385
8,0.990,Chicken,23-5,10,8,0,18,55.556,55.556
8,0.990,Sea Lion,16-23,0,1,0,1,0.000,0.000
8,0.990,Sea Lion,23-5,2,7,0,9,22.222,22.222
8,0.990,Hu and Cw,16-23,7,14,0,21,33.333,33.333
8,0.990,Hu and Cw,23-5,5,24,0,29,17.241,17.241
8,0.990,Sheep,16-23,51,51,0,102,50.000,50.000
8,0.990,Sheep,23-5,61,41,0,102,59.804,59.804
8,0.990,Hu and Dg,16-23,9,17,0,26,34.615,34.615
8,0.990,Hu and Dg,23-5,20,12,0,32,62.500,62.500
8,0.990,Common Loon,16-23,0,0,0,0,NaN,NaN
8,0.990,Common Loon,23-5,0,4,0,4,0.000,0.000
8,0.990,Red-Winged Blackbird,16-23,0,5,0,5,0.000,0.000
8,0.990,Red-Winged Blackbird,23-5,0,2,0,2,0.000,0.000
8,0.990,Cw,16-23,12,10,0,22,54.545,54.545
8,0.990,Cw,23-5,21,42,0,63,33.333,33.333
8,0.990,Cliff Sparrow,16-23,3,19,0,22,13.636,13.636
8,0.990,Cliff Sparrow,23-5,0,12,0,12,0.000,0.000
8,0.990,Pig,16-23,8,10,0,18,44.444,44.444
8,0.990,Pig,23-5,9,10,0,19,47.368,47.368
8,0.990,Barn Owl,16-23,0,0,0,0,NaN,NaN
8,0.990,Barn Owl,23-5,0,0,0,0,NaN,NaN
8,0.990,Wild Pig,16-23,1,3,0,4,25.000,25.000
8,0.990,Wild Pig,23-5,1,2,0,3,33.333,33.333
8,0.990,Pennington Creek Water,16-23,0,0,0,0,NaN,NaN
8,0.990,Pennington Creek Water,23-5,0,0,0,0,NaN,NaN
8,0.990,Guinni,16-23,0,0,0,0,NaN,NaN
8,0.990,Guinni,23-5,0,0,0,0,NaN,NaN
8,0.990,Racoon,16-23,0,0,0,0,NaN,NaN
8,0.990,Racoon,23-5,0,1,0,1,0.000,0.000
8,0.990,Hu,16-23,15,15,0,30,50.000,50.000
8,0.990,Hu,23-5,22,14,0,36,61.111,61.111
8,0.990,Cw and Dg,16-23,9,17,0,26,34.615,34.615
8,0.990,Cw and Dg,23-5,16,13,0,29,55.172,55.172
8,0.990,Red Wind Blackbird,16-23,0,0,0,0,NaN,NaN
8,0.990,Red Wind Blackbird,23-5,0,0,0,0,NaN,NaN
8,0.990,Tree Swallow,16-23,0,0,0,0,NaN,NaN
8,0.990,Tree Swallow,23-5,0,0,0,0,NaN,NaN
8,0.990,Turkey Vulture,16-23,0,0,0,0,NaN,NaN
8,0.990,Turkey Vulture,23-5,0,0,0,0,NaN,NaN
8,0.990,Dg,16-23,6,11,0,17,35.294,35.294
8,0.990,Dg,23-5,31,19,0,50,62.000,62.000
8,0.990,Western Kingbird,16-23,0,0,0,0,NaN,NaN
8,0.990,Western Kingbird,23-5,0,0,0,0,NaN,NaN
8,0.990,White Crowned Sparrow,16-23,0,4,0,4,0.000,0.000
8,0.990,White Crowned Sparrow,23-5,1,18,0,19,5.263,5.263
8,0.990,Eared Grebe,16-23,0,0,0,0,NaN,NaN
8,0.990,Eared Grebe,23-5,0,16,0,16,0.000,0.000
8,0.990,cougar,16-23,0,1,0,1,0.000,0.000
8,0.990,cougar,23-5,0,0,0,0,NaN,NaN
8,0.990,Ocean Water,16-23,0,0,0,0,NaN,NaN
8,0.990,Ocean Water,23-5,0,0,0,0,NaN,NaN
8,0.990,Red Tailed Hawk,16-23,0,2,0,2,0.000,0.000
8,0.990,Red Tailed Hawk,23-5,0,5,0,5,0.000,0.000
8,0.990,Dog,16-23,60,76,0,136,44.118,44.118
8,0.990,Dog,23-5,104,120,0,224,46.429,46.429
8,0.990,Human,16-23,1714,682,0,2396,71.536,71.536
8,0.990,Human,23-5,2143,534,0,2677,80.052,80.052
8,0.990,Wild Turkey,16-23,5,22,0,27,18.519,18.519
8,0.990,Wild Turkey,23-5,4,28,0,32,12.500,12.500
8,0.990,Clark Grebe,16-23,0,0,0,0,NaN,NaN
8,0.990,Clark Grebe,23-5,2,3,0,5,40.000,40.000
8,0.990,Seagull,16-23,0,0,0,0,NaN,NaN
8,0.990,Seagull,23-5,13,6,0,19,68.421,68.421
8,0.990,Surf Scoter,16-23,0,0,0,0,NaN,NaN
8,0.990,Surf Scoter,23-5,2,0,0,2,100.000,100.000
8,0.990,Pigeon,16-23,66,149,0,215,30.698,30.698
8,0.990,Pigeon,23-5,100,244,0,344,29.070,29.070
8,0.990,Pacific Ocean Water,16-23,0,0,0,0,NaN,NaN
8,0.990,Pacific Ocean Water,23-5,0,0,0,0,NaN,NaN
8,0.990,Cat,16-23,20,28,0,48,41.667,41.667
8,0.990,Cat,23-5,23,35,0,58,39.655,39.655
8,0.990,Horse,16-23,10,24,0,34,29.412,29.412
8,0.990,Horse,23-5,33,162,0,195,16.923,16.923
8,0.990,orangutan,16-23,0,0,0,0,NaN,NaN
8,0.990,orangutan,23-5,0,0,0,0,NaN,NaN
8,0.990,Bat,16-23,36,22,0,58,62.069,62.069
8,0.990,Bat,23-5,37,26,0,63,58.730,58.730
8,0.990,Deer,16-23,16,36,0,52,30.769,30.769
8,0.990,Deer,23-5,18,102,0,120,15.000,15.000
8,0.990,Great Horned Owl,16-23,0,0,0,0,NaN,NaN
8,0.990,Great Horned Owl,23-5,0,4,0,4,0.000,0.000
8,0.990,Freshwater Lagoon,16-23,0,0,0,0,NaN,NaN
8,0.990,Freshwater Lagoon,23-5,0,0,0,0,NaN,NaN
8,0.990,Unknown Avian,16-23,0,0,0,0,NaN,NaN
8,0.990,Unknown Avian,23-5,0,0,0,0,NaN,NaN
8,0.990,Human UTI,16-23,85,73,0,158,53.797,53.797
8,0.990,Human UTI,23-5,104,76,0,180,57.778,57.778
8,0.990,unknown,16-23,0,0,0,0,NaN,NaN
8,0.990,unknown,23-5,3,4,0,7,42.857,42.857
8,0.990,SLO Creek Water,16-23,0,0,0,0,NaN,NaN
8,0.990,SLO Creek Water,23-5,0,0,0,0,NaN,NaN
8,0.990,Pig/Swine,16-23,9,8,0,17,52.941,52.941
8,0.990,Pig/Swine,23-5,10,9,0,19,52.632,52.632
8,0.990,Klebsiella,16-23,0,0,0,0,NaN,NaN
8,0.990,Klebsiella,23-5,0,0,0,0,NaN,NaN
8,0.990,Hu Cw and Dg,16-23,12,17,0,29,41.379,41.379
8,0.990,Hu Cw and Dg,23-5,15,21,0,36,41.667,41.667
8,0.990,Ground Squirrel,16-23,97,65,0,162,59.877,59.877
8,0.990,Ground Squirrel,23-5,89,88,0,177,50.282,50.282
8,0.990,Opossum,16-23,1,1,0,2,50.000,50.000
8,0.990,Opossum,23-5,2,0,0,2,100.000,100.000
8,0.990,Cow,16-23,1501,965,0,2466,60.868,60.868
8,0.990,Cow,23-5,1460,1232,0,2692,54.235,54.235
8,0.990,Deer Mouse,16-23,0,0,0,0,NaN,NaN
8,0.990,Deer Mouse,23-5,0,0,0,0,NaN,NaN
8,0.990,OVERALL,16-23,3755,2359,0,6114,61.416,61.416
8,0.990,OVERALL,23-5,4361,2944,0,7305,59.699,59.699
8,1.000,Chicken,16-23,0,0,0,0,NaN,NaN
8,1.000,Chicken,23-5,0,0,0,0,NaN,NaN
8,1.000,Sea Lion,16-23,0,0,0,0,NaN,NaN
8,1.000,Sea Lion,23-5,0,0,0,0,NaN,NaN
8,1.000,Hu and Cw,16-23,0,0,0,0,NaN,NaN
8,1.000,Hu and Cw,23-5,0,0,0,0,NaN,NaN
8,1.000,Sheep,16-23,0,0,0,0,NaN,NaN
8,1.000,Sheep,23-5,0,0,0,0,NaN,NaN
8,1.000,Hu and Dg,16-23,0,0,0,0,NaN,NaN
8,1.000,Hu and Dg,23-5,0,0,0,0,NaN,NaN
8,1.000,Common Loon,16-23,0,0,0,0,NaN,NaN
8,1.000,Common Loon,23-5,0,0,0,0,NaN,NaN
8,1.000,Red-Winged Blackbird,16-23,0,0,0,0,NaN,NaN
8,1.000,Red-Winged Blackbird,23-5,0,0,0,0,NaN,NaN
8,1.000,Cw,16-23,0,0,0,0,NaN,NaN
8,1.000,Cw,23-5,0,0,0,0,NaN,NaN
8,1.000,Cliff Sparrow,16-23,0,0,0,0,NaN,NaN
8,1.000,Cliff Sparrow,23-5,0,0,0,0,NaN,NaN
8,1.000,Pig,16-23,0,0,0,0,NaN,NaN
8,1.000,Pig,23-5,0,0,0,0,NaN,NaN
8,1.000,Barn Owl,16-23,0,0,0,0,NaN,NaN
8,1.000,Barn Owl,23-5,0,0,0,0,NaN,NaN
8,1.000,Wild Pig,16-23,0,0,0,0,NaN,NaN
8,1.000,Wild Pig,23-5,0,0,0,0,NaN,NaN
8,1.000,Pennington Creek Water,16-23,0,0,0,0,NaN,NaN
8,1.000,Pennington Creek Water,23-5,0,0,0,0,NaN,NaN
8,1.000,Guinni,16-23,0,0,0,0,NaN,NaN
8,1.000,Guinni,23-5,0,0,0,0,NaN,NaN
8,1.000,Racoon,16-23,0,0,0,0,NaN,NaN
8,1.000,Racoon,23-5,0,0,0,0,NaN,NaN
8,1.000,Hu,16-23,0,0,0,0,NaN,NaN
8,1.000,Hu,23-5,0,0,0,0,NaN,NaN
8,1.000,Cw and Dg,16-23,0,0,0,0,NaN,NaN
8,1.000,Cw and Dg,23-5,0,0,0,0,NaN,NaN
8,1.000,Red Wind Blackbird,16-23,0,0,0,0,NaN,NaN
8,1.000,Red Wind Blackbird,23-5,0,0,0,0,NaN,NaN
8,1.000,Tree Swallow,16-23,0,0,0,0,NaN,NaN
8,1.000,Tree Swallow,23-5,0,0,0,0,NaN,NaN
8,1.000,Turkey Vulture,16-23,0,0,0,0,NaN,NaN
8,1.000,Turkey Vulture,23-5,0,0,0,0,NaN,NaN
8,1.000,Dg,16-23,0,0,0,0,NaN,NaN
8,1.000,Dg,23-5,0,0,0,0,NaN,NaN
8,1.000,Western Kingbird,16-23,0,0,0,0,NaN,NaN
8,1.000,Western Kingbird,23-5,0,0,0,0,NaN,NaN
8,1.000,White Crowned Sparrow,16-23,0,0,0,0,NaN,NaN
8,1.000,White Crowned Sparrow,23-5,0,0,0,0,NaN,NaN
8,1.000,Eared Grebe,16-23,0,0,0,0,NaN,NaN
8,1.000,Eared Grebe,23-5,0,0,0,0,NaN,NaN
8,1.000,cougar,16-23,0,0,0,0,NaN,NaN
8,1.000,cougar,23-5,0,0,0,0,NaN,NaN
8,1.000,Ocean Water,16-23,0,0,0,0,NaN,NaN
8,1.000,Ocean Water,23-5,0,0,0,0,NaN,NaN
8,1.000,Red Tailed Hawk,16-23,0,0,0,0,NaN,NaN
8,1.000,Red Tailed Hawk,23-5,0,0,0,0,NaN,NaN
8,1.000,Dog,16-23,0,0,0,0,NaN,NaN
8,1.000,Dog,23-5,0,0,0,0,NaN,NaN
8,1.000,Human,16-23,0,0,0,0,NaN,NaN
8,1.000,Human,23-5,0,0,0,0,NaN,NaN
8,1.000,Wild Turkey,16-23,0,0,0,0,NaN,NaN
8,1.000,Wild Turkey,23-5,0,0,0,0,NaN,NaN
8,1.000,Clark Grebe,16-23,0,0,0,0,NaN,NaN
8,1.000,Clark Grebe,23-5,0,0,0,0,NaN,NaN
8,1.000,Seagull,16-23,0,0,0,0,NaN,NaN
8,1.000,Seagull,23-5,0,0,0,0,NaN,NaN
8,1.000,Surf Scoter,16-23,0,0,0,0,NaN,NaN
8,1.000,Surf Scoter,23-5,0,0,0,0,NaN,NaN
8,1.000,Pigeon,16-23,0,0,0,0,NaN,NaN
8,1.000,Pigeon,23-5,0,0,0,0,NaN,NaN
8,1.000,Pacific Ocean Water,16-23,0,0,0,0,NaN,NaN
8,1.000,Pacific Ocean Water,23-5,0,0,0,0,NaN,NaN
8,1.000,Cat,16-23,0,0,0,0,NaN,NaN
8,1.000,Cat,23-5,0,0,0,0,NaN,NaN
8,1.000,Horse,16-23,0,0,0,0,NaN,NaN
8,1.000,Horse,23-5,0,0,0,0,NaN,NaN
8,1.000,orangutan,16-23,0,0,0,0,NaN,NaN
8,1.000,orangutan,23-5,0,0,0,0,NaN,NaN
8,1.000,Bat,16-23,0,0,0,0,NaN,NaN
8,1.000,Bat,23-5,0,0,0,0,NaN,NaN
8,1.000,Deer,16-23,0,0,0,0,NaN,NaN
8,1.000,Deer,23-5,0,0,0,0,NaN,NaN
8,1.000,Great Horned Owl,16-23,0,0,0,0,NaN,NaN
8,1.000,Great Horned Owl,23-5,0,0,0,0,NaN,NaN
8,1.000,Freshwater Lagoon,16-23,0,0,0,0,NaN,NaN
8,1.000,Freshwater Lagoon,23-5,0,0,0,0,NaN,NaN
8,1.000,Unknown Avian,16-23,0,0,0,0,NaN,NaN
8,1.000,Unknown Avian,23-5,0,0,0,0,NaN,NaN
8,1.000,Human UTI,16-23,0,0,0,0,NaN,NaN
8,1.000,Human UTI,23-5,0,0,0,0,NaN,NaN
8,1.000,unknown,16-23,0,0,0,0,NaN,NaN
8,1.000,unknown,23-5,0,0,0,0,NaN,NaN
8,1.000,SLO Creek Water,16-23,0,0,0,0,NaN,NaN
8,1.000,SLO Creek Water,23-5,0,0,0,0,NaN,NaN
8,1.000,Pig/Swine,16-23,0,0,0,0,NaN,NaN
8,1.000,Pig/Swine,23-5,0,0,0,0,NaN,NaN
8,1.000,Klebsiella,16-23,0,0,0,0,NaN,NaN
8,1.000,Klebsiella,23-5,0,0,0,0,NaN,NaN
8,1.000,Hu Cw and Dg,16-23,0,0,0,0,NaN,NaN
8,1.000,Hu Cw and Dg,23-5,0,0,0,0,NaN,NaN
8,1.000,Ground Squirrel,16-23,0,0,0,0,NaN,NaN
8,1.000,Ground Squirrel,23-5,0,0,0,0,NaN,NaN
8,1.000,Opossum,16-23,0,0,0,0,NaN,NaN
8,1.000,Opossum,23-5,0,0,0,0,NaN,NaN
8,1.000,Cow,16-23,0,0,0,0,NaN,NaN
8,1.000,Cow,23-5,0,0,0,0,NaN,NaN
8,1.000,Deer Mouse,16-23,0,0,0,0,NaN,NaN
8,1.000,Deer Mouse,23-5,0,0,0,0,NaN,NaN
8,1.000,OVERALL,16-23,0,0,0,0,NaN,NaN
8,1.000,OVERALL,23-5,0,0,0,0,NaN,NaN
9,0.000,Chicken,16-23,0,4,0,4,0.000,0.000
9,0.000,Chicken,23-5,8,7,0,15,53.333,53.333
9,0.000,Sea Lion,16-23,0,1,0,1,0.000,0.000
9,0.000,Sea Lion,23-5,1,11,0,12,8.333,8.333
9,0.000,Hu and Cw,16-23,5,7,0,12,41.667,41.667
9,0.000,Hu and Cw,23-5,4,9,0,13,30.769,30.769
9,0.000,Sheep,16-23,51,56,0,107,47.664,47.664
9,0.000,Sheep,23-5,58,41,0,99,58.586,58.586
9,0.000,Hu and Dg,16-23,9,16,0,25,36.000,36.000
9,0.000,Hu and Dg,23-5,20,19,0,39,51.282,51.282
9,0.000,Common Loon,16-23,0,0,0,0,NaN,NaN
9,0.000,Common Loon,23-5,0,3,0,3,0.000,0.000
9,0.000,Red-Winged Blackbird,16-23,0,3,0,3,0.000,0.000
9,0.000,Red-Winged Blackbird,23-5,0,0,0,0,NaN,NaN
9,0.000,Cw,16-23,8,14,0,22,36.364,36.364
9,0.000,Cw,23-5,16,32,0,48,33.333,33.333
9,0.000,Cliff Sparrow,16-23,1,14,0,15,6.667,6.667
9,0.000,Cliff Sparrow,23-5,0,9,0,9,0.000,0.000
9,0.000,Pig,16-23,8,9,0,17,47.059,47.059
9,0.000,Pig,23-5,4,5,0,9,44.444,44.444
9,0.000,Barn Owl,16-23,0,0,0,0,NaN,NaN
9,0.000,Barn Owl,23-5,0,0,0,0,NaN,NaN
9,0.000,Wild Pig,16-23,1,0,0,1,100.000,100.000
9,0.000,Wild Pig,23-5,1,1,0,2,50.000,50.000
9,0.000,Pennington Creek Water,16-23,0,0,0,0,NaN,NaN
9,0.000,Pennington Creek Water,23-5,0,0,0,0,NaN,NaN
9,0.000,Guinni,16-23,0,0,0,0,NaN,NaN
9,0.000,Guinni,23-5,0,0,0,0,NaN,NaN
9,0.000,Racoon,16-23,0,0,0,0,NaN,NaN
9,0.000,Racoon,23-5,0,0,0,0,NaN,NaN
9,0.000,Hu,16-23,16,15,0,31,51.613,51.613
9,0.000,Hu,23-5,21,13,0,34,61.765,61.765
9,0.000,Cw and Dg,16-23,5,15,0,20,25.000,25.000
9,0.000,Cw and Dg,23-5,16,17,0,33,48.485,48.485
9,0.000,Red Wind Blackbird,16-23,0,0,0,0,NaN,NaN
9,0.000,Red Wind Blackbird,23-5,0,0,0,0,NaN,NaN
9,0.000,Tree Swallow,16-23,0,0,0,0,NaN,NaN
9,0.000,Tree Swallow,23-5,0,0,0,0,NaN,NaN
9,0.000,Turkey Vulture,16-23,0,0,0,0,NaN,NaN
9,0.000,Turkey Vulture,23-5,0,0,0,0,NaN,NaN
9,0.000,Dg,16-23,6,10,0,16,37.500,37.500
9,0.000,Dg,23-5,31,30,0,61,50.820,50.820
9,0.000,Western Kingbird,16-23,0,0,0,0,NaN,NaN
9,0.000,Western Kingbird,23-5,0,0,0,0,NaN,NaN
9,0.000,White Crowned Sparrow,16-23,0,1,0,1,0.000,0.000
9,0.000,White Crowned Sparrow,23-5,1,16,0,17,5.882,5.882
9,0.000,Eared Grebe,16-23,0,0,0,0,NaN,NaN
9,0.000,Eared Grebe,23-5,0,15,0,15,0.000,0.000
9,0.000,cougar,16-23,0,0,0,0,NaN,NaN
9,0.000,cougar,23-5,0,0,0,0,NaN,NaN
9,0.000,Ocean Water,16-23,0,0,0,0,NaN,NaN
9,0.000,Ocean Water,23-5,0,0,0,0,NaN,NaN
9,0.000,Red Tailed Hawk,16-23,0,1,0,1,0.000,0.000
9,0.000,Red Tailed Hawk,23-5,0,5,0,5,0.000,0.000
9,0.000,Dog,16-23,56,67,0,123,45.528,45.528
9,0.000,Dog,23-5,92,136,0,228,40.351,40.351
9,0.000,Human,16-23,1719,748,0,2467,69.680,69.680
9,0.000,Human,23-5,2150,642,0,2792,77.006,77.006
9,0.000,Wild Turkey,16-23,2,10,0,12,16.667,16.667
9,0.000,Wild Turkey,23-5,0,24,0,24,0.000,0.000
9,0.000,Clark Grebe,16-23,0,0,0,0,NaN,NaN
9,0.000,Clark Grebe,23-5,0,0,0,0,NaN,NaN
9,0.000,Seagull,16-23,0,0,0,0,NaN,NaN
9,0.000,Seagull,23-5,5,8,0,13,38.462,38.462
9,0.000,Surf Scoter,16-23,0,0,0,0,NaN,NaN
9,0.000,Surf Scoter,23-5,0,0,0,0,NaN,NaN
9,0.000,Pigeon,16-23,56,156,0,212,26.415,26.415
9,0.000,Pigeon,23-5,91,187,0,278,32.734,32.734
9,0.000,Pacific Ocean Water,16-23,0,0,0,0,NaN,NaN
9,0.000,Pacific Ocean Water,23-5,0,0,0,0,NaN,NaN
9,0.000,Cat,16-23,19,28,0,47,40.426,40.426
9,0.000,Cat,23-5,21,39,0,60,35.000,35.000
9,0.000,Horse,16-23,7,21,0,28,25.000,25.000
9,0.000,Horse,23-5,31,156,0,187,16.578,16.578
9,0.000,orangutan,16-23,0,0,0,0,NaN,NaN
9,0.000,orangutan,23-5,0,0,0,0,NaN,NaN
9,0.000,Bat,16-23,36,28,0,64,56.250,56.250
9,0.000,Bat,23-5,37,29,0,66,56.061,56.061
9,0.000,Deer,16-23,15,35,0,50,30.000,30.000
9,0.000,Deer,23-5,18,109,0,127,14.173,14.173
9,0.000,Great Horned Owl,16-23,0,0,0,0,NaN,NaN
9,0.000,Great Horned Owl,23-5,0,1,0,1,0.000,0.000
9,0.000,Freshwater Lagoon,16-23,0,0,0,0,NaN,NaN
9,0.000,Freshwater Lagoon,23-5,0,0,0,0,NaN,NaN
9,0.000,Unknown Avian,16-23,0,0,0,0,NaN,NaN
9,0.000,Unknown Avian,23-5,0,0,0,0,NaN,NaN
9,0.000,Human UTI,16-23,77,75,0,152,50.658,50.658
9,0.000,Human UTI,23-5,102,96,0,198,51.515,51.515
9,0.000,unknown,16-23,0,0,0,0,NaN,NaN
9,0.000,unknown,23-5,2,3,0,5,40.000,40.000
9,0.000,SLO Creek Water,16-23,0,0,0,0,NaN,NaN
9,0.000,SLO Creek Water,23-5,0,0,0,0,NaN,NaN
9,0.000,Pig/Swine,16-23,9,8,0,17,52.941,52.941
9,0.000,Pig/Swine,23-5,9,10,0,19,47.368,47.368
9,0.000,Klebsiella,16-23,0,0,0,0,NaN,NaN
9,0.000,Klebsiella,23-5,0,0,0,0,NaN,NaN
9,0.000,Hu Cw and Dg,16-23,12,22,0,34,35.294,35.294
9,0.000,Hu Cw and Dg,23-5,12,22,0,34,35.294,35.294
9,0.000,Ground Squirrel,16-23,90,61,0,151,59.603,59.603
9,0.000,Ground Squirrel,23-5,86,81,0,167,51.497,51.497
9,0.000,Opossum,16-23,0,0,0,0,NaN,NaN
9,0.000,Opossum,23-5,0,0,0,0,NaN,NaN
9,0.000,Cow,16-23,1572,1143,0,2715,57.901,57.901
9,0.000,Cow,23-5,1519,1478,0,2997,50.684,50.684
9,0.000,Deer Mouse,16-23,0,0,0,0,NaN,NaN
9,0.000,Deer Mouse,23-5,0,0,0,0,NaN,NaN
9,0.000,OVERALL,16-23,3780,2568,0,6348,59.546,59.546
9,0.000,OVERALL,23-5,4356,3254,0,7610,57.240,57.240
9,0.500,Chicken,16-23,0,4,0,4,0.000,0.000
9,0.500,Chicken,23-5,8,7,0,15,53.333,53.333
9,0.500,Sea Lion,16-23,0,1,0,1,0.000,0.000
9,0.500,Sea Lion,23-5,1,11,0,12,8.333,8.333
9,0.500,Hu and Cw,16-23,5,7,0,12,41.667,41.667
9,0.500,Hu and Cw,23-5,4,9,0,13,30.769,30.769
9,0.500,Sheep,16-23,51,56,0,107,47.664,47.664
9,0.500,Sheep,23-5,58,41,0,99,58.586,58.586
9,0.500,Hu and Dg,16-23,9,16,0,25,36.000,36.000
9,0.500,Hu and Dg,23-5,20,19,0,39,51.282,51.282
9,0.500,Common Loon,16-23,0,0,0,0,NaN,NaN
9,0.500,Common Loon,23-5,0,3,0,3,0.000,0.000
9,0.500,Red-Winged Blackbird,16-23,0,3,0,3,0.000,0.000
9,0.500,Red-Winged Blackbird,23-5,0,0,0,0,NaN,NaN
9,0.500,Cw,16-23,8,14,0,22,36.364,36.364
9,0.500,Cw,23-5,16,32,0,48,33.333,33.333
9,0.500,Cliff Sparrow,16-23,1,14,0,15,6.667,6.667
9,0.500,Cliff Sparrow,23-5,0,9,0,9,0.000,0.000
9,0.500,Pig,16-23,8,9,0,17,47.059,47.059
9,0.500,Pig,23-5,4,5,0,9,44.444,44.444
9,0.500,Barn Owl,16-23,0,0,0,0,NaN,NaN
9,0.500,Barn Owl,23-5,0,0,0,0,NaN,NaN
9,0.500,Wild Pig,16-23,1,0,0,1,100.000,100.000
9,0.500,Wild Pig,23-5,1,1,0,2,50.000,50.000
9,0.500,Pennington Creek Water,16-23,0,0,0,0,NaN,NaN
9,0.500,Pennington Creek Water,23-5,0,0,0,0,NaN,NaN
9,0.500,Guinni,16-23,0,0,0,0,NaN,NaN
9,0.500,Guinni,23-5,0,0,0,0,NaN,NaN
9,0.500,Racoon,16-23,0,0,0,0,NaN,NaN
9,0.500,Racoon,23-5,0,0,0,0,NaN,NaN
9,0.500,Hu,16-23,16,15,0,31,51.613,51.613
9,0.500,Hu,23-5,21,13,0,34,61.765,61.765
9,0.500,Cw and Dg,16-23,5,15,0,20,25.000,25.000
9,0.500,Cw and Dg,23-5,16,17,0,33,48.485,48.485
9,0.500,Red Wind Blackbird,16-23,0,0,0,0,NaN,NaN
9,0.500,Red Wind Blackbird,23-5,0,0,0,0,NaN,NaN
9,0.500,Tree Swallow,16-23,0,0,0,0,NaN,NaN
9,0.500,Tree Swallow,23-5,0,0,0,0,NaN,NaN
9,0.500,Turkey Vulture,16-23,0,0,0,0,NaN,NaN
9,0.500,Turkey Vulture,23-5,0,0,0,0,NaN,NaN
9,0.500,Dg,16-23,6,10,0,16,37.500,37.500
9,0.500,Dg,23-5,31,30,0,61,50.820,50.820
9,0.500,Western Kingbird,16-23,0,0,0,0,NaN,NaN
9,0.500,Western Kingbird,23-5,0,0,0,0,NaN,NaN
9,0.500,White Crowned Sparrow,16-23,0,1,0,1,0.000,0.000
9,0.500,White Crowned Sparrow,23-5,1,16,0,17,5.882,5.882
9,0.500,Eared Grebe,16-23,0,0,0,0,NaN,NaN
9,0.500,Eared Grebe,23-5,0,15,0,15,0.000,0.000
9,0.500,cougar,16-23,0,0,0,0,NaN,NaN
9,0.500,cougar,23-5,0,0,0,0,NaN,NaN
9,0.500,Ocean Water,16-23,0,0,0,0,NaN,NaN
9,0.500,Ocean Water,23-5,0,0,0,0,NaN,NaN
9,0.500,Red Tailed Hawk,16-23,0,1,0,1,0.000,0.000
9,0.500,Red Tailed Hawk,23-5,0,5,0,5,0.000,0.000
9,0.500,Dog,16-23,56,67,0,123,45.528,45.528
9,0.500,Dog,23-5,92,136,0,228,40.351,40.351
9,0.500,Human,16-23,1719,748,0,2467,69.680,69.680
9,0.500,Human,23-5,2150,642,0,2792,77.006,77.006
9,0.500,Wild Turkey,16-23,2,10,0,12,16.667,16.667
9,0.500,Wild Turkey,23-5,0,24,0,24,0.000,0.000
9,0.500,Clark Grebe,16-23,0,0,0,0,NaN,NaN
9,0.500,Clark Grebe,23-5,0,0,0,0,NaN,NaN
9,0.500,Seagull,16-23,0,0,0,0,NaN,NaN
9,0.500,Seagull,23-5,5,8,0,13,38.462,38.462
9,0.500,Surf Scoter,16-23,0,0,0,0,NaN,NaN
9,0.500,Surf Scoter,23-5,0,0,0,0,NaN,NaN
9,0.500,Pigeon,16-23,56,156,0,212,26.415,26.415
9,0.500,Pigeon,23-5,91,187,0,278,32.734,32.734
9,0.500,Pacific Ocean Water,16-23,0,0,0,0,NaN,NaN
9,0.500,Pacific Ocean Water,23-5,0,0,0,0,NaN,NaN
9,0.500,Cat,16-23,19,28,0,47,40.426,40.426
9,0.500,Cat,23-5,21,39,0,60,35.000,35.000
9,0.500,Horse,16-23,7,21,0,28,25.000,25.000
9,0.500,Horse,23-5,31,156,0,187,16.578,16.578
9,0.500,orangutan,16-23,0,0,0,0,NaN,NaN
9,0.500,orangutan,23-5,0,0,0,0,NaN,NaN
9,0.500,Bat,16-23,36,28,0,64,56.250,56.250
9,0.500,Bat,23-5,37,29,0,66,56.061,56.061
9,0.500,Deer,16-23,15,35,0,50,30.000,30.000
9,0.500,Deer,23-5,18,109,0,127,14.173,14.173
9,0.500,Great Horned Owl,16-23,0,0,0,0,NaN,NaN
9,0.500,Great Horned Owl,23-5,0,1,0,1,0.000,0.000
9,0.500,Freshwater Lagoon,16-23,0,0,0,0,NaN,NaN
9,0.500,Freshwater Lagoon,23-5,0,0,0,0,NaN,NaN
9,0.500,Unknown Avian,16-23,0,0,0,0,NaN,NaN
9,0.500,Unknown Avian,23-5,0,0,0,0,NaN,NaN
9,0.500,Human UTI,16-23,77,75,0,152,50.658,50.658
9,0.500,Human UTI,23-5,102,96,0,198,51.515,51.515
9,0.500,unknown,16-23,0,0,0,0,NaN,NaN
9,0.500,unknown,23-5,2,3,0,5,40.000,40.000
9,0.500,SLO Creek Water,16-23,0,0,0,0,NaN,NaN
9,0.500,SLO Creek Water,23-5,0,0,0,0,NaN,NaN
9,0.500,Pig/Swine,16-23,9,8,0,17,52.941,52.941
9,0.500,Pig/Swine,23-5,9,10,0,19,47.368,47.368
9,0.500,Klebsiella,16-23,0,0,0,0,NaN,NaN
9,0.500,Klebsiella,23-5,0,0,0,0,NaN,NaN
9,0.500,Hu Cw and Dg,16-23,12,22,0,34,35.294,35.294
9,0.500,Hu Cw and Dg,23-5,12,22,0,34,35.294,35.294
9,0.500,Ground Squirrel,16-23,90,61,0,151,59.603,59.603
9,0.500,Ground Squirrel,23-5,86,81,0,167,51.497,51.497
9,0.500,Opossum,16-23,0,0,0,0,NaN,NaN
9,0.500,Opossum,23-5,0,0,0,0,NaN,NaN
9,0.500,Cow,16-23,1572,1143,0,2715,57.901,57.901
9,0.500,Cow,23-5,1519,1478,0,2997,50.684,50.684
9,0.500,Deer Mouse,16-23,0,0,0,0,NaN,NaN
9,0.500,Deer Mouse,23-5,0,0,0,0,NaN,NaN
9,0.500,OVERALL,16-23,3780,2568,0,6348,59.546,59.546
9,0.500,OVERALL,23-5,4356,3254,0,7610,57.240,57.240
9,0.900,Chicken,16-23,0,4,0,4,0.000,0.000
9,0.900,Chicken,23-5,8,7,0,15,53.333,53.333
9,0.900,Sea Lion,16-23,0,1,0,1,0.000,0.000
9,0.900,Sea Lion,23-5,1,11,0,12,8.333,8.333
9,0.900,Hu and Cw,16-23,5,7,0,12,41.667,41.667
9,0.900,Hu and Cw,23-5,4,9,0,13,30.769,30.769
9,0.900,Sheep,16-23,51,56,0,107,47.664,47.664
9,0.900,Sheep,23-5,58,41,0,99,58.586,58.586
9,0.900,Hu and Dg,16-23,9,16,0,25,36.000,36.000
9,0.900,Hu and Dg,23-5,20,19,0,39,51.282,51.282
9,0.900,Common Loon,16-23,0,0,0,0,NaN,NaN
9,0.900,Common Loon,23-5,0,3,0,3,0.000,0.000
9,0.900,Red-Winged Blackbird,16-23,0,3,0,3,0.000,0.000
9,0.900,Red-Winged Blackbird,23-5,0,0,0,0,NaN,NaN
9,0.900,Cw,16-23,8,14,0,22,36.364,36.364
9,0.900,Cw,23-5,16,32,0,48,33.333,33.333
9,0.900,Cliff Sparrow,16-23,1,14,0,15,6.667,6.667
9,0.900,Cliff Sparrow,23-5,0,9,0,9,0.000,0.000
9,0.900,Pig,16-23,8,9,0,17,47.059,47.059
9,0.900,Pig,23-5,4,5,0,9,44.444,44.444
9,0.900,Barn Owl,16-23,0,0,0,0,NaN,NaN
9,0.900,Barn Owl,23-5,0,0,0,0,NaN,NaN
9,0.900,Wild Pig,16-23,1,0,0,1,100.000,100.000
9,0.900,Wild Pig,23-5,1,1,0,2,50.000,50.000
9,0.900,Pennington Creek Water,16-23,0,0,0,0,NaN,NaN
9,0.900,Pennington Creek Water,23-5,0,0,0,0,NaN,NaN
9,0.900,Guinni,16-23,0,0,0,0,NaN,NaN
9,0.900,Guinni,23-5,0,0,0,0,NaN,NaN
9,0.900,Racoon,16-23,0,0,0,0,NaN,NaN
9,0.900,Racoon,23-5,0,0,0,0,NaN,NaN
9,0.900,Hu,16-23,16,15,0,31,51.613,51.613
9,0.900,Hu,23-5,21,13,0,34,61.765,61.765
9,0.900,Cw and Dg,16-23,5,15,0,20,25.000,25.000
9,0.900,Cw and Dg,23-5,16,17,0,33,48.485,48.485
9,0.900,Red Wind Blackbird,16-23,0,0,0,0,NaN,NaN
9,0.900,Red Wind Blackbird,23-5,0,0,0,0,NaN,NaN
9,0.900,Tree Swallow,16-23,0,0,0,0,NaN,NaN
9,0.900,Tree Swallow,23-5,0,0,0,0,NaN,NaN
9,0.900,Turkey Vulture,16-23,0,0,0,0,NaN,NaN
9,0.900,Turkey Vulture,23-5,0,0,0,0,NaN,NaN
9,0.900,Dg,16-23,6,10,0,16,37.500,37.500
9,0.900,Dg,23-5,31,30,0,61,50.820,50.820
9,0.900,Western Kingbird,16-23,0,0,0,0,NaN,NaN
9,0.900,Western Kingbird,23-5,0,0,0,0,NaN,NaN
9,0.900,White Crowned Sparrow,16-23,0,1,0,1,0.000,0.000
9,0.900,White Crowned Sparrow,23-5,1,16,0,17,5.882,5.882
9,0.900,Eared Grebe,16-23,0,0,0,0,NaN,NaN
9,0.900,Eared Grebe,23-5,0,15,0,15,0.000,0.000
9,0.900,cougar,16-23,0,0,0,0,NaN,NaN
9,0.900,cougar,23-5,0,0,0,0,NaN,NaN
9,0.900,Ocean Water,16-23,0,0,0,0,NaN,NaN
9,0.900,Ocean Water,23-5,0,0,0,0,NaN,NaN
9,0.900,Red Tailed Hawk,16-23,0,1,0,1,0.000,0.000
9,0.900,Red Tailed Hawk,23-5,0,5,0,5,0.000,0.000
9,0.900,Dog,16-23,56,67,0,123,45.528,45.528
9,0.900,Dog,23-5,92,132,0,224,41.071,41.071
9,0.900,Human,16-23,1719,747,0,2466,69.708,69.708
9,0.900,Human,23-5,2150,636,0,2786,77.172,77.172
9,0.900,Wild Turkey,16-23,2,10,0,12,16.667,16.667
9,0.900,Wild Turkey,23-5,0,24,0,24,0.000,0.000
9,0.900,Clark Grebe,16-23,0,0,0,0,NaN,NaN
9,0.900,Clark Grebe,23-5,0,0,0,0,NaN,NaN
9,0.900,Seagull,16-23,0,0,0,0,NaN,NaN
9,0.900,Seagull,23-5,5,9,0,14,35.714,35.714
9,0.900,Surf Scoter,16-23,0,0,0,0,NaN,NaN
9,0.900,Surf Scoter,23-5,0,0,0,0,NaN,NaN
9,0.900,Pigeon,16-23,56,156,0,212,26.415,26.415
9,0.900,Pigeon,23-5,91,187,0,278,32.734,32.734
9,0.900,Pacific Ocean Water,16-23,0,0,0,0,NaN,NaN
9,0.900,Pacific Ocean Water,23-5,0,0,0,0,NaN,NaN
9,0.900,Cat,16-23,19,28,0,47,40.426,40.426
9,0.900,Cat,23-5,21,39,0,60,35.000,35.000
9,0.900,Horse,16-23,7,21,0,28,25.000,25.000
9,0.900,Horse,23-5,31,156,0,187,16.578,16.578
9,0.900,orangutan,16-23,0,0,0,0,NaN,NaN
9,0.900,orangutan,23-5,0,0,0,0,NaN,NaN
9,0.900,Bat,16-23,36,28,0,64,56.250,56.250
9,0.900,Bat,23-5,37,29,0,66,56.061,56.061
9,0.900,Deer,16-23,15,35,0,50,30.000,30.000
9,0.900,Deer,23-5,18,109,0,127,14.173,14.173
9,0.900,Great Horned Owl,16-23,0,0,0,0,NaN,NaN
9,0.900,Great Horned Owl,23-5,0,1,0,1,0.000,0.000
9,0.900,Freshwater Lagoon,16-23,0,0,0,0,NaN,NaN
9,0.900,Freshwater Lagoon,23-5,0,0,0,0,NaN,NaN
9,0.900,Unknown Avian,16-23,0,0,0,0,NaN,NaN
9,0.900,Unknown Avian,23-5,0,0,0,0,NaN,NaN
9,0.900,Human UTI,16-23,77,75,0,152,50.658,50.658
9,0.900,Human UTI,23-5,105,96,0,201,52.239,52.239
9,0.900,unknown,16-23,0,0,0,0,NaN,NaN
9,0.900,unknown,23-5,2,3,0,5,40.000,40.000
9,0.900,SLO Creek Water,16-23,0,0,0,0,NaN,NaN
9,0.900,SLO Creek Water,23-5,0,0,0,0,NaN,NaN
9,0.900,Pig/Swine,16-23,9,8,0,17,52.941,52.941
9,0.900,Pig/Swine,23-5,9,10,0,19,47.368,47.368
9,0.900,Klebsiella,16-23,0,0,0,0,NaN,NaN
9,0.900,Klebsiella,23-5,0,0,0,0,NaN,NaN
9,0.900,Hu Cw and Dg,16-23,12,22,0,34,35.294,35.294
9,0.900,Hu Cw and Dg,23-5,12,22,0,34,35.294,35.294
9,0.900,Ground Squirrel,16-23,90,61,0,151,59.603,59.603
9,0.900,Ground Squirrel,23-5,86,81,0,167,51.497,51.497
9,0.900,Opossum,16-23,0,0,0,0,NaN,NaN
9,0.900,Opossum,23-5,0,0,0,0,NaN,NaN
9,0.900,Cow,16-23,1572,1140,0,2712,57.965,57.965
9,0.900,Cow,23-5,1519,1476,0,2995,50.718,50.718
9,0.900,Deer Mouse,16-23,0,0,0,0,NaN,NaN
9,0.900,Deer Mouse,23-5,0,0,0,0,NaN,NaN
9,0.900,OVERALL,16-23,3780,2564,0,6344,59.584,59.584
9,0.900,OVERALL,23-5,4359,3243,0,7602,57.340,57.340
9,0.950,Chicken,16-23,0,4,0,4,0.000,0.000
9,0.950,Chicken,23-5,8,7,0,15,53.333,53.333
9,0.950,Sea Lion,16-23,0,1,0,1,0.000,0.000
9,0.950,Sea Lion,23-5,1,11,0,12,8.333,8.333
9,0.950,Hu and Cw,16-23,5,7,0,12,41.667,41.667
9,0.950,Hu and Cw,23-5,4,9,0,13,30.769,30.769
9,0.950,Sheep,16-23,51,56,0,107,47.664,47.664
9,0.950,Sheep,23-5,58,41,0,99,58.586,58.586
9,0.950,Hu and Dg,16-23,9,16,0,25,36.000,36.000
9,0.950,Hu and Dg,23-5,20,19,0,39,51.282,51.282
9,0.950,Common Loon,16-23,0,0,0,0,NaN,NaN
9,0.950,Common Loon,23-5,0,3,0,3,0.000,0.000
9,0.950,Red-Winged Blackbird,16-23,0,3,0,3,0.000,0.000
9,0.950,Red-Winged Blackbird,23-5,0,0,0,0,NaN,NaN
9,0.950,Cw,16-23,8,14,0,22,36.364,36.364
9,0.950,Cw,23-5,16,32,0,48,33.333,33.333
9,0.950,Cliff Sparrow,16-23,1,14,0,15,6.667,6.667
9,0.950,Cliff Sparrow,23-5,0,9,0,9,0.000,0.000
9,0.950,Pig,16-23,8,9,0,17,47.059,47.059
9,0.950,Pig,23-5,4,5,0,9,44.444,44.444
9,0.950,Barn Owl,16-23,0,0,0,0,NaN,NaN
9,0.950,Barn Owl,23-5,0,0,0,0,NaN,NaN
9,0.950,Wild Pig,16-23,1,0,0,1,100.000,100.000
9,0.950,Wild Pig,23-5,1,1,0,2,50.000,50.000
9,0.950,Pennington Creek Water,16-23,0,0,0,0,NaN,NaN
9,0.950,Pennington Creek Water,23-5,0,0,0,0,NaN,NaN
9,0.950,Guinni,16-23,0,0,0,0,NaN,NaN
9,0.950,Guinni,23-5,0,0,0,0,NaN,NaN
9,0.950,Racoon,16-23,0,0,0,0,NaN,NaN
9,0.950,Racoon,23-5,0,0,0,0,NaN,NaN
9,0.950,Hu,16-23,16,15,0,31,51.613,51.613
9,0.950,Hu,23-5,21,13,0,34,61.765,61.765
9,0.950,Cw and Dg,16-23,5,15,0,20,25.000,25.000
9,0.950,Cw and Dg,23-5,16,17,0,33,48.485,48.485
9,0.950,Red Wind Blackbird,16-23,0,0,0,0,NaN,NaN
9,0.950,Red Wind Blackbird,23-5,0,0,0,0,NaN,NaN
9,0.950,Tree Swallow,16-23,0,0,0,0,NaN,NaN
9,0.950,Tree Swallow,23-5,0,0,0,0,NaN,NaN
9,0.950,Turkey Vulture,16-23,0,0,0,0,NaN,NaN
9,0.950,Turkey Vulture,23-5,0,0,0,0,NaN,NaN
9,0.950,Dg,16-23,6,10,0,16,37.500,37.500
9,0.950,Dg,23-5,31,30,0,61,50.820,50.820
9,0.950,Western Kingbird,16-23,0,0,0,0,NaN,NaN
9,0.950,Western Kingbird,23-5,0,0,0,0,NaN,NaN
9,0.950,White Crowned Sparrow,16-23,0,1,0,1,0.000,0.000
9,0.950,White Crowned Sparrow,23-5,1,16,0,17,5.882,5.882
9,0.950,Eared Grebe,16-23,0,0,0,0,NaN,NaN
9,0.950,Eared Grebe,23-5,0,15,0,15,0.000,0.000
9,0.950,cougar,16-23,0,0,0,0,NaN,NaN
9,0.950,cougar,23-5,0,0,0,0,NaN,NaN
9,0.950,Ocean Water,16-23,0,0,0,0,NaN,NaN
9,0.950,Ocean Water,23-5,0,0,0,0,NaN,NaN
9,0.950,Red Tailed Hawk,16-23,0,1,0,1,0.000,0.000
9,0.950,Red Tailed Hawk,23-5,0,5,0,5,0.000,0.000
9,0.950,Dog,16-23,56,67,0,123,45.528,45.528
9,0.950,Dog,23-5,92,130,0,222,41.441,41.441
9,0.950,Human,16-23,1719,746,0,2465,69.736,69.736
9,0.950,Human,23-5,2150,629,0,2779,77.366,77.366
9,0.950,Wild Turkey,16-23,2,10,0,12,16.667,16.667
9,0.950,Wild Turkey,23-5,0,24,0,24,0.000,0.000
9,0.950,Clark Grebe,16-23,0,0,0,0,NaN,NaN
9,0.950,Clark Grebe,23-5,0,0,0,0,NaN,NaN
9,0.950,Seagull,16-23,0,0,0,0,NaN,NaN
9,0.950,Seagull,23-5,5,8,0,13,38.462,38.462
9,0.950,Surf Scoter,16-23,0,0,0,0,NaN,NaN
9,0.950,Surf Scoter,23-5,0,0,0,0,NaN,NaN
9,0.950,Pigeon,16-23,57,155,0,212,26.887,26.887
9,0.950,Pigeon,23-5,91,188,0,279,32.616,32.616
9,0.950,Pacific Ocean Water,16-23,0,0,0,0,NaN,NaN
9,0.950,Pacific Ocean Water,23-5,0,0,0,0,NaN,NaN
9,0.950,Cat,16-23,19,28,0,47,40.426,40.426
9,0.950,Cat,23-5,21,39,0,60,35.000,35.000
9,0.950,Horse,16-23,7,21,0,28,25.000,25.000
9,0.950,Horse,23-5,31,156,0,187,16.578,16.578
9,0.950,orangutan,16-23,0,0,0,0,NaN,NaN
9,0.950,orangutan,23-5,0,0,0,0,NaN,NaN
9,0.950,Bat,16-23,36,28,0,64,56.250,56.250
9,0.950,Bat,23-5,37,28,0,65,56.923,56.923
9,0.950,Deer,16-23,15,35,0,50,30.000,30.000
9,0.950,Deer,23-5,18,109,0,127,14.173,14.173
9,0.950,Great Horned Owl,16-23,0,0,0,0,NaN,NaN
9,0.950,Great Horned Owl,23-5,0,1,0,1,0.000,0.000
9,0.950,Freshwater Lagoon,16-23,0,0,0,0,NaN,NaN
9,0.950,Freshwater Lagoon,23-5,0,0,0,0,NaN,NaN
9,0.950,Unknown Avian,16-23,0,0,0,0,NaN,NaN
9,0.950,Unknown Avian,23-5,0,0,0,0,NaN,NaN
9,0.950,Human UTI,16-23,80,76,0,156,51.282,51.282
9,0.950,Human UTI,23-5,104,98,0,202,51.485,51.485
9,0.950,unknown,16-23,0,0,0,0,NaN,NaN
9,0.950,unknown,23-5,2,3,0,5,40.000,40.000
9,0.950,SLO Creek Water,16-23,0,0,0,0,NaN,NaN
9,0.950,SLO Creek Water,23-5,0,0,0,0,NaN,NaN
9,0.950,Pig/Swine,16-23,9,8,0,17,52.941,52.941
9,0.950,Pig/Swine,23-5,9,10,0,19,47.368,47.368
9,0.950,Klebsiella,16-23,0,0,0,0,NaN,NaN
9,0.950,Klebsiella,23-5,0,0,0,0,NaN,NaN
9,0.950,Hu Cw and Dg,16-23,12,22,0,34,35.294,35.294
9,0.950,Hu Cw and Dg,23-5,12,22,0,34,35.294,35.294
9,0.950,Ground Squirrel,16-23,90,61,0,151,59.603,59.603
9,0.950,Ground Squirrel,23-5,86,80,0,166,51.807,51.807
9,0.950,Opossum,16-23,0,0,0,0,NaN,NaN
9,0.950,Opossum,23-5,0,0,0,0,NaN,NaN
9,0.950,Cow,16-23,1572,1120,0,2692,58.395,58.395
9,0.950,Cow,23-5,1518,1473,0,2991,50.752,50.752
9,0.950,Deer Mouse,16-23,0,0,0,0,NaN,NaN
9,0.950,Deer Mouse,23-5,0,0,0,0,NaN,NaN
9,0.950,OVERALL,16-23,3784,2543,0,6327,59.807,59.807
9,0.950,OVERALL,23-5,4357,3231,0,7588,57.420,57.420
9,0.960,Chicken,16-23,0,4,0,4,0.000,0.000
9,0.960,Chicken,23-5,8,7,0,15,53.333,53.333
9,0.960,Sea Lion,16-23,0,1,0,1,0.000,0.000
9,0.960,Sea Lion,23-5,1,11,0,12,8.333,8.333
9,0.960,Hu and Cw,16-23,5,7,0,12,41.667,41.667
9,0.960,Hu and Cw,23-5,4,9,0,13,30.769,30.769
9,0.960,Sheep,16-23,51,56,0,107,47.664,47.664
9,0.960,Sheep,23-5,58,42,0,100,58.000,58.000
9,0.960,Hu and Dg,16-23,9,16,0,25,36.000,36.000
9,0.960,Hu and Dg,23-5,20,19,0,39,51.282,51.282
9,0.960,Common Loon,16-23,0,0,0,0,NaN,NaN
9,0.960,Common Loon,23-5,0,3,0,3,0.000,0.000
9,0.960,Red-Winged Blackbird,16-23,0,3,0,3,0.000,0.000
9,0.960,Red-Winged Blackbird,23-5,0,0,0,0,NaN,NaN
9,0.960,Cw,16-23,8,14,0,22,36.364,36.364
9,0.960,Cw,23-5,16,32,0,48,33.333,33.333
9,0.960,Cliff Sparrow,16-23,1,14,0,15,6.667,6.667
9,0.960,Cliff Sparrow,23-5,0,9,0,9,0.000,0.000
9,0.960,Pig,16-23,8,9,0,17,47.059,47.059
9,0.960,Pig,23-5,4,5,0,9,44.444,44.444
9,0.960,Barn Owl,16-23,0,0,0,0,NaN,NaN
9,0.960,Barn Owl,23-5,0,0,0,0,NaN,NaN
9,0.960,Wild Pig,16-23,1,0,0,1,100.000,100.000
9,0.960,Wild Pig,23-5,1,1,0,2,50.000,50.000
9,0.960,Pennington Creek Water,16-23,0,0,0,0,NaN,NaN
9,0.960,Pennington Creek Water,23-5,0,0,0,0,NaN,NaN
9,0.960,Guinni,16-23,0,0,0,0,NaN,NaN
9,0.960,Guinni,23-5,0,0,0,0,NaN,NaN
9,0.960,Racoon,16-23,0,0,0,0,NaN,NaN
9,0.960,Racoon,23-5,0,0,0,0,NaN,NaN
9,0.960,Hu,16-23,16,15,0,31,51.613,51.613
9,0.960,Hu,23-5,21,13,0,34,61.765,61.765
9,0.960,Cw and Dg,16-23,5,15,0,20,25.000,25.000
9,0.960,Cw and Dg,23-5,16,17,0,33,48.485,48.485
9,0.960,Red Wind Blackbird,16-23,0,0,0,0,NaN,NaN
9,0.960,Red Wind Blackbird,23-5,0,0,0,0,NaN,NaN
9,0.960,Tree Swallow,16-23,0,0,0,0,NaN,NaN
9,0.960,Tree Swallow,23-5,0,0,0,0,NaN,NaN
9,0.960,Turkey Vulture,16-23,0,0,0,0,NaN,NaN
9,0.960,Turkey Vulture,23-5,0,0,0,0,NaN,NaN
9,0.960,Dg,16-23,6,10,0,16,37.500,37.500
9,0.960,Dg,23-5,31,30,0,61,50.820,50.820
9,0.960,Western Kingbird,16-23,0,0,0,0,NaN,NaN
9,0.960,Western Kingbird,23-5,0,0,0,0,NaN,NaN
9,0.960,White Crowned Sparrow,16-23,0,1,0,1,0.000,0.000
9,0.960,White Crowned Sparrow,23-5,1,16,0,17,5.882,5.882
9,0.960,Eared Grebe,16-23,0,0,0,0,NaN,NaN
9,0.960,Eared Grebe,23-5,0,15,0,15,0.000,0.000
9,0.960,cougar,16-23,0,0,0,0,NaN,NaN
9,0.960,cougar,23-5,0,0,0,0,NaN,NaN
9,0.960,Ocean Water,16-23,0,0,0,0,NaN,NaN
9,0.960,Ocean Water,23-5,0,0,0,0,NaN,NaN
9,0.960,Red Tailed Hawk,16-23,0,1,0,1,0.000,0.000
9,0.960,Red Tailed Hawk,23-5,0,5,0,5,0.000,0.000
9,0.960,Dog,16-23,56,67,0,123,45.528,45.528
9,0.960,Dog,23-5,92,125,0,217,42.396,42.396
9,0.960,Human,16-23,1720,744,0,2464,69.805,69.805
9,0.960,Human,23-5,2155,616,0,2771,77.770,77.770
9,0.960,Wild Turkey,16-23,2,10,0,12,16.667,16.667
9,0.960,Wild Turkey,23-5,0,28,0,28,0.000,0.000
9,0.960,Clark Grebe,16-23,0,0,0,0,NaN,NaN
9,0.960,Clark Grebe,23-5,0,0,0,0,NaN,NaN
9,0.960,Seagull,16-23,0,0,0,0,NaN,NaN
9,0.960,Seagull,23-5,5,9,0,14,35.714,35.714
9,0.960,Surf Scoter,16-23,0,0,0,0,NaN,NaN
9,0.960,Surf Scoter,23-5,0,2,0,2,0.000,0.000
9,0.960,Pigeon,16-23,56,155,0,211,26.540,26.540
9,0.960,Pigeon,23-5,92,202,0,294,31.293,31.293
9,0.960,Pacific Ocean Water,16-23,0,0,0,0,NaN,NaN
9,0.960,Pacific Ocean Water,23-5,0,0,0,0,NaN,NaN
9,0.960,Cat,16-23,19,28,0,47,40.426,40.426
9,0.960,Cat,23-5,21,39,0,60,35.000,35.000
9,0.960,Horse,16-23,7,21,0,28,25.000,25.000
9,0.960,Horse,23-5,31,156,0,187,16.578,16.578
9,0.960,orangutan,16-23,0,0,0,0,NaN,NaN
9,0.960,orangutan,23-5,0,0,0,0,NaN,NaN
9,0.960,Bat,16-23,36,28,0,64,56.250,56.250
9,0.960,Bat,23-5,37,28,0,65,56.923,56.923
9,0.960,Deer,16-23,15,35,0,50,30.000,30.000
9,0.960,Deer,23-5,18,109,0,127,14.173,14.173
9,0.960,Great Horned Owl,16-23,0,0,0,0,NaN,NaN
9,0.960,Great Horned Owl,23-5,0,1,0,1,0.000,0.000
9,0.960,Freshwater Lagoon,16-23,0,0,0,0,NaN,NaN
9,0.960,Freshwater Lagoon,23-5,0,0,0,0,NaN,NaN
9,0.960,Unknown Avian,16-23,0,0,0,0,NaN,NaN
9,0.960,Unknown Avian,23-5,0,0,0,0,NaN,NaN
9,0.960,Human UTI,16-23,80,77,0,157,50.955,50.955
9,0.960,Human UTI,23-5,104,97,0,201,51.741,51.741
9,0.960,unknown,16-23,0,0,0,0,NaN,NaN
9,0.960,unknown,23-5,2,3,0,5,40.000,40.000
9,0.960,SLO Creek Water,16-23,0,0,0,0,NaN,NaN
9,0.960,SLO Creek Water,23-5,0,0,0,0,NaN,NaN
9,0.960,Pig/Swine,16-23,9,8,0,17,52.941,52.941
9,0.960,Pig/Swine,23-5,9,10,0,19,47.368,47.368
9,0.960,Klebsiella,16-23,0,0,0,0,NaN,NaN
9,0.960,Klebsiella,23-5,0,0,0,0,NaN,NaN
9,0.960,Hu Cw and Dg,16-23,12,22,0,34,35.294,35.294
9,0.960,Hu Cw and Dg,23-5,12,22,0,34,35.294,35.294
9,0.960,Ground Squirrel,16-23,90,61,0,151,59.603,59.603
9,0.960,Ground Squirrel,23-5,86,82,0,168,51.190,51.190
9,0.960,Opossum,16-23,0,0,0,0,NaN,NaN
9,0.960,Opossum,23-5,0,0,0,0,NaN,NaN
9,0.960,Cow,16-23,1570,1112,0,2682,58.538,58.538
9,0.960,Cow,23-5,1518,1451,0,2969,51.128,51.128
9,0.960,Deer Mouse,16-23,0,0,0,0,NaN,NaN
9,0.960,Deer Mouse,23-5,0,0,0,0,NaN,NaN
9,0.960,OVERALL,16-23,3782,2534,0,6316,59.880,59.880
9,0.960,OVERALL,23-5,4363,3214,0,7577,57.582,57.582
9,0.970,Chicken,16-23,0,4,0,4,0.000,0.000
9,0.970,Chicken,23-5,8,7,0,15,53.333,53.333
9,0.970,Sea Lion,16-23,0,1,0,1,0.000,0.000
9,0.970,Sea Lion,23-5,1,11,0,12,8.333,8.333
9,0.970,Hu and Cw,16-23,5,7,0,12,41.667,41.667
9,0.970,Hu and Cw,23-5,4,9,0,13,30.769,30.769
9,0.970,Sheep,16-23,52,57,0,109,47.706,47.706
9,0.970,Sheep,23-5,58,41,0,99,58.586,58.586
9,0.970,Hu and Dg,16-23,9,16,0,25,36.000,36.000
9,0.970,Hu and Dg,23-5,20,19,0,39,51.282,51.282
9,0.970,Common Loon,16-23,0,0,0,0,NaN,NaN
9,0.970,Common Loon,23-5,0,3,0,3,0.000,0.000
9,0.970,Red-Winged Blackbird,16-23,0,3,0,3,0.000,0.000
9,0.970,Red-Winged Blackbird,23-5,0,0,0,0,NaN,NaN
9,0.970,Cw,16-23,8,15,0,23,34.783,34.783
9,0.970,Cw,23-5,16,32,0,48,33.333,33.333
9,0.970,Cliff Sparrow,16-23,1,14,0,15,6.667,6.667
9,0.970,Cliff Sparrow,23-5,0,9,0,9,0.000,0.000
9,0.970,Pig,16-23,8,9,0,17,47.059,47.059
9,0.970,Pig,23-5,4,5,0,9,44.444,44.444
9,0.970,Barn Owl,16-23,0,0,0,0,NaN,NaN
9,0.970,Barn Owl,23-5,0,0,0,0,NaN,NaN
9,0.970,Wild Pig,16-23,1,0,0,1,100.000,100.000
9,0.970,Wild Pig,23-5,0,1,0,1,0.000,0.000
9,0.970,Pennington Creek Water,16-23,0,0,0,0,NaN,NaN
9,0.970,Pennington Creek Water,23-5,0,0,0,0,NaN,NaN
9,0.970,Guinni,16-23,0,0,0,0,NaN,NaN
9,0.970,Guinni,23-5,0,0,0,0,NaN,NaN
9,0.970,Racoon,16-23,0,0,0,0,NaN,NaN
9,0.970,Racoon,23-5,0,0,0,0,NaN,NaN
9,0.970,Hu,16-23,16,15,0,31,51.613,51.613
9,0.970,Hu,23-5,21,13,0,34,61.765,61.765
9,0.970,Cw and Dg,16-23,5,15,0,20,25.000,25.000
9,0.970,Cw and Dg,23-5,16,17,0,33,48.485,48.485
9,0.970,Red Wind Blackbird,16-23,0,0,0,0,NaN,NaN
9,0.970,Red Wind Blackbird,23-5,0,0,0,0,NaN,NaN
9,0.970,Tree Swallow,16-23,0,0,0,0,NaN,NaN
9,0.970,Tree Swallow,23-5,0,0,0,0,NaN,NaN
9,0.970,Turkey Vulture,16-23,0,0,0,0,NaN,NaN
9,0.970,Turkey Vulture,23-5,0,0,0,0,NaN,NaN
9,0.970,Dg,16-23,6,10,0,16,37.500,37.500
9,0.970,Dg,23-5,31,29,0,60,51.667,51.667
9,0.970,Western Kingbird,16-23,0,0,0,0,NaN,NaN
9,0.970,Western Kingbird,23-5,0,0,0,0,NaN,NaN
9,0.970,White Crowned Sparrow,16-23,0,1,0,1,0.000,0.000
9,0.970,White Crowned Sparrow,23-5,1,16,0,17,5.882,5.882
9,0.970,Eared Grebe,16-23,0,0,0,0,NaN,NaN
9,0.970,Eared Grebe,23-5,0,15,0,15,0.000,0.000
9,0.970,cougar,16-23,0,0,0,0,NaN,NaN
9,0.970,cougar,23-5,0,0,0,0,NaN,NaN
9,0.970,Ocean Water,16-23,0,0,0,0,NaN,NaN
9,0.970,Ocean Water,23-5,0,0,0,0,NaN,NaN
9,0.970,Red Tailed Hawk,16-23,0,1,0,1,0.000,0.000
9,0.970,Red Tailed Hawk,23-5,0,5,0,5,0.000,0.000
9,0.970,Dog,16-23,56,67,0,123,45.528,45.528
9,0.970,Dog,23-5,92,124,0,216,42.593,42.593
9,0.970,Human,16-23,1720,743,0,2463,69.834,69.834
9,0.970,Human,23-5,2154,616,0,2770,77.762,77.762
9,0.970,Wild Turkey,16-23,2,12,0,14,14.286,14.286
9,0.970,Wild Turkey,23-5,2,27,0,29,6.897,6.897
9,0.970,Clark Grebe,16-23,0,0,0,0,NaN,NaN
9,0.970,Clark Grebe,23-5,0,0,0,0,NaN,NaN
9,0.970,Seagull,16-23,0,0,0,0,NaN,NaN
9,0.970,Seagull,23-5,5,10,0,15,33.333,33.333
9,0.970,Surf Scoter,16-23,0,0,0,0,NaN,NaN
9,0.970,Surf Scoter,23-5,0,2,0,2,0.000,0.000
9,0.970,Pigeon,16-23,54,153,0,207,26.087,26.087
9,0.970,Pigeon,23-5,92,220,0,312,29.487,29.487
9,0.970,Pacific Ocean Water,16-23,0,0,0,0,NaN,NaN
9,0.970,Pacific Ocean Water,23-5,0,0,0,0,NaN,NaN
9,0.970,Cat,16-23,19,28,0,47,40.426,40.426
9,0.970,Cat,23-5,21,36,0,57,36.842,36.842
9,0.970,Horse,16-23,7,21,0,28,25.000,25.000
9,0.970,Horse,23-5,31,156,0,187,16.578,16.578
9,0.970,orangutan,16-23,0,0,0,0,NaN,NaN
9,0.970,orangutan,23-5,0,0,0,0,NaN,NaN
9,0.970,Bat,16-23,36,28,0,64,56.250,56.250
9,0.970,Bat,23-5,37,28,0,65,56.923,56.923
9,0.970,Deer,16-23,15,35,0,50,30.000,30.000
9,0.970,Deer,23-5,18,109,0,127,14.173,14.173
9,0.970,Great Horned Owl,16-23,0,0,0,0,NaN,NaN
9,0.970,Great Horned Owl,23-5,0,1,0,1,0.000,0.000
9,0.970,Freshwater Lagoon,16-23,0,0,0,0,NaN,NaN
9,0.970,Freshwater Lagoon,23-5,0,0,0,0,NaN,NaN
9,0.970,Unknown Avian,16-23,0,0,0,0,NaN,NaN
9,0.970,Unknown Avian,23-5,0,0,0,0,NaN,NaN
9,0.970,Human UTI,16-23,80,78,0,158,50.633,50.633
9,0.970,Human UTI,23-5,103,96,0,199,51.759,51.759
9,0.970,unknown,16-23,0,0,0,0,NaN,NaN
9,0.970,unknown,23-5,2,3,0,5,40.000,40.000
9,0.970,SLO Creek Water,16-23,0,0,0,0,NaN,NaN
9,0.970,SLO Creek Water,23-5,0,0,0,0,NaN,NaN
9,0.970,Pig/Swine,16-23,9,8,0,17,52.941,52.941
9,0.970,Pig/Swine,23-5,9,10,0,19,47.368,47.368
9,0.970,Klebsiella,16-23,0,0,0,0,NaN,NaN
9,0.970,Klebsiella,23-5,0,0,0,0,NaN,NaN
9,0.970,Hu Cw and Dg,16-23,12,22,0,34,35.294,35.294
9,0.970,Hu Cw and Dg,23-5,12,22,0,34,35.294,35.294
9,0.970,Ground Squirrel,16-23,90,59,0,149,60.403,60.403
9,0.970,Ground Squirrel,23-5,86,80,0,166,51.807,51.807
9,0.970,Opossum,16-23,0,0,0,0,NaN,NaN
9,0.970,Opossum,23-5,0,0,0,0,NaN,NaN
9,0.970,Cow,16-23,1564,1109,0,2673,58.511,58.511
9,0.970,Cow,23-5,1515,1425,0,2940,51.531,51.531
9,0.970,Deer Mouse,16-23,0,0,0,0,NaN,NaN
9,0.970,Deer Mouse,23-5,0,0,0,0,NaN,NaN
9,0.970,OVERALL,16-23,3775,2531,0,6306,59.864,59.864
9,0.970,OVERALL,23-5,4359,3197,0,7556,57.689,57.689
9,0.980,Chicken,16-23,0,4,0,4,0.000,0.000
9,0.980,Chicken,23-5,9,7,0,16,56.250,56.250
9,0.980,Sea Lion,16-23,0,1,0,1,0.000,0.000
9,0.980,Sea Lion,23-5,1,10,0,11,9.091,9.091
9,0.980,Hu and Cw,16-23,5,7,0,12,41.667,41.667
9,0.980,Hu and Cw,23-5,4,19,0,23,17.391,17.391
9,0.980,Sheep,16-23,52,55,0,107,48.598,48.598
9,0.980,Sheep,23-5,57,40,0,97,58.763,58.763
9,0.980,Hu and Dg,16-23,9,15,0,24,37.500,37.500
9,0.980,Hu and Dg,23-5,20,17,0,37,54.054,54.054
9,0.980,Common Loon,16-23,0,0,0,0,NaN,NaN
9,0.980,Common Loon,23-5,0,3,0,3,0.000,0.000
9,0.980,Red-Winged Blackbird,16-23,0,3,0,3,0.000,0.000
9,0.980,Red-Winged Blackbird,23-5,0,0,0,0,NaN,NaN
9,0.980,Cw,16-23,8,14,0,22,36.364,36.364
9,0.980,Cw,23-5,16,32,0,48,33.333,33.333
9,0.980,Cliff Sparrow,16-23,1,13,0,14,7.143,7.143
9,0.980,Cliff Sparrow,23-5,0,9,0,9,0.000,0.000
9,0.980,Pig,16-23,8,9,0,17,47.059,47.059
9,0.980,Pig,23-5,4,5,0,9,44.444,44.444
9,0.980,Barn Owl,16-23,0,0,0,0,NaN,NaN
9,0.980,Barn Owl,23-5,0,0,0,0,NaN,NaN
9,0.980,Wild Pig,16-23,1,0,0,1,100.000,100.000
9,0.980,Wild Pig,23-5,0,1,0,1,0.000,0.000
9,0.980,Pennington Creek Water,16-23,0,0,0,0,NaN,NaN
9,0.980,Pennington Creek Water,23-5,0,0,0,0,NaN,NaN
9,0.980,Guinni,16-23,0,0,0,0,NaN,NaN
9,0.980,Guinni,23-5,0,0,0,0,NaN,NaN
9,0.980,Racoon,16-23,0,0,0,0,NaN,NaN
9,0.980,Racoon,23-5,0,0,0,0,NaN,NaN
9,0.980,Hu,16-23,16,15,0,31,51.613,51.613
9,0.980,Hu,23-5,21,14,0,35,60.000,60.000
9,0.980,Cw and Dg,16-23,5,15,0,20,25.000,25.000
9,0.980,Cw and Dg,23-5,16,18,0,34,47.059,47.059
9,0.980,Red Wind Blackbird,16-23,0,0,0,0,NaN,NaN
9,0.980,Red Wind Blackbird,23-5,0,0,0,0,NaN,NaN
9,0.980,Tree Swallow,16-23,0,0,0,0,NaN,NaN
9,0.980,Tree Swallow,23-5,0,0,0,0,NaN,NaN
9,0.980,Turkey Vulture,16-23,0,0,0,0,NaN,NaN
9,0.980,Turkey Vulture,23-5,0,0,0,0,NaN,NaN
9,0.980,Dg,16-23,6,10,0,16,37.500,37.500
9,0.980,Dg,23-5,31,22,0,53,58.491,58.491
9,0.980,Western Kingbird,16-23,0,0,0,0,NaN,NaN
9,0.980,Western Kingbird,23-5,0,0,0,0,NaN,NaN
9,0.980,White Crowned Sparrow,16-23,0,1,0,1,0.000,0.000
9,0.980,White Crowned Sparrow,23-5,1,17,0,18,5.556,5.556
9,0.980,Eared Grebe,16-23,0,0,0,0,NaN,NaN
9,0.980,Eared Grebe,23-5,0,15,0,15,0.000,0.000
9,0.980,cougar,16-23,0,0,0,0,NaN,NaN
9,0.980,cougar,23-5,0,0,0,0,NaN,NaN
9,0.980,Ocean Water,16-23,0,0,0,0,NaN,NaN
9,0.980,Ocean Water,23-5,0,0,0,0,NaN,NaN
9,0.980,Red Tailed Hawk,16-23,0,1,0,1,0.000,0.000
9,0.980,Red Tailed Hawk,23-5,0,4,0,4,0.000,0.000
9,0.980,Dog,16-23,55,72,0,127,43.307,43.307
9,0.980,Dog,23-5,92,122,0,214,42.991,42.991
9,0.980,Human,16-23,1719,735,0,2454,70.049,70.049
9,0.980,Human,23-5,2153,605,0,2758,78.064,78.064
9,0.980,Wild Turkey,16-23,2,12,0,14,14.286,14.286
9,0.980,Wild Turkey,23-5,4,34,0,38,10.526,10.526
9,0.980,Clark Grebe,16-23,0,0,0,0,NaN,NaN
9,0.980,Clark Grebe,23-5,0,0,0,0,NaN,NaN
9,0.980,Seagull,16-23,0,0,0,0,NaN,NaN
9,0.980,Seagull,23-5,7,8,0,15,46.667,46.667
9,0.980,Surf Scoter,16-23,0,0,0,0,NaN,NaN
9,0.980,Surf Scoter,23-5,2,0,0,2,100.000,100.000
9,0.980,Pigeon,16-23,54,151,0,205,26.341,26.341
9,0.980,Pigeon,23-5,91,229,0,320,28.438,28.438
9,0.980,Pacific Ocean Water,16-23,0,0,0,0,NaN,NaN
9,0.980,Pacific Ocean Water,23-5,0,0,0,0,NaN,NaN
9,0.980,Cat,16-23,19,27,0,46,41.304,41.304
9,0.980,Cat,23-5,22,31,0,53,41.509,41.509
9,0.980,Horse,16-23,7,20,0,27,25.926,25.926
9,0.980,Horse,23-5,31,153,0,184,16.848,16.848
9,0.980,orangutan,16-23,0,0,0,0,NaN,NaN
9,0.980,orangutan,23-5,0,0,0,0,NaN,NaN
9,0.980,Bat,16-23,36,28,0,64,56.250,56.250
9,0.980,Bat,23-5,37,27,0,64,57.813,57.813
9,0.980,Deer,16-23,15,35,0,50,30.000,30.000
9,0.980,Deer,23-5,18,109,0,127,14.173,14.173
9,0.980,Great Horned Owl,16-23,0,0,0,0,NaN,NaN
9,0.980,Great Horned Owl,23-5,0,1,0,1,0.000,0.000
9,0.980,Freshwater Lagoon,16-23,0,0,0,0,NaN,NaN
9,0.980,Freshwater Lagoon,23-5,0,0,0,0,NaN,NaN
9,0.980,Unknown Avian,16-23,0,0,0,0,NaN,NaN
9,0.980,Unknown Avian,23-5,0,0,0,0,NaN,NaN
9,0.980,Human UTI,16-23,80,80,0,160,50.000,50.000
9,0.980,Human UTI,23-5,103,92,0,195,52.821,52.821
9,0.980,unknown,16-23,0,0,0,0,NaN,NaN
9,0.980,unknown,23-5,2,4,0,6,33.333,33.333
9,0.980,SLO Creek Water,16-23,0,0,0,0,NaN,NaN
9,0.980,SLO Creek Water,23-5,0,0,0,0,NaN,NaN
9,0.980,Pig/Swine,16-23,9,8,0,17,52.941,52.941
9,0.980,Pig/Swine,23-5,9,10,0,19,47.368,47.368
9,0.980,Klebsiella,16-23,0,0,0,0,NaN,NaN
9,0.980,Klebsiella,23-5,0,0,0,0,NaN,NaN
9,0.980,Hu Cw and Dg,16-23,12,22,0,34,35.294,35.294
9,0.980,Hu Cw and Dg,23-5,12,20,0,32,37.500,37.500
9,0.980,Ground Squirrel,16-23,92,60,0,152,60.526,60.526
9,0.980,Ground Squirrel,23-5,86,77,0,163,52.761,52.761
9,0.980,Opossum,16-23,0,0,0,0,NaN,NaN
9,0.980,Opossum,23-5,0,0,0,0,NaN,NaN
9,0.980,Cow,16-23,1556,1096,0,2652,58.673,58.673
9,0.980,Cow,23-5,1510,1397,0,2907,51.944,51.944
9,0.980,Deer Mouse,16-23,0,0,0,0,NaN,NaN
9,0.980,Deer Mouse,23-5,0,0,0,0,NaN,NaN
9,0.980,OVERALL,16-23,3767,2509,0,6276,60.022,60.022
9,0.980,OVERALL,23-5,4359,3152,0,7511,58.035,58.035
9,0.990,Chicken,16-23,2,10,0,12,16.667,16.667
9,0.990,Chicken,23-5,10,7,0,17,58.824,58.824
9,0.990,Sea Lion,16-23,0,1,0,1,0.000,0.000
9,0.990,Sea Lion,23-5,2,7,0,9,22.222,22.222
9,0.990,Hu and Cw,16-23,6,7,0,13,46.154,46.154
9,0.990,Hu and Cw,23-5,6,24,0,30,20.000,20.000
9,0.990,Sheep,16-23,51,55,0,106,48.113,48.113
9,0.990,Sheep,23-5,59,39,0,98,60.204,60.204
9,0.990,Hu and Dg,16-23,9,16,0,25,36.000,36.000
9,0.990,Hu and Dg,23-5,20,14,0,34,58.824,58.824
9,0.990,Common Loon,16-23,0,0,0,0,NaN,NaN
9,0.990,Common Loon,23-5,0,3,0,3,0.000,0.000
9,0.990,Red-Winged Blackbird,16-23,0,4,0,4,0.000,0.000
9,0.990,Red-Winged Blackbird,23-5,0,0,0,0,NaN,NaN
9,0.990,Cw,16-23,8,14,0,22,36.364,36.364
9,0.990,Cw,23-5,20,34,0,54,37.037,37.037
9,0.990,Cliff Sparrow,16-23,1,13,0,14,7.143,7.143
9,0.990,Cliff Sparrow,23-5,0,13,0,13,0.000,0.000
9,0.990,Pig,16-23,8,10,0,18,44.444,44.444
9,0.990,Pig,23-5,8,9,0,17,47.059,47.059
9,0.990,Barn Owl,16-23,0,0,0,0,NaN,NaN
9,0.990,Barn Owl,23-5,0,0,0,0,NaN,NaN
9,0.990,Wild Pig,16-23,1,2,0,3,33.333,33.333
9,0.990,Wild Pig,23-5,0,2,0,2,0.000,0.000
9,0.990,Pennington Creek Water,16-23,0,0,0,0,NaN,NaN
9,0.990,Pennington Creek Water,23-5,0,0,0,0,NaN,NaN
9,0.990,Guinni,16-23,0,0,0,0,NaN,NaN
9,0.990,Guinni,23-5,0,0,0,0,NaN,NaN
9,0.990,Racoon,16-23,0,0,0,0,NaN,NaN
9,0.990,Racoon,23-5,0,1,0,1,0.000,0.000
9,0.990,Hu,16-23,16,13,0,29,55.172,55.172
9,0.990,Hu,23-5,21,11,0,32,65.625,65.625
9,0.990,Cw and Dg,16-23,5,15,0,20,25.000,25.000
9,0.990,Cw and Dg,23-5,16,12,0,28,57.143,57.143
9,0.990,Red Wind Blackbird,16-23,0,0,0,0,NaN,NaN
9,0.990,Red Wind Blackbird,23-5,0,0,0,0,NaN,NaN
9,0.990,Tree Swallow,16-23,0,0,0,0,NaN,NaN
9,0.990,Tree Swallow,23-5,0,0,0,0,NaN,NaN
9,0.990,Turkey Vulture,16-23,0,0,0,0,NaN,NaN
9,0.990,Turkey Vulture,23-5,0,0,0,0,NaN,NaN
9,0.990,Dg,16-23,6,10,0,16,37.500,37.500
9,0.990,Dg,23-5,31,17,0,48,64.583,64.583
9,0.990,Western Kingbird,16-23,0,0,0,0,NaN,NaN
9,0.990,Western Kingbird,23-5,0,0,0,0,NaN,NaN
9,0.990,White Crowned Sparrow,16-23,0,1,0,1,0.000,0.000
9,0.990,White Crowned Sparrow,23-5,1,17,0,18,5.556,5.556
9,0.990,Eared Grebe,16-23,0,0,0,0,NaN,NaN
9,0.990,Eared Grebe,23-5,0,14,0,14,0.000,0.000
9,0.990,cougar,16-23,0,1,0,1,0.000,0.000
9,0.990,cougar,23-5,0,0,0,0,NaN,NaN
9,0.990,Ocean Water,16-23,0,0,0,0,NaN,NaN
9,0.990,Ocean Water,23-5,0,0,0,0,NaN,NaN
9,0.990,Red Tailed Hawk,16-23,0,1,0,1,0.000,0.000
9,0.990,Red Tailed Hawk,23-5,0,5,0,5,0.000,0.000
9,0.990,Dog,16-23,58,74,0,132,43.939,43.939
9,0.990,Dog,23-5,95,115,0,210,45.238,45.238
9,0.990,Human,16-23,1698,699,0,2397,70.839,70.839
9,0.990,Human,23-5,2134,560,0,2694,79.213,79.213
9,0.990,Wild Turkey,16-23,4,17,0,21,19.048,19.048
9,0.990,Wild Turkey,23-5,4,33,0,37,10.811,10.811
9,0.990,Clark Grebe,16-23,0,0,0,0,NaN,NaN
9,0.990,Clark Grebe,23-5,2,3,0,5,40.000,40.000
9,0.990,Seagull,16-23,0,0,0,0,NaN,NaN
9,0.990,Seagull,23-5,12,7,0,19,63.158,63.158
9,0.990,Surf Scoter,16-23,0,0,0,0,NaN,NaN
9,0.990,Surf Scoter,23-5,2,0,0,2,100.000,100.000
9,0.990,Pigeon,16-23,59,143,0,202,29.208,29.208
9,0.990,Pigeon,23-5,96,235,0,331,29.003,29.003
9,0.990,Pacific Ocean Water,16-23,0,0,0,0,NaN,NaN
9,0.990,Pacific Ocean Water,23-5,0,0,0,0,NaN,NaN
9,0.990,Cat,16-23,19,27,0,46,41.304,41.304
9,0.990,Cat,23-5,22,34,0,56,39.286,39.286
9,0.990,Horse,16-23,10,21,0,31,32.258,32.258
9,0.990,Horse,23-5,31,156,0,187,16.578,16.578
9,0.990,orangutan,16-23,0,0,0,0,NaN,NaN
9,0.990,orangutan,23-5,0,0,0,0,NaN,NaN
9,0.990,Bat,16-23,36,26,0,62,58.065,58.065
9,0.990,Bat,23-5,37,26,0,63,58.730,58.730
9,0.990,Deer,16-23,15,36,0,51,29.412,29.412
9,0.990,Deer,23-5,18,103,0,121,14.876,14.876
9,0.990,Great Horned Owl,16-23,0,0,0,0,NaN,NaN
9,0.990,Great Horned Owl,23-5,0,1,0,1,0.000,0.000
9,0.990,Freshwater Lagoon,16-23,0,0,0,0,NaN,NaN
9,0.990,Freshwater Lagoon,23-5,0,0,0,0,NaN,NaN
9,0.990,Unknown Avian,16-23,0,0,0,0,NaN,NaN
9,0.990,Unknown Avian,23-5,0,0,0,0,NaN,NaN
9,0.990,Human UTI,16-23,84,76,0,160,52.500,52.500
9,0.990,Human UTI,23-5,104,76,0,180,57.778,57.778
9,0.990,unknown,16-23,0,0,0,0,NaN,NaN
9,0.990,unknown,23-5,2,6,0,8,25.000,25.000
9,0.990,SLO Creek Water,16-23,0,0,0,0,NaN,NaN
9,0.990,SLO Creek Water,23-5,0,0,0,0,NaN,NaN
9,0.990,Pig/Swine,16-23,8,9,0,17,47.059,47.059
9,0.990,Pig/Swine,23-5,9,10,0,19,47.368,47.368
9,0.990,Klebsiella,16-23,0,0,0,0,NaN,NaN
9,0.990,Klebsiella,23-5,0,0,0,0,NaN,NaN
9,0.990,Hu Cw and Dg,16-23,12,22,0,34,35.294,35.294
9,0.990,Hu Cw and Dg,23-5,12,19,0,31,38.710,38.710
9,0.990,Ground Squirrel,16-23,94,59,0,153,61.438,61.438
9,0.990,Ground Squirrel,23-5,88,81,0,169,52.071,52.071
9,0.990,Opossum,16-23,1,0,0,1,100.000,100.000
9,0.990,Opossum,23-5,2,0,0,2,100.000,100.000
9,0.990,Cow,16-23,1521,1000,0,2521,60.333,60.333
9,0.990,Cow,23-5,1475,1272,0,2747,53.695,53.695
9,0.990,Deer Mouse,16-23,0,0,0,0,NaN,NaN
9,0.990,Deer Mouse,23-5,0,0,0,0,NaN,NaN
9,0.990,OVERALL,16-23,3732,2382,0,6114,61.040,61.040
9,0.990,OVERALL,23-5,4339,2966,0,7305,59.398,59.398
9,1.000,Chicken,16-23,0,0,0,0,NaN,NaN
9,1.000,Chicken,23-5,0,0,0,0,NaN,NaN
9,1.000,Sea Lion,16-23,0,0,0,0,NaN,NaN
9,1.000,Sea Lion,23-5,0,0,0,0,NaN,NaN
9,1.000,Hu and Cw,16-23,0,0,0,0,NaN,NaN
9,1.000,Hu and Cw,23-5,0,0,0,0,NaN,NaN
9,1.000,Sheep,16-23,0,0,0,0,NaN,NaN
9,1.000,Sheep,23-5,0,0,0,0,NaN,NaN
9,1.000,Hu and Dg,16-23,0,0,0,0,NaN,NaN
9,1.000,Hu and Dg,23-5,0,0,0,0,NaN,NaN
9,1.000,Common Loon,16-23,0,0,0,0,NaN,NaN
9,1.000,Common Loon,23-5,0,0,0,0,NaN,NaN
9,1.000,Red-Winged Blackbird,16-23,0,0,0,0,NaN,NaN
9,1.000,Red-Winged Blackbird,23-5,0,0,0,0,NaN,NaN
9,1.000,Cw,16-23,0,0,0,0,NaN,NaN
9,1.000,Cw,23-5,0,0,0,0,NaN,NaN
9,1.000,Cliff Sparrow,16-23,0,0,0,0,NaN,NaN
9,1.000,Cliff Sparrow,23-5,0,0,0,0,NaN,NaN
9,1.000,Pig,16-23,0,0,0,0,NaN,NaN
9,1.000,Pig,23-5,0,0,0,0,NaN,NaN
9,1.000,Barn Owl,16-23,0,0,0,0,NaN,NaN
9,1.000,Barn Owl,23-5,0,0,0,0,NaN,NaN
9,1.000,Wild Pig,16-23,0,0,0,0,NaN,NaN
9,1.000,Wild Pig,23-5,0,0,0,0,NaN,NaN
9,1.000,Pennington Creek Water,16-23,0,0,0,0,NaN,NaN
9,1.000,Pennington Creek Water,23-5,0,0,0,0,NaN,NaN
9,1.000,Guinni,16-23,0,0,0,0,NaN,NaN
9,1.000,Guinni,23-5,0,0,0,0,NaN,NaN
9,1.000,Racoon,16-23,0,0,0,0,NaN,NaN
9,1.000,Racoon,23-5,0,0,0,0,NaN,NaN
9,1.000,Hu,16-23,0,0,0,0,NaN,NaN
9,1.000,Hu,23-5,0,0,0,0,NaN,NaN
9,1.000,Cw and Dg,16-23,0,0,0,0,NaN,NaN
9,1.000,Cw and Dg,23-5,0,0,0,0,NaN,NaN
9,1.000,Red Wind Blackbird,16-23,0,0,0,0,NaN,NaN
9,1.000,Red Wind Blackbird,23-5,0,0,0,0,NaN,NaN
9,1.000,Tree Swallow,16-23,0,0,0,0,NaN,NaN
9,1.000,Tree Swallow,23-5,0,0,0,0,NaN,NaN
9,1.000,Turkey Vulture,16-23,0,0,0,0,NaN,NaN
9,1.000,Turkey Vulture,23-5,0,0,0,0,NaN,NaN
9,1.000,Dg,16-23,0,0,0,0,NaN,NaN
9,1.000,Dg,23-5,0,0,0,0,NaN,NaN
9,1.000,Western Kingbird,16-23,0,0,0,0,NaN,NaN
9,1.000,Western Kingbird,23-5,0,0,0,0,NaN,NaN
9,1.000,White Crowned Sparrow,16-23,0,0,0,0,NaN,NaN
9,1.000,White Crowned Sparrow,23-5,0,0,0,0,NaN,NaN
9,1.000,Eared Grebe,16-23,0,0,0,0,NaN,NaN
9,1.000,Eared Grebe,23-5,0,0,0,0,NaN,NaN
9,1.000,cougar,16-23,0,0,0,0,NaN,NaN
9,1.000,cougar,23-5,0,0,0,0,NaN,NaN
9,1.000,Ocean Water,16-23,0,0,0,0,NaN,NaN
9,1.000,Ocean Water,23-5,0,0,0,0,NaN,NaN
9,1.000,Red Tailed Hawk,16-23,0,0,0,0,NaN,NaN
9,1.000,Red Tailed Hawk,23-5,0,0,0,0,NaN,NaN
9,1.000,Dog,16-23,0,0,0,0,NaN,NaN
9,1.000,Dog,23-5,0,0,0,0,NaN,NaN
9,1.000,Human,16-23,0,0,0,0,NaN,NaN
9,1.000,Human,23-5,0,0,0,0,NaN,NaN
9,1.000,Wild Turkey,16-23,0,0,0,0,NaN,NaN
9,1.000,Wild Turkey,23-5,0,0,0,0,NaN,NaN
9,1.000,Clark Grebe,16-23,0,0,0,0,NaN,NaN
9,1.000,Clark Grebe,23-5,0,0,0,0,NaN,NaN
9,1.000,Seagull,16-23,0,0,0,0,NaN,NaN
9,1.000,Seagull,23-5,0,0,0,0,NaN,NaN
9,1.000,Surf Scoter,16-23,0,0,0,0,NaN,NaN
9,1.000,Surf Scoter,23-5,0,0,0,0,NaN,NaN
9,1.000,Pigeon,16-23,0,0,0,0,NaN,NaN
9,1.000,Pigeon,23-5,0,0,0,0,NaN,NaN
9,1.000,Pacific Ocean Water,16-23,0,0,0,0,NaN,NaN
9,1.000,Pacific Ocean Water,23-5,0,0,0,0,NaN,NaN
9,1.000,Cat,16-23,0,0,0,0,NaN,NaN
9,1.000,Cat,23-5,0,0,0,0,NaN,NaN
9,1.000,Horse,16-23,0,0,0,0,NaN,NaN
9,1.000,Horse,23-5,0,0,0,0,NaN,NaN
9,1.000,orangutan,16-23,0,0,0,0,NaN,NaN
9,1.000,orangutan,23-5,0,0,0,0,NaN,NaN
9,1.000,Bat,16-23,0,0,0,0,NaN,NaN
9,1.000,Bat,23-5,0,0,0,0,NaN,NaN
9,1.000,Deer,16-23,0,0,0,0,NaN,NaN
9,1.000,Deer,23-5,0,0,0,0,NaN,NaN
9,1.000,Great Horned Owl,16-23,0,0,0,0,NaN,NaN
9,1.000,Great Horned Owl,23-5,0,0,0,0,NaN,NaN
9,1.000,Freshwater Lagoon,16-23,0,0,0,0,NaN,NaN
9,1.000,Freshwater Lagoon,23-5,0,0,0,0,NaN,NaN
9,1.000,Unknown Avian,16-23,0,0,0,0,NaN,NaN
9,1.000,Unknown Avian,23-5,0,0,0,0,NaN,NaN
9,1.000,Human UTI,16-23,0,0,0,0,NaN,NaN
9,1.000,Human UTI,23-5,0,0,0,0,NaN,NaN
9,1.000,unknown,16-23,0,0,0,0,NaN,NaN
9,1.000,unknown,23-5,0,0,0,0,NaN,NaN
9,1.000,SLO Creek Water,16-23,0,0,0,0,NaN,NaN
9,1.000,SLO Creek Water,23-5,0,0,0,0,NaN,NaN
9,1.000,Pig/Swine,16-23,0,0,0,0,NaN,NaN
9,1.000,Pig/Swine,23-5,0,0,0,0,NaN,NaN
9,1.000,Klebsiella,16-23,0,0,0,0,NaN,NaN
9,1.000,Klebsiella,23-5,0,0,0,0,NaN,NaN
9,1.000,Hu Cw and Dg,16-23,0,0,0,0,NaN,NaN
9,1.000,Hu Cw and Dg,23-5,0,0,0,0,NaN,NaN
9,1.000,Ground Squirrel,16-23,0,0,0,0,NaN,NaN
9,1.000,Ground Squirrel,23-5,0,0,0,0,NaN,NaN
9,1.000,Opossum,16-23,0,0,0,0,NaN,NaN
9,1.000,Opossum,23-5,0,0,0,0,NaN,NaN
9,1.000,Cow,16-23,0,0,0,0,NaN,NaN
9,1.000,Cow,23-5,0,0,0,0,NaN,NaN
9,1.000,Deer Mouse,16-23,0,0,0,0,NaN,NaN
9,1.000,Deer Mouse,23-5,0,0,0,0,NaN,NaN
9,1.000,OVERALL,16-23,0,0,0,0,NaN,NaN
9,1.000,OVERALL,23-5,0,0,0,0,NaN,NaN
10,0.000,Chicken,16-23,0,1,0,1,0.000,0.000
10,0.000,Chicken,23-5,7,9,0,16,43.750,43.750
10,0.000,Sea Lion,16-23,0,1,0,1,0.000,0.000
10,0.000,Sea Lion,23-5,0,11,0,11,0.000,0.000
10,0.000,Hu and Cw,16-23,2,7,0,9,22.222,22.222
10,0.000,Hu and Cw,23-5,2,10,0,12,16.667,16.667
10,0.000,Sheep,16-23,48,50,0,98,48.980,48.980
10,0.000,Sheep,23-5,58,43,0,101,57.426,57.426
10,0.000,Hu and Dg,16-23,7,10,0,17,41.176,41.176
10,0.000,Hu and Dg,23-5,19,21,0,40,47.500,47.500
10,0.000,Common Loon,16-23,0,0,0,0,NaN,NaN
10,0.000,Common Loon,23-5,0,1,0,1,0.000,0.000
10,0.000,Red-Winged Blackbird,16-23,0,1,0,1,0.000,0.000
10,0.000,Red-Winged Blackbird,23-5,0,0,0,0,NaN,NaN
10,0.000,Cw,16-23,7,13,0,20,35.000,35.000
10,0.000,Cw,23-5,14,26,0,40,35.000,35.000
10,0.000,Cliff Sparrow,16-23,1,12,0,13,7.692,7.692
10,0.000,Cliff Sparrow,23-5,0,5,0,5,0.000,0.000
10,0.000,Pig,16-23,9,8,0,17,52.941,52.941
10,0.000,Pig,23-5,4,5,0,9,44.444,44.444
10,0.000,Barn Owl,16-23,0,0,0,0,NaN,NaN
10,0.000,Barn Owl,23-5,0,0,0,0,NaN,NaN
10,0.000,Wild Pig,16-23,0,0,0,0,NaN,NaN
10,0.000,Wild Pig,23-5,1,2,0,3,33.333,33.333
10,0.000,Pennington Creek Water,16-23,0,0,0,0,NaN,NaN
10,0.000,Pennington Creek Water,23-5,0,0,0,0,NaN,NaN
10,0.000,Guinni,16-23,0,0,0,0,NaN,NaN
10,0.000,Guinni,23-5,0,0,0,0,NaN,NaN
10,0.000,Racoon,16-23,0,0,0,0,NaN,NaN
10,0.000,Racoon,23-5,0,0,0,0,NaN,NaN
10,0.000,Hu,16-23,15,14,0,29,51.724,51.724
10,0.000,Hu,23-5,23,14,0,37,62.162,62.162
10,0.000,Cw and Dg,16-23,5,15,0,20,25.000,25.000
10,0.000,Cw and Dg,23-5,15,16,0,31,48.387,48.387
10,0.000,Red Wind Blackbird,16-23,0,0,0,0,NaN,NaN
10,0.000,Red Wind Blackbird,23-5,0,0,0,0,NaN,NaN
10,0.000,Tree Swallow,16-23,0,0,0,0,NaN,NaN
10,0.000,Tree Swallow,23-5,0,0,0,0,NaN,NaN
10,0.000,Turkey Vulture,16-23,0,0,0,0,NaN,NaN
10,0.000,Turkey Vulture,23-5,0,0,0,0,NaN,NaN
10,0.000,Dg,16-23,5,9,0,14,35.714,35.714
10,0.000,Dg,23-5,31,31,0,62,50.000,50.000
10,0.000,Western Kingbird,16-23,0,0,0,0,NaN,NaN
10,0.000,Western Kingbird,23-5,0,0,0,0,NaN,NaN
10,0.000,White Crowned Sparrow,16-23,0,1,0,1,0.000,0.000
10,0.000,White Crowned Sparrow,23-5,0,13,0,13,0.000,0.000
10,0.000,Eared Grebe,16-23,0,0,0,0,NaN,NaN
10,0.000,Eared Grebe,23-5,0,10,0,10,0.000,0.000
10,0.000,cougar,16-23,0,0,0,0,NaN,NaN
10,0.000,cougar,23-5,0,0,0,0,NaN,NaN
10,0.000,Ocean Water,16-23,0,0,0,0,NaN,NaN
10,0.000,Ocean Water,23-5,0,0,0,0,NaN,NaN
10,0.000,Red Tailed Hawk,16-23,0,0,0,0,NaN,NaN
10,0.000,Red Tailed Hawk,23-5,0,5,0,5,0.000,0.000
10,0.000,Dog,16-23,55,67,0,122,45.082,45.082
10,0.000,Dog,23-5,88,139,0,227,38.767,38.767
10,0.000,Human,16-23,1733,784,0,2517,68.852,68.852
10,0.000,Human,23-5,2136,670,0,2806,76.123,76.123
10,0.000,Wild Turkey,16-23,1,5,0,6,16.667,16.667
10,0.000,Wild Turkey,23-5,0,15,0,15,0.000,0.000
10,0.000,Clark Grebe,16-23,0,0,0,0,NaN,NaN
10,0.000,Clark Grebe,23-5,0,0,0,0,NaN,NaN
10,0.000,Seagull,16-23,0,0,0,0,NaN,NaN
10,0.000,Seagull,23-5,5,8,0,13,38.462,38.462
10,0.000,Surf Scoter,16-23,0,0,0,0,NaN,NaN
10,0.000,Surf Scoter,23-5,0,0,0,0,NaN,NaN
10,0.000,Pigeon,16-23,51,148,0,199,25.628,25.628
10,0.000,Pigeon,23-5,84,171,0,255,32.941,32.941
10,0.000,Pacific Ocean Water,16-23,0,0,0,0,NaN,NaN
10,0.000,Pacific Ocean Water,23-5,0,0,0,0,NaN,NaN
10,0.000,Cat,16-23,19,24,0,43,44.186,44.186
10,0.000,Cat,23-5,21,34,0,55,38.182,38.182
10,0.000,Horse,16-23,6,19,0,25,24.000,24.000
10,0.000,Horse,23-5,26,140,0,166,15.663,15.663
10,0.000,orangutan,16-23,0,0,0,0,NaN,NaN
10,0.000,orangutan,23-5,0,0,0,0,NaN,NaN
10,0.000,Bat,16-23,36,31,0,67,53.731,53.731
10,0.000,Bat,23-5,37,34,0,71,52.113,52.113
10,0.000,Deer,16-23,15,38,0,53,28.302,28.302
10,0.000,Deer,23-5,18,117,0,135,13.333,13.333
10,0.000,Great Horned Owl,16-23,0,0,0,0,NaN,NaN
10,0.000,Great Horned Owl,23-5,0,1,0,1,0.000,0.000
10,0.000,Freshwater Lagoon,16-23,0,0,0,0,NaN,NaN
10,0.000,Freshwater Lagoon,23-5,0,0,0,0,NaN,NaN
10,0.000,Unknown Avian,16-23,0,0,0,0,NaN,NaN
10,0.000,Unknown Avian,23-5,0,0,0,0,NaN,NaN
10,0.000,Human UTI,16-23,75,75,0,150,50.000,50.000
10,0.000,Human UTI,23-5,100,100,0,200,50.000,50.000
10,0.000,unknown,16-23,0,0,0,0,NaN,NaN
10,0.000,unknown,23-5,0,3,0,3,0.000,0.000
10,0.000,SLO Creek Water,16-23,0,0,0,0,NaN,NaN
10,0.000,SLO Creek Water,23-5,0,0,0,0,NaN,NaN
10,0.000,Pig/Swine,16-23,7,6,0,13,53.846,53.846
10,0.000,Pig/Swine,23-5,9,11,0,20,45.000,45.000
10,0.000,Klebsiella,16-23,0,0,0,0,NaN,NaN
10,0.000,Klebsiella,23-5,0,0,0,0,NaN,NaN
10,0.000,Hu Cw and Dg,16-23,11,18,0,29,37.931,37.931
10,0.000,Hu Cw and Dg,23-5,11,23,0,34,32.353,32.353
10,0.000,Ground Squirrel,16-23,86,49,0,135,63.704,63.704
10,0.000,Ground Squirrel,23-5,84,79,0,163,51.534,51.534
10,0.000,Opossum,16-23,0,0,0,0,NaN,NaN
10,0.000,Opossum,23-5,0,0,0,0,NaN,NaN
10,0.000,Cow,16-23,1572,1176,0,2748,57.205,57.205
10,0.000,Cow,23-5,1523,1527,0,3050,49.934,49.934
10,0.000,Deer Mouse,16-23,0,0,0,0,NaN,NaN
10,0.000,Deer Mouse,23-5,0,0,0,0,NaN,NaN
10,0.000,OVERALL,16-23,3766,2582,0,6348,59.326,59.326
10,0.000,OVERALL,23-5,4316,3294,0,7610,56.715,56.715
10,0.500,Chicken,16-23,0,1,0,1,0.000,0.000
10,0.500,Chicken,23-5,7,9,0,16,43.750,43.750
10,0.500,Sea Lion,16-23,0,1,0,1,0.000,0.000
10,0.500,Sea Lion,23-5,0,11,0,11,0.000,0.000
10,0.500,Hu and Cw,16-23,2,7,0,9,22.222,22.222
10,0.500,Hu and Cw,23-5,2,10,0,12,16.667,16.667
10,0.500,Sheep,16-23,48,50,0,98,48.980,48.980
10,0.500,Sheep,23-5,58,43,0,101,57.426,57.426
10,0.500,Hu and Dg,16-23,7,10,0,17,41.176,41.176
10,0.500,Hu and Dg,23-5,19,21,0,40,47.500,47.500
10,0.500,Common Loon,16-23,0,0,0,0,NaN,NaN
10,0.500,Common Loon,23-5,0,1,0,1,0.000,0.000
10,0.500,Red-Winged Blackbird,16-23,0,1,0,1,0.000,0.000
10,0.500,Red-Winged Blackbird,23-5,0,0,0,0,NaN,NaN
10,0.500,Cw,16-23,7,13,0,20,35.000,35.000
10,0.500,Cw,23-5,14,26,0,40,35.000,35.000
10,0.500,Cliff Sparrow,16-23,1,12,0,13,7.692,7.692
10,0.500,Cliff Sparrow,23-5,0,5,0,5,0.000,0.000
10,0.500,Pig,16-23,9,8,0,17,52.941,52.941
10,0.500,Pig,23-5,4,5,0,9,44.444,44.444
10,0.500,Barn Owl,16-23,0,0,0,0,NaN,NaN
10,0.500,Barn Owl,23-5,0,0,0,0,NaN,NaN
10,0.500,Wild Pig,16-23,0,0,0,0,NaN,NaN
10,0.500,Wild Pig,23-5,1,2,0,3,33.333,33.333
10,0.500,Pennington Creek Water,16-23,0,0,0,0,NaN,NaN
10,0.500,Pennington Creek Water,23-5,0,0,0,0,NaN,NaN
10,0.500,Guinni,16-23,0,0,0,0,NaN,NaN
10,0.500,Guinni,23-5,0,0,0,0,NaN,NaN
10,0.500,Racoon,16-23,0,0,0,0,NaN,NaN
10,0.500,Racoon,23-5,0,0,0,0,NaN,NaN
10,0.500,Hu,16-23,15,14,0,29,51.724,51.724
10,0.500,Hu,23-5,23,14,0,37,62.162,62.162
10,0.500,Cw and Dg,16-23,5,15,0,20,25.000,25.000
10,0.500,Cw and Dg,23-5,15,16,0,31,48.387,48.387
10,0.500,Red Wind Blackbird,16-23,0,0,0,0,NaN,NaN
10,0.500,Red Wind Blackbird,23-5,0,0,0,0,NaN,NaN
10,0.500,Tree Swallow,16-23,0,0,0,0,NaN,NaN
10,0.500,Tree Swallow,23-5,0,0,0,0,NaN,NaN
10,0.500,Turkey Vulture,16-23,0,0,0,0,NaN,NaN
10,0.500,Turkey Vulture,23-5,0,0,0,0,NaN,NaN
10,0.500,Dg,16-23,5,9,0,14,35.714,35.714
10,0.500,Dg,23-5,31,31,0,62,50.000,50.000
10,0.500,Western Kingbird,16-23,0,0,0,0,NaN,NaN
10,0.500,Western Kingbird,23-5,0,0,0,0,NaN,NaN
10,0.500,White Crowned Sparrow,16-23,0,1,0,1,0.000,0.000
10,0.500,White Crowned Sparrow,23-5,0,13,0,13,0.000,0.000
10,0.500,Eared Grebe,16-23,0,0,0,0,NaN,NaN
10,0.500,Eared Grebe,23-5,0,10,0,10,0.000,0.000
10,0.500,cougar,16-23,0,0,0,0,NaN,NaN
10,0.500,cougar,23-5,0,0,0,0,NaN,NaN
10,0.500,Ocean Water,16-23,0,0,0,0,NaN,NaN
10,0.500,Ocean Water,23-5,0,0,0,0,NaN,NaN
10,0.500,Red Tailed Hawk,16-23,0,0,0,0,NaN,NaN
10,0.500,Red Tailed Hawk,23-5,0,5,0,5,0.000,0.000
10,0.500,Dog,16-23,55,67,0,122,45.082,45.082
10,0.500,Dog,23-5,88,139,0,227,38.767,38.767
10,0.500,Human,16-23,1733,784,0,2517,68.852,68.852
10,0.500,Human,23-5,2136,670,0,2806,76.123,76.123
10,0.500,Wild Turkey,16-23,1,5,0,6,16.667,16.667
10,0.500,Wild Turkey,23-5,0,15,0,15,0.000,0.000
10,0.500,Clark Grebe,16-23,0,0,0,0,NaN,NaN
10,0.500,Clark Grebe,23-5,0,0,0,0,NaN,NaN
10,0.500,Seagull,16-23,0,0,0,0,NaN,NaN
10,0.500,Seagull,23-5,5,8,0,13,38.462,38.462
10,0.500,Surf Scoter,16-23,0,0,0,0,NaN,NaN
10,0.500,Surf Scoter,23-5,0,0,0,0,NaN,NaN
10,0.500,Pigeon,16-23,51,148,0,199,25.628,25.628
10,0.500,Pigeon,23-5,84,171,0,255,32.941,32.941
10,0.500,Pacific Ocean Water,16-23,0,0,0,0,NaN,NaN
10,0.500,Pacific Ocean Water,23-5,0,0,0,0,NaN,NaN
10,0.500,Cat,16-23,19,24,0,43,44.186,44.186
10,0.500,Cat,23-5,21,34,0,55,38.182,38.182
10,0.500,Horse,16-23,6,19,0,25,24.000,24.000
10,0.500,Horse,23-5,26,140,0,166,15.663,15.663
10,0.500,orangutan,16-23,0,0,0,0,NaN,NaN
10,0.500,orangutan,23-5,0,0,0,0,NaN,NaN
10,0.500,Bat,16-23,36,31,0,67,53.731,53.731
10,0.500,Bat,23-5,37,34,0,71,52.113,52.113
10,0.500,Deer,16-23,15,38,0,53,28.302,28.302
10,0.500,Deer,23-5,18,117,0,135,13.333,13.333
10,0.500,Great Horned Owl,16-23,0,0,0,0,NaN,NaN
10,0.500,Great Horned Owl,23-5,0,1,0,1,0.000,0.000
10,0.500,Freshwater Lagoon,16-23,0,0,0,0,NaN,NaN
10,0.500,Freshwater Lagoon,23-5,0,0,0,0,NaN,NaN
10,0.500,Unknown Avian,16-23,0,0,0,0,NaN,NaN
10,0.500,Unknown Avian,23-5,0,0,0,0,NaN,NaN
10,0.500,Human UTI,16-23,75,75,0,150,50.000,50.000
10,0.500,Human UTI,23-5,100,100,0,200,50.000,50.000
10,0.500,unknown,16-23,0,0,0,0,NaN,NaN
10,0.500,unknown,23-5,0,3,0,3,0.000,0.000
10,0.500,SLO Creek Water,16-23,0,0,0,0,NaN,NaN
10,0.500,SLO Creek Water,23-5,0,0,0,0,NaN,NaN
10,0.500,Pig/Swine,16-23,7,6,0,13,53.846,53.846
10,0.500,Pig/Swine,23-5,9,11,0,20,45.000,45.000
10,0.500,Klebsiella,16-23,0,0,0,0,NaN,NaN
10,0.500,Klebsiella,23-5,0,0,0,0,NaN,NaN
10,0.500,Hu Cw and Dg,16-23,11,18,0,29,37.931,37.931
10,0.500,Hu Cw and Dg,23-5,11,23,0,34,32.353,32.353
10,0.500,Ground Squirrel,16-23,86,49,0,135,63.704,63.704
10,0.500,Ground Squirrel,23-5,84,79,0,163,51.534,51.534
10,0.500,Opossum,16-23,0,0,0,0,NaN,NaN
10,0.500,Opossum,23-5,0,0,0,0,NaN,NaN
10,0.500,Cow,16-23,1572,1176,0,2748,57.205,57.205
10,0.500,Cow,23-5,1523,1527,0,3050,49.934,49.934
10,0.500,Deer Mouse,16-23,0,0,0,0,NaN,NaN
10,0.500,Deer Mouse,23-5,0,0,0,0,NaN,NaN
10,0.500,OVERALL,16-23,3766,2582,0,6348,59.326,59.326
10,0.500,OVERALL,23-5,4316,3294,0,7610,56.715,56.715
10,0.900,Chicken,16-23,0,1,0,1,0.000,0.000
10,0.900,Chicken,23-5,7,9,0,16,43.750,43.750
10,0.900,Sea Lion,16-23,0,1,0,1,0.000,0.000
10,0.900,Sea Lion,23-5,0,11,0,11,0.000,0.000
10,0.900,Hu and Cw,16-23,2,7,0,9,22.222,22.222
10,0.900,Hu and Cw,23-5,2,10,0,12,16.667,16.667
10,0.900,Sheep,16-23,48,50,0,98,48.980,48.980
10,0.900,Sheep,23-5,58,43,0,101,57.426,57.426
10,0.900,Hu and Dg,16-23,7,10,0,17,41.176,41.176
10,0.900,Hu and Dg,23-5,19,21,0,40,47.500,47.500
10,0.900,Common Loon,16-23,0,0,0,0,NaN,NaN
10,0.900,Common Loon,23-5,0,1,0,1,0.000,0.000
10,0.900,Red-Winged Blackbird,16-23,0,1,0,1,0.000,0.000
10,0.900,Red-Winged Blackbird,23-5,0,0,0,0,NaN,NaN
10,0.900,Cw,16-23,7,13,0,20,35.000,35.000
10,0.900,Cw,23-5,14,26,0,40,35.000,35.000
10,0.900,Cliff Sparrow,16-23,1,12,0,13,7.692,7.692
10,0.900,Cliff Sparrow,23-5,0,5,0,5,0.000,0.000
10,0.900,Pig,16-23,9,8,0,17,52.941,52.941
10,0.900,Pig,23-5,4,5,0,9,44.444,44.444
10,0.900,Barn Owl,16-23,0,0,0,0,NaN,NaN
10,0.900,Barn Owl,23-5,0,0,0,0,NaN,NaN
10,0.900,Wild Pig,16-23,0,0,0,0,NaN,NaN
10,0.900,Wild Pig,23-5,1,2,0,3,33.333,33.333
10,0.900,Pennington Creek Water,16-23,0,0,0,0,NaN,NaN
10,0.900,Pennington Creek Water,23-5,0,0,0,0,NaN,NaN
10,0.900,Guinni,16-23,0,0,0,0,NaN,NaN
10,0.900,Guinni,23-5,0,0,0,0,NaN,NaN
10,0.900,Racoon,16-23,0,0,0,0,NaN,NaN
10,0.900,Racoon,23-5,0,0,0,0,NaN,NaN
10,0.900,Hu,16-23,15,14,0,29,51.724,51.724
10,0.900,Hu,23-5,23,14,0,37,62.162,62.162
10,0.900,Cw and Dg,16-23,5,15,0,20,25.000,25.000
10,0.900,Cw and Dg,23-5,15,16,0,31,48.387,48.387
10,0.900,Red Wind Blackbird,16-23,0,0,0,0,NaN,NaN
10,0.900,Red Wind Blackbird,23-5,0,0,0,0,NaN,NaN
10,0.900,Tree Swallow,16-23,0,0,0,0,NaN,NaN
10,0.900,Tree Swallow,23-5,0,0,0,0,NaN,NaN
10,0.900,Turkey Vulture,16-23,0,0,0,0,NaN,NaN
10,0.900,Turkey Vulture,23-5,0,0,0,0,NaN,NaN
10,0.900,Dg,16-23,5,9,0,14,35.714,35.714
10,0.900,Dg,23-5,31,31,0,62,50.000,50.000
10,0.900,Western Kingbird,16-23,0,0,0,0,NaN,NaN
10,0.900,Western Kingbird,23-5,0,0,0,0,NaN,NaN
10,0.900,White Crowned Sparrow,16-23,0,1,0,1,0.000,0.000
10,0.900,White Crowned Sparrow,23-5,0,13,0,13,0.000,0.000
10,0.900,Eared Grebe,16-23,0,0,0,0,NaN,NaN
10,0.900,Eared Grebe,23-5,0,10,0,10,0.000,0.000
10,0.900,cougar,16-23,0,0,0,0,NaN,NaN
10,0.900,cougar,23-5,0,0,0,0,NaN,NaN
10,0.900,Ocean Water,16-23,0,0,0,0,NaN,NaN
10,0.900,Ocean Water,23-5,0,0,0,0,NaN,NaN
10,0.900,Red Tailed Hawk,16-23,0,0,0,0,NaN,NaN
10,0.900,Red Tailed Hawk,23-5,0,5,0,5,0.000,0.000
10,0.900,Dog,16-23,55,67,0,122,45.082,45.082
10,0.900,Dog,23-5,88,134,0,222,39.640,39.640
10,0.900,Human,16-23,1733,783,0,2516,68.879,68.879
10,0.900,Human,23-5,2136,666,0,2802,76.231,76.231
10,0.900,Wild Turkey,16-23,1,5,0,6,16.667,16.667
10,0.900,Wild Turkey,23-5,0,15,0,15,0.000,0.000
10,0.900,Clark Grebe,16-23,0,0,0,0,NaN,NaN
10,0.900,Clark Grebe,23-5,0,0,0,0,NaN,NaN
10,0.900,Seagull,16-23,0,0,0,0,NaN,NaN
10,0.900,Seagull,23-5,5,9,0,14,35.714,35.714
10,0.900,Surf Scoter,16-23,0,0,0,0,NaN,NaN
10,0.900,Surf Scoter,23-5,0,0,0,0,NaN,NaN
10,0.900,Pigeon,16-23,51,149,0,200,25.500,25.500
10,0.900,Pigeon,23-5,84,171,0,255,32.941,32.941
10,0.900,Pacific Ocean Water,16-23,0,0,0,0,NaN,NaN
10,0.900,Pacific Ocean Water,23-5,0,0,0,0,NaN,NaN
10,0.900,Cat,16-23,19,24,0,43,44.186,44.186
10,0.900,Cat,23-5,21,34,0,55,38.182,38.182
10,0.900,Horse,16-23,6,19,0,25,24.000,24.000
10,0.900,Horse,23-5,26,140,0,166,15.663,15.663
10,0.900,orangutan,16-23,0,0,0,0,NaN,NaN
10,0.900,orangutan,23-5,0,0,0,0,NaN,NaN
10,0.900,Bat,16-23,36,31,0,67,53.731,53.731
10,0.900,Bat,23-5,37,34,0,71,52.113,52.113
10,0.900,Deer,16-23,15,38,0,53,28.302,28.302
10,0.900,Deer,23-5,18,117,0,135,13.333,13.333
10,0.900,Great Horned Owl,16-23,0,0,0,0,NaN,NaN
10,0.900,Great Horned Owl,23-5,0,1,0,1,0.000,0.000
10,0.900,Freshwater Lagoon,16-23,0,0,0,0,NaN,NaN
10,0.900,Freshwater Lagoon,23-5,0,0,0,0,NaN,NaN
10,0.900,Unknown Avian,16-23,0,0,0,0,NaN,NaN
10,0.900,Unknown Avian,23-5,0,0,0,0,NaN,NaN
10,0.900,Human UTI,16-23,75,75,0,150,50.000,50.000
10,0.900,Human UTI,23-5,103,100,0,203,50.739,50.739
10,0.900,unknown,16-23,0,0,0,0,NaN,NaN
10,0.900,unknown,23-5,0,3,0,3,0.000,0.000
10,0.900,SLO Creek Water,16-23,0,0,0,0,NaN,NaN
10,0.900,SLO Creek Water,23-5,0,0,0,0,NaN,NaN
10,0.900,Pig/Swine,16-23,7,6,0,13,53.846,53.846
10,0.900,Pig/Swine,23-5,9,11,0,20,45.000,45.000
10,0.900,Klebsiella,16-23,0,0,0,0,NaN,NaN
10,0.900,Klebsiella,23-5,0,0,0,0,NaN,NaN
10,0.900,Hu Cw and Dg,16-23,11,18,0,29,37.931,37.931
10,0.900,Hu Cw and Dg,23-5,11,23,0,34,32.353,32.353
10,0.900,Ground Squirrel,16-23,86,49,0,135,63.704,63.704
10,0.900,Ground Squirrel,23-5,84,79,0,163,51.534,51.534
10,0.900,Opossum,16-23,0,0,0,0,NaN,NaN
10,0.900,Opossum,23-5,0,0,0,0,NaN,NaN
10,0.900,Cow,16-23,1572,1172,0,2744,57.289,57.289
10,0.900,Cow,23-5,1523,1524,0,3047,49.984,49.984
10,0.900,Deer Mouse,16-23,0,0,0,0,NaN,NaN
10,0.900,Deer Mouse,23-5,0,0,0,0,NaN,NaN
10,0.900,OVERALL,16-23,3766,2578,0,6344,59.363,59.363
10,0.900,OVERALL,23-5,4319,3283,0,7602,56.814,56.814
10,0.950,Chicken,16-23,0,1,0,1,0.000,0.000
10,0.950,Chicken,23-5,7,9,0,16,43.750,43.750
10,0.950,Sea Lion,16-23,0,1,0,1,0.000,0.000
10,0.950,Sea Lion,23-5,0,11,0,11,0.000,0.000
10,0.950,Hu and Cw,16-23,2,7,0,9,22.222,22.222
10,0.950,Hu and Cw,23-5,2,10,0,12,16.667,16.667
10,0.950,Sheep,16-23,48,50,0,98,48.980,48.980
10,0.950,Sheep,23-5,58,43,0,101,57.426,57.426
10,0.950,Hu and Dg,16-23,7,10,0,17,41.176,41.176
10,0.950,Hu and Dg,23-5,19,21,0,40,47.500,47.500
10,0.950,Common Loon,16-23,0,0,0,0,NaN,NaN
10,0.950,Common Loon,23-5,0,1,0,1,0.000,0.000
10,0.950,Red-Winged Blackbird,16-23,0,1,0,1,0.000,0.000
10,0.950,Red-Winged Blackbird,23-5,0,0,0,0,NaN,NaN
10,0.950,Cw,16-23,7,13,0,20,35.000,35.000
10,0.950,Cw,23-5,14,26,0,40,35.000,35.000
10,0.950,Cliff Sparrow,16-23,1,12,0,13,7.692,7.692
10,0.950,Cliff Sparrow,23-5,0,5,0,5,0.000,0.000
10,0.950,Pig,16-23,9,8,0,17,52.941,52.941
10,0.950,Pig,23-5,4,5,0,9,44.444,44.444
10,0.950,Barn Owl,16-23,0,0,0,0,NaN,NaN
10,0.950,Barn Owl,23-5,0,0,0,0,NaN,NaN
10,0.950,Wild Pig,16-23,0,0,0,0,NaN,NaN
10,0.950,Wild Pig,23-5,1,2,0,3,33.333,33.333
10,0.950,Pennington Creek Water,16-23,0,0,0,0,NaN,NaN
10,0.950,Pennington Creek Water,23-5,0,0,0,0,NaN,NaN
10,0.950,Guinni,16-23,0,0,0,0,NaN,NaN
10,0.950,Guinni,23-5,0,0,0,0,NaN,NaN
10,0.950,Racoon,16-23,0,0,0,0,NaN,NaN
10,0.950,Racoon,23-5,0,0,0,0,NaN,NaN
10,0.950,Hu,16-23,15,14,0,29,51.724,51.724
10,0.950,Hu,23-5,23,14,0,37,62.162,62.162
10,0.950,Cw and Dg,16-23,5,15,0,20,25.000,25.000
10,0.950,Cw and Dg,23-5,15,16,0,31,48.387,48.387
10,0.950,Red Wind Blackbird,16-23,0,0,0,0,NaN,NaN
10,0.950,Red Wind Blackbird,23-5,0,0,0,0,NaN,NaN
10,0.950,Tree Swallow,16-23,0,0,0,0,NaN,NaN
10,0.950,Tree Swallow,23-5,0,0,0,0,NaN,NaN
10,0.950,Turkey Vulture,16-23,0,0,0,0,NaN,NaN
10,0.950,Turkey Vulture,23-5,0,0,0,0,NaN,NaN
10,0.950,Dg,16-23,5,9,0,14,35.714,35.714
10,0.950,Dg,23-5,31,31,0,62,50.000,50.000
10,0.950,Western Kingbird,16-23,0,0,0,0,NaN,NaN
10,0.950,Western Kingbird,23-5,0,0,0,0,NaN,NaN
10,0.950,White Crowned Sparrow,16-23,0,1,0,1,0.000,0.000
10,0.950,White Crowned Sparrow,23-5,0,13,0,13,0.000,0.000
10,0.950,Eared Grebe,16-23,0,0,0,0,NaN,NaN
10,0.950,Eared Grebe,23-5,0,10,0,10,0.000,0.000
10,0.950,cougar,16-23,0,0,0,0,NaN,NaN
10,0.950,cougar,23-5,0,0,0,0,NaN,NaN
10,0.950,Ocean Water,16-23,0,0,0,0,NaN,NaN
10,0.950,Ocean Water,23-5,0,0,0,0,NaN,NaN
10,0.950,Red Tailed Hawk,16-23,0,0,0,0,NaN,NaN
10,0.950,Red Tailed Hawk,23-5,0,5,0,5,0.000,0.000
10,0.950,Dog,16-23,55,67,0,122,45.082,45.082
10,0.950,Dog,23-5,88,132,0,220,40.000,40.000
10,0.950,Human,16-23,1733,781,0,2514,68.934,68.934
10,0.950,Human,23-5,2136,659,0,2795,76.422,76.422
10,0.950,Wild Turkey,16-23,1,5,0,6,16.667,16.667
10,0.950,Wild Turkey,23-5,0,15,0,15,0.000,0.000
10,0.950,Clark Grebe,16-23,0,0,0,0,NaN,NaN
10,0.950,Clark Grebe,23-5,0,0,0,0,NaN,NaN
10,0.950,Seagull,16-23,0,0,0,0,NaN,NaN
10,0.950,Seagull,23-5,5,8,0,13,38.462,38.462
10,0.950,Surf Scoter,16-23,0,0,0,0,NaN,NaN
10,0.950,Surf Scoter,23-5,0,0,0,0,NaN,NaN
10,0.950,Pigeon,16-23,52,146,0,198,26.263,26.263
10,0.950,Pigeon,23-5,84,172,0,256,32.813,32.813
10,0.950,Pacific Ocean Water,16-23,0,0,0,0,NaN,NaN
10,0.950,Pacific Ocean Water,23-5,0,0,0,0,NaN,NaN
10,0.950,Cat,16-23,19,24,0,43,44.186,44.186
10,0.950,Cat,23-5,21,34,0,55,38.182,38.182
10,0.950,Horse,16-23,6,19,0,25,24.000,24.000
10,0.950,Horse,23-5,26,140,0,166,15.663,15.663
10,0.950,orangutan,16-23,0,0,0,0,NaN,NaN
10,0.950,orangutan,23-5,0,0,0,0,NaN,NaN
10,0.950,Bat,16-23,36,31,0,67,53.731,53.731
10,0.950,Bat,23-5,37,33,0,70,52.857,52.857
10,0.950,Deer,16-23,15,38,0,53,28.302,28.302
10,0.950,Deer,23-5,18,117,0,135,13.333,13.333
10,0.950,Great Horned Owl,16-23,0,0,0,0,NaN,NaN
10,0.950,Great Horned Owl,23-5,0,1,0,1,0.000,0.000
10,0.950,Freshwater Lagoon,16-23,0,0,0,0,NaN,NaN
10,0.950,Freshwater Lagoon,23-5,0,0,0,0,NaN,NaN
10,0.950,Unknown Avian,16-23,0,0,0,0,NaN,NaN
10,0.950,Unknown Avian,23-5,0,0,0,0,NaN,NaN
10,0.950,Human UTI,16-23,78,76,0,154,50.649,50.649
10,0.950,Human UTI,23-5,102,102,0,204,50.000,50.000
10,0.950,unknown,16-23,0,0,0,0,NaN,NaN
10,0.950,unknown,23-5,0,3,0,3,0.000,0.000
10,0.950,SLO Creek Water,16-23,0,0,0,0,NaN,NaN
10,0.950,SLO Creek Water,23-5,0,0,0,0,NaN,NaN
10,0.950,Pig/Swine,16-23,7,6,0,13,53.846,53.846
10,0.950,Pig/Swine,23-5,9,11,0,20,45.000,45.000
10,0.950,Klebsiella,16-23,0,0,0,0,NaN,NaN
10,0.950,Klebsiella,23-5,0,0,0,0,NaN,NaN
10,0.950,Hu Cw and Dg,16-23,11,18,0,29,37.931,37.931
10,0.950,Hu Cw and Dg,23-5,11,23,0,34,32.353,32.353
10,0.950,Ground Squirrel,16-23,86,49,0,135,63.704,63.704
10,0.950,Ground Squirrel,23-5,84,78,0,162,51.852,51.852
10,0.950,Opossum,16-23,0,0,0,0,NaN,NaN
10,0.950,Opossum,23-5,0,0,0,0,NaN,NaN
10,0.950,Cow,16-23,1575,1152,0,2727,57.756,57.756
10,0.950,Cow,23-5,1522,1521,0,3043,50.016,50.016
10,0.950,Deer Mouse,16-23,0,0,0,0,NaN,NaN
10,0.950,Deer Mouse,23-5,0,0,0,0,NaN,NaN
10,0.950,OVERALL,16-23,3773,2554,0,6327,59.633,59.633
10,0.950,OVERALL,23-5,4317,3271,0,7588,56.892,56.892
10,0.960,Chicken,16-23,0,1,0,1,0.000,0.000
10,0.960,Chicken,23-5,7,9,0,16,43.750,43.750
10,0.960,Sea Lion,16-23,0,1,0,1,0.000,0.000
10,0.960,Sea Lion,23-5,0,11,0,11,0.000,0.000
10,0.960,Hu and Cw,16-23,2,7,0,9,22.222,22.222
10,0.960,Hu and Cw,23-5,2,10,0,12,16.667,16.667
10,0.960,Sheep,16-23,48,50,0,98,48.980,48.980
10,0.960,Sheep,23-5,58,44,0,102,56.863,56.863
10,0.960,Hu and Dg,16-23,7,10,0,17,41.176,41.176
10,0.960,Hu and Dg,23-5,19,21,0,40,47.500,47.500
10,0.960,Common Loon,16-23,0,0,0,0,NaN,NaN
10,0.960,Common Loon,23-5,0,1,0,1,0.000,0.000
10,0.960,Red-Winged Blackbird,16-23,0,1,0,1,0.000,0.000
10,0.960,Red-Winged Blackbird,23-5,0,0,0,0,NaN,NaN
10,0.960,Cw,16-23,7,13,0,20,35.000,35.000
10,0.960,Cw,23-5,14,26,0,40,35.000,35.000
10,0.960,Cliff Sparrow,16-23,1,12,0,13,7.692,7.692
10,0.960,Cliff Sparrow,23-5,0,5,0,5,0.000,0.000
10,0.960,Pig,16-23,9,8,0,17,52.941,52.941
10,0.960,Pig,23-5,4,5,0,9,44.444,44.444
10,0.960,Barn Owl,16-23,0,0,0,0,NaN,NaN
10,0.960,Barn Owl,23-5,0,0,0,0,NaN,NaN
10,0.960,Wild Pig,16-23,0,0,0,0,NaN,NaN
10,0.960,Wild Pig,23-5,1,2,0,3,33.333,33.333
10,0.960,Pennington Creek Water,16-23,0,0,0,0,NaN,NaN
10,0.960,Pennington Creek Water,23-5,0,0,0,0,NaN,NaN
10,0.960,Guinni,16-23,0,0,0,0,NaN,NaN
10,0.960,Guinni,23-5,0,0,0,0,NaN,NaN
10,0.960,Racoon,16-23,0,0,0,0,NaN,NaN
10,0.960,Racoon,23-5,0,0,0,0,NaN,NaN
10,0.960,Hu,16-23,15,14,0,29,51.724,51.724
10,0.960,Hu,23-5,23,14,0,37,62.162,62.162
10,0.960,Cw and Dg,16-23,5,15,0,20,25.000,25.000
10,0.960,Cw and Dg,23-5,15,16,0,31,48.387,48.387
10,0.960,Red Wind Blackbird,16-23,0,0,0,0,NaN,NaN
10,0.960,Red Wind Blackbird,23-5,0,0,0,0,NaN,NaN
10,0.960,Tree Swallow,16-23,0,0,0,0,NaN,NaN
10,0.960,Tree Swallow,23-5,0,0,0,0,NaN,NaN
10,0.960,Turkey Vulture,16-23,0,0,0,0,NaN,NaN
10,0.960,Turkey Vulture,23-5,0,0,0,0,NaN,NaN
10,0.960,Dg,16-23,5,9,0,14,35.714,35.714
10,0.960,Dg,23-5,31,31,0,62,50.000,50.000
10,0.960,Western Kingbird,16-23,0,0,0,0,NaN,NaN
10,0.960,Western Kingbird,23-5,0,0,0,0,NaN,NaN
10,0.960,White Crowned Sparrow,16-23,0,1,0,1,0.000,0.000
10,0.960,White Crowned Sparrow,23-5,0,13,0,13,0.000,0.000
10,0.960,Eared Grebe,16-23,0,0,0,0,NaN,NaN
10,0.960,Eared Grebe,23-5,0,10,0,10,0.000,0.000
10,0.960,cougar,16-23,0,0,0,0,NaN,NaN
10,0.960,cougar,23-5,0,0,0,0,NaN,NaN
10,0.960,Ocean Water,16-23,0,0,0,0,NaN,NaN
10,0.960,Ocean Water,23-5,0,0,0,0,NaN,NaN
10,0.960,Red Tailed Hawk,16-23,0,0,0,0,NaN,NaN
10,0.960,Red Tailed Hawk,23-5,0,5,0,5,0.000,0.000
10,0.960,Dog,16-23,55,67,0,122,45.082,45.082
10,0.960,Dog,23-5,88,128,0,216,40.741,40.741
10,0.960,Human,16-23,1734,779,0,2513,69.001,69.001
10,0.960,Human,23-5,2141,645,0,2786,76.849,76.849
10,0.960,Wild Turkey,16-23,1,5,0,6,16.667,16.667
10,0.960,Wild Turkey,23-5,0,19,0,19,0.000,0.000
10,0.960,Clark Grebe,16-23,0,0,0,0,NaN,NaN
10,0.960,Clark Grebe,23-5,0,0,0,0,NaN,NaN
10,0.960,Seagull,16-23,0,0,0,0,NaN,NaN
10,0.960,Seagull,23-5,5,9,0,14,35.714,35.714
10,0.960,Surf Scoter,16-23,0,0,0,0,NaN,NaN
10,0.960,Surf Scoter,23-5,0,2,0,2,0.000,0.000
10,0.960,Pigeon,16-23,51,146,0,197,25.888,25.888
10,0.960,Pigeon,23-5,85,186,0,271,31.365,31.365
10,0.960,Pacific Ocean Water,16-23,0,0,0,0,NaN,NaN
10,0.960,Pacific Ocean Water,23-5,0,0,0,0,NaN,NaN
10,0.960,Cat,16-23,19,24,0,43,44.186,44.186
10,0.960,Cat,23-5,21,35,0,56,37.500,37.500
10,0.960,Horse,16-23,6,19,0,25,24.000,24.000
10,0.960,Horse,23-5,26,140,0,166,15.663,15.663
10,0.960,orangutan,16-23,0,0,0,0,NaN,NaN
10,0.960,orangutan,23-5,0,0,0,0,NaN,NaN
10,0.960,Bat,16-23,36,31,0,67,53.731,53.731
10,0.960,Bat,23-5,37,33,0,70,52.857,52.857
10,0.960,Deer,16-23,15,38,0,53,28.302,28.302
10,0.960,Deer,23-5,18,117,0,135,13.333,13.333
10,0.960,Great Horned Owl,16-23,0,0,0,0,NaN,NaN
10,0.960,Great Horned Owl,23-5,0,1,0,1,0.000,0.000
10,0.960,Freshwater Lagoon,16-23,0,0,0,0,NaN,NaN
10,0.960,Freshwater Lagoon,23-5,0,0,0,0,NaN,NaN
10,0.960,Unknown Avian,16-23,0,0,0,0,NaN,NaN
10,0.960,Unknown Avian,23-5,0,0,0,0,NaN,NaN
10,0.960,Human UTI,16-23,78,77,0,155,50.323,50.323
10,0.960,Human UTI,23-5,102,101,0,203,50.246,50.246
10,0.960,unknown,16-23,0,0,0,0,NaN,NaN
10,0.960,unknown,23-5,0,3,0,3,0.000,0.000
10,0.960,SLO Creek Water,16-23,0,0,0,0,NaN,NaN
10,0.960,SLO Creek Water,23-5,0,0,0,0,NaN,NaN
10,0.960,Pig/Swine,16-23,7,6,0,13,53.846,53.846
10,0.960,Pig/Swine,23-5,9,11,0,20,45.000,45.000
10,0.960,Klebsiella,16-23,0,0,0,0,NaN,NaN
10,0.960,Klebsiella,23-5,0,0,0,0,NaN,NaN
10,0.960,Hu Cw and Dg,16-23,11,18,0,29,37.931,37.931
10,0.960,Hu Cw and Dg,23-5,11,23,0,34,32.353,32.353
10,0.960,Ground Squirrel,16-23,86,49,0,135,63.704,63.704
10,0.960,Ground Squirrel,23-5,84,80,0,164,51.220,51.220
10,0.960,Opossum,16-23,0,0,0,0,NaN,NaN
10,0.960,Opossum,23-5,0,0,0,0,NaN,NaN
10,0.960,Cow,16-23,1573,1144,0,2717,57.895,57.895
10,0.960,Cow,23-5,1522,1498,0,3020,50.397,50.397
10,0.960,Deer Mouse,16-23,0,0,0,0,NaN,NaN
10,0.960,Deer Mouse,23-5,0,0,0,0,NaN,NaN
10,0.960,OVERALL,16-23,3771,2545,0,6316,59.706,59.706
10,0.960,OVERALL,23-5,4323,3254,0,7577,57.054,57.054
10,0.970,Chicken,16-23,0,1,0,1,0.000,0.000
10,0.970,Chicken,23-5,7,9,0,16,43.750,43.750
10,0.970,Sea Lion,16-23,0,1,0,1,0.000,0.000
10,0.970,Sea Lion,23-5,0,11,0,11,0.000,0.000
10,0.970,Hu and Cw,16-23,2,7,0,9,22.222,22.222
10,0.970,Hu and Cw,23-5,2,10,0,12,16.667,16.667
10,0.970,Sheep,16-23,49,51,0,100,49.000,49.000
10,0.970,Sheep,23-5,58,43,0,101,57.426,57.426
10,0.970,Hu and Dg,16-23,7,10,0,17,41.176,41.176
10,0.970,Hu and Dg,23-5,19,21,0,40,47.500,47.500
10,0.970,Common Loon,16-23,0,0,0,0,NaN,NaN
10,0.970,Common Loon,23-5,0,1,0,1,0.000,0.000
10,0.970,Red-Winged Blackbird,16-23,0,1,0,1,0.000,0.000
10,0.970,Red-Winged Blackbird,23-5,0,0,0,0,NaN,NaN
10,0.970,Cw,16-23,7,14,0,21,33.333,33.333
10,0.970,Cw,23-5,14,26,0,40,35.000,35.000
10,0.970,Cliff Sparrow,16-23,1,12,0,13,7.692,7.692
10,0.970,Cliff Sparrow,23-5,0,5,0,5,0.000,0.000
10,0.970,Pig,16-23,9,8,0,17,52.941,52.941
10,0.970,Pig,23-5,4,5,0,9,44.444,44.444
10,0.970,Barn Owl,16-23,0,0,0,0,NaN,NaN
10,0.970,Barn Owl,23-5,0,0,0,0,NaN,NaN
10,0.970,Wild Pig,16-23,0,0,0,0,NaN,NaN
10,0.970,Wild Pig,23-5,0,2,0,2,0.000,0.000
10,0.970,Pennington Creek Water,16-23,0,0,0,0,NaN,NaN
10,0.970,Pennington Creek Water,23-5,0,0,0,0,NaN,NaN
10,0.970,Guinni,16-23,0,0,0,0,NaN,NaN
10,0.970,Guinni,23-5,0,0,0,0,NaN,NaN
10,0.970,Racoon,16-23,0,0,0,0,NaN,NaN
10,0.970,Racoon,23-5,0,0,0,0,NaN,NaN
10,0.970,Hu,16-23,15,14,0,29,51.724,51.724
10,0.970,Hu,23-5,23,14,0,37,62.162,62.162
10,0.970,Cw and Dg,16-23,5,15,0,20,25.000,25.000
10,0.970,Cw and Dg,23-5,15,16,0,31,48.387,48.387
10,0.970,Red Wind Blackbird,16-23,0,0,0,0,NaN,NaN
10,0.970,Red Wind Blackbird,23-5,0,0,0,0,NaN,NaN
10,0.970,Tree Swallow,16-23,0,0,0,0,NaN,NaN
10,0.970,Tree Swallow,23-5,0,0,0,0,NaN,NaN
10,0.970,Turkey Vulture,16-23,0,0,0,0,NaN,NaN
10,0.970,Turkey Vulture,23-5,0,0,0,0,NaN,NaN
10,0.970,Dg,16-23,5,9,0,14,35.714,35.714
10,0.970,Dg,23-5,31,30,0,61,50.820,50.820
10,0.970,Western Kingbird,16-23,0,0,0,0,NaN,NaN
10,0.970,Western Kingbird,23-5,0,0,0,0,NaN,NaN
10,0.970,White Crowned Sparrow,16-23,0,1,0,1,0.000,0.000
10,0.970,White Crowned Sparrow,23-5,0,13,0,13,0.000,0.000
10,0.970,Eared Grebe,16-23,0,0,0,0,NaN,NaN
10,0.970,Eared Grebe,23-5,0,10,0,10,0.000,0.000
10,0.970,cougar,16-23,0,0,0,0,NaN,NaN
10,0.970,cougar,23-5,0,0,0,0,NaN,NaN
10,0.970,Ocean Water,16-23,0,0,0,0,NaN,NaN
10,0.970,Ocean Water,23-5,0,0,0,0,NaN,NaN
10,0.970,Red Tailed Hawk,16-23,0,0,0,0,NaN,NaN
10,0.970,Red Tailed Hawk,23-5,0,5,0,5,0.000,0.000
10,0.970,Dog,16-23,55,67,0,122,45.082,45.082
10,0.970,Dog,23-5,88,127,0,215,40.930,40.930
10,0.970,Human,16-23,1733,778,0,2511,69.016,69.016
10,0.970,Human,23-5,2140,644,0,2784,76.868,76.868
10,0.970,Wild Turkey,16-23,1,7,0,8,12.500,12.500
10,0.970,Wild Turkey,23-5,2,19,0,21,9.524,9.524
10,0.970,Clark Grebe,16-23,0,0,0,0,NaN,NaN
10,0.970,Clark Grebe,23-5,0,0,0,0,NaN,NaN
10,0.970,Seagull,16-23,0,0,0,0,NaN,NaN
10,0.970,Seagull,23-5,5,10,0,15,33.333,33.333
10,0.970,Surf Scoter,16-23,0,0,0,0,NaN,NaN
10,0.970,Surf Scoter,23-5,0,2,0,2,0.000,0.000
10,0.970,Pigeon,16-23,49,144,0,193,25.389,25.389
10,0.970,Pigeon,23-5,85,203,0,288,29.514,29.514
10,0.970,Pacific Ocean Water,16-23,0,0,0,0,NaN,NaN
10,0.970,Pacific Ocean Water,23-5,0,0,0,0,NaN,NaN
10,0.970,Cat,16-23,19,24,0,43,44.186,44.186
10,0.970,Cat,23-5,21,32,0,53,39.623,39.623
10,0.970,Horse,16-23,6,19,0,25,24.000,24.000
10,0.970,Horse,23-5,26,141,0,167,15.569,15.569
10,0.970,orangutan,16-23,0,0,0,0,NaN,NaN
10,0.970,orangutan,23-5,0,0,0,0,NaN,NaN
10,0.970,Bat,16-23,36,31,0,67,53.731,53.731
10,0.970,Bat,23-5,37,33,0,70,52.857,52.857
10,0.970,Deer,16-23,15,38,0,53,28.302,28.302
10,0.970,Deer,23-5,18,117,0,135,13.333,13.333
10,0.970,Great Horned Owl,16-23,0,0,0,0,NaN,NaN
10,0.970,Great Horned Owl,23-5,0,1,0,1,0.000,0.000
10,0.970,Freshwater Lagoon,16-23,0,0,0,0,NaN,NaN
10,0.970,Freshwater Lagoon,23-5,0,0,0,0,NaN,NaN
10,0.970,Unknown Avian,16-23,0,0,0,0,NaN,NaN
10,0.970,Unknown Avian,23-5,0,0,0,0,NaN,NaN
10,0.970,Human UTI,16-23,78,78,0,156,50.000,50.000
10,0.970,Human UTI,23-5,101,101,0,202,50.000,50.000
10,0.970,unknown,16-23,0,0,0,0,NaN,NaN
10,0.970,unknown,23-5,0,3,0,3,0.000,0.000
10,0.970,SLO Creek Water,16-23,0,0,0,0,NaN,NaN
10,0.970,SLO Creek Water,23-5,0,0,0,0,NaN,NaN
10,0.970,Pig/Swine,16-23,7,6,0,13,53.846,53.846
10,0.970,Pig/Swine,23-5,9,11,0,20,45.000,45.000
10,0.970,Klebsiella,16-23,0,0,0,0,NaN,NaN
10,0.970,Klebsiella,23-5,0,0,0,0,NaN,NaN
10,0.970,Hu Cw and Dg,16-23,11,18,0,29,37.931,37.931
10,0.970,Hu Cw and Dg,23-5,11,23,0,34,32.353,32.353
10,0.970,Ground Squirrel,16-23,86,47,0,133,64.662,64.662
10,0.970,Ground Squirrel,23-5,84,78,0,162,51.852,51.852
10,0.970,Opossum,16-23,0,0,0,0,NaN,NaN
10,0.970,Opossum,23-5,0,0,0,0,NaN,NaN
10,0.970,Cow,16-23,1567,1142,0,2709,57.844,57.844
10,0.970,Cow,23-5,1519,1471,0,2990,50.803,50.803
10,0.970,Deer Mouse,16-23,0,0,0,0,NaN,NaN
10,0.970,Deer Mouse,23-5,0,0,0,0,NaN,NaN
10,0.970,OVERALL,16-23,3763,2543,0,6306,59.673,59.673
10,0.970,OVERALL,23-5,4319,3237,0,7556,57.160,57.160
10,0.980,Chicken,16-23,0,1,0,1,0.000,0.000
10,0.980,Chicken,23-5,8,9,0,17,47.059,47.059
10,0.980,Sea Lion,16-23,0,1,0,1,0.000,0.000
10,0.980,Sea Lion,23-5,0,10,0,10,0.000,0.000
10,0.980,Hu and Cw,16-23,2,7,0,9,22.222,22.222
10,0.980,Hu and Cw,23-5,2,20,0,22,9.091,9.091
10,0.980,Sheep,16-23,51,49,0,100,51.000,51.000
10,0.980,Sheep,23-5,57,42,0,99,57.576,57.576
10,0.980,Hu and Dg,16-23,7,10,0,17,41.176,41.176
10,0.980,Hu and Dg,23-5,19,18,0,37,51.351,51.351
10,0.980,Common Loon,16-23,0,0,0,0,NaN,NaN
10,0.980,Common Loon,23-5,0,1,0,1,0.000,0.000
10,0.980,Red-Winged Blackbird,16-23,0,1,0,1,0.000,0.000
10,0.980,Red-Winged Blackbird,23-5,0,0,0,0,NaN,NaN
10,0.980,Cw,16-23,7,13,0,20,35.000,35.000
10,0.980,Cw,23-5,14,26,0,40,35.000,35.000
10,0.980,Cliff Sparrow,16-23,1,11,0,12,8.333,8.333
10,0.980,Cliff Sparrow,23-5,0,5,0,5,0.000,0.000
10,0.980,Pig,16-23,9,8,0,17,52.941,52.941
10,0.980,Pig,23-5,4,5,0,9,44.444,44.444
10,0.980,Barn Owl,16-23,0,0,0,0,NaN,NaN
10,0.980,Barn Owl,23-5,0,0,0,0,NaN,NaN
10,0.980,Wild Pig,16-23,0,0,0,0,NaN,NaN
10,0.980,Wild Pig,23-5,0,2,0,2,0.000,0.000
10,0.980,Pennington Creek Water,16-23,0,0,0,0,NaN,NaN
10,0.980,Pennington Creek Water,23-5,0,0,0,0,NaN,NaN
10,0.980,Guinni,16-23,0,0,0,0,NaN,NaN
10,0.980,Guinni,23-5,0,0,0,0,NaN,NaN
10,0.980,Racoon,16-23,0,0,0,0,NaN,NaN
10,0.980,Racoon,23-5,0,0,0,0,NaN,NaN
10,0.980,Hu,16-23,15,14,0,29,51.724,51.724
10,0.980,Hu,23-5,23,15,0,38,60.526,60.526
10,0.980,Cw and Dg,16-23,5,15,0,20,25.000,25.000
10,0.980,Cw and Dg,23-5,15,17,0,32,46.875,46.875
10,0.980,Red Wind Blackbird,16-23,0,0,0,0,NaN,NaN
10,0.980,Red Wind Blackbird,23-5,0,0,0,0,NaN,NaN
10,0.980,Tree Swallow,16-23,0,0,0,0,NaN,NaN
10,0.980,Tree Swallow,23-5,0,0,0,0,NaN,NaN
10,0.980,Turkey Vulture,16-23,0,0,0,0,NaN,NaN
10,0.980,Turkey Vulture,23-5,0,0,0,0,NaN,NaN
10,0.980,Dg,16-23,5,9,0,14,35.714,35.714
10,0.980,Dg,23-5,31,23,0,54,57.407,57.407
10,0.980,Western Kingbird,16-23,0,0,0,0,NaN,NaN
10,0.980,Western Kingbird,23-5,0,0,0,0,NaN,NaN
10,0.980,White Crowned Sparrow,16-23,0,1,0,1,0.000,0.000
10,0.980,White Crowned Sparrow,23-5,0,14,0,14,0.000,0.000
10,0.980,Eared Grebe,16-23,0,0,0,0,NaN,NaN
10,0.980,Eared Grebe,23-5,0,10,0,10,0.000,0.000
10,0.980,cougar,16-23,0,0,0,0,NaN,NaN
10,0.980,cougar,23-5,0,0,0,0,NaN,NaN
10,0.980,Ocean Water,16-23,0,0,0,0,NaN,NaN
10,0.980,Ocean Water,23-5,0,0,0,0,NaN,NaN
10,0.980,Red Tailed Hawk,16-23,0,0,0,0,NaN,NaN
10,0.980,Red Tailed Hawk,23-5,0,4,0,4,0.000,0.000
10,0.980,Dog,16-23,54,71,0,125,43.200,43.200
10,0.980,Dog,23-5,88,125,0,213,41.315,41.315
10,0.980,Human,16-23,1732,767,0,2499,69.308,69.308
10,0.980,Human,23-5,2139,631,0,2770,77.220,77.220
10,0.980,Wild Turkey,16-23,1,7,0,8,12.500,12.500
10,0.980,Wild Turkey,23-5,4,26,0,30,13.333,13.333
10,0.980,Clark Grebe,16-23,0,0,0,0,NaN,NaN
10,0.980,Clark Grebe,23-5,0,0,0,0,NaN,NaN
10,0.980,Seagull,16-23,0,0,0,0,NaN,NaN
10,0.980,Seagull,23-5,7,8,0,15,46.667,46.667
10,0.980,Surf Scoter,16-23,0,0,0,0,NaN,NaN
10,0.980,Surf Scoter,23-5,2,0,0,2,100.000,100.000
10,0.980,Pigeon,16-23,49,141,0,190,25.789,25.789
10,0.980,Pigeon,23-5,84,211,0,295,28.475,28.475
10,0.980,Pacific Ocean Water,16-23,0,0,0,0,NaN,NaN
10,0.980,Pacific Ocean Water,23-5,0,0,0,0,NaN,NaN
10,0.980,Cat,16-23,19,24,0,43,44.186,44.186
10,0.980,Cat,23-5,22,28,0,50,44.000,44.000
10,0.980,Horse,16-23,6,19,0,25,24.000,24.000
10,0.980,Horse,23-5,26,138,0,164,15.854,15.854
10,0.980,orangutan,16-23,0,0,0,0,NaN,NaN
10,0.980,orangutan,23-5,0,0,0,0,NaN,NaN
10,0.980,Bat,16-23,36,31,0,67,53.731,53.731
10,0.980,Bat,23-5,37,32,0,69,53.623,53.623
10,0.980,Deer,16-23,15,38,0,53,28.302,28.302
10,0.980,Deer,23-5,18,117,0,135,13.333,13.333
10,0.980,Great Horned Owl,16-23,0,0,0,0,NaN,NaN
10,0.980,Great Horned Owl,23-5,0,1,0,1,0.000,0.000
10,0.980,Freshwater Lagoon,16-23,0,0,0,0,NaN,NaN
10,0.980,Freshwater Lagoon,23-5,0,0,0,0,NaN,NaN
10,0.980,Unknown Avian,16-23,0,0,0,0,NaN,NaN
10,0.980,Unknown Avian,23-5,0,0,0,0,NaN,NaN
10,0.980,Human UTI,16-23,78,80,0,158,49.367,49.367
10,0.980,Human UTI,23-5,101,99,0,200,50.500,50.500
10,0.980,unknown,16-23,0,0,0,0,NaN,NaN
10,0.980,unknown,23-5,0,4,0,4,0.000,0.000
10,0.980,SLO Creek Water,16-23,0,0,0,0,NaN,NaN
10,0.980,SLO Creek Water,23-5,0,0,0,0,NaN,NaN
10,0.980,Pig/Swine,16-23,7,6,0,13,53.846,53.846
10,0.980,Pig/Swine,23-5,9,11,0,20,45.000,45.000
10,0.980,Klebsiella,16-23,0,0,0,0,NaN,NaN
10,0.980,Klebsiella,23-5,0,0,0,0,NaN,NaN
10,0.980,Hu Cw and Dg,16-23,11,18,0,29,37.931,37.931
10,0.980,Hu Cw and Dg,23-5,11,22,0,33,33.333,33.333
10,0.980,Ground Squirrel,16-23,87,48,0,135,64.444,64.444
10,0.980,Ground Squirrel,23-5,84,76,0,160,52.500,52.500
10,0.980,Opossum,16-23,0,0,0,0,NaN,NaN
10,0.980,Opossum,23-5,0,0,0,0,NaN,NaN
10,0.980,Cow,16-23,1561,1128,0,2689,58.051,58.051
10,0.980,Cow,23-5,1514,1442,0,2956,51.218,51.218
10,0.980,Deer Mouse,16-23,0,0,0,0,NaN,NaN
10,0.980,Deer Mouse,23-5,0,0,0,0,NaN,NaN
10,0.980,OVERALL,16-23,3758,2518,0,6276,59.879,59.879
10,0.980,OVERALL,23-5,4319,3192,0,7511,57.502,57.502
10,0.990,Chicken,16-23,2,7,0,9,22.222,22.222
10,0.990,Chicken,23-5,9,9,0,18,50.000,50.000
10,0.990,Sea Lion,16-23,0,1,0,1,0.000,0.000
10,0.990,Sea Lion,23-5,2,7,0,9,22.222,22.222
10,0.990,Hu and Cw,16-23,3,7,0,10,30.000,30.000
10,0.990,Hu and Cw,23-5,4,25,0,29,13.793,13.793
10,0.990,Sheep,16-23,50,49,0,99,50.505,50.505
10,0.990,Sheep,23-5,58,41,0,99,58.586,58.586
10,0.990,Hu and Dg,16-23,7,12,0,19,36.842,36.842
10,0.990,Hu and Dg,23-5,19,14,0,33,57.576,57.576
10,0.990,Common Loon,16-23,0,0,0,0,NaN,NaN
10,0.990,Common Loon,23-5,0,2,0,2,0.000,0.000
10,0.990,Red-Winged Blackbird,16-23,0,3,0,3,0.000,0.000
10,0.990,Red-Winged Blackbird,23-5,0,0,0,0,NaN,NaN
10,0.990,Cw,16-23,8,13,0,21,38.095,38.095
10,0.990,Cw,23-5,20,28,0,48,41.667,41.667
10,0.990,Cliff Sparrow,16-23,1,12,0,13,7.692,7.692
10,0.990,Cliff Sparrow,23-5,0,8,0,8,0.000,0.000
10,0.990,Pig,16-23,9,9,0,18,50.000,50.000
10,0.990,Pig,23-5,8,9,0,17,47.059,47.059
10,0.990,Barn Owl,16-23,0,0,0,0,NaN,NaN
10,0.990,Barn Owl,23-5,0,0,0,0,NaN,NaN
10,0.990,Wild Pig,16-23,0,2,0,2,0.000,0.000
10,0.990,Wild Pig,23-5,0,3,0,3,0.000,0.000
10,0.990,Pennington Creek Water,16-23,0,0,0,0,NaN,NaN
10,0.990,Pennington Creek Water,23-5,0,0,0,0,NaN,NaN
10,0.990,Guinni,16-23,0,0,0,0,NaN,NaN
10,0.990,Guinni,23-5,0,0,0,0,NaN,NaN
10,0.990,Racoon,16-23,0,0,0,0,NaN,NaN
10,0.990,Racoon,23-5,0,1,0,1,0.000,0.000
10,0.990,Hu,16-23,15,12,0,27,55.556,55.556
10,0.990,Hu,23-5,23,12,0,35,65.714,65.714
10,0.990,Cw and Dg,16-23,5,15,0,20,25.000,25.000
10,0.990,Cw and Dg,23-5,15,11,0,26,57.692,57.692
10,0.990,Red Wind Blackbird,16-23,0,0,0,0,NaN,NaN
10,0.990,Red Wind Blackbird,23-5,0,0,0,0,NaN,NaN
10,0.990,Tree Swallow,16-23,0,0,0,0,NaN,NaN
10,0.990,Tree Swallow,23-5,0,0,0,0,NaN,NaN
10,0.990,Turkey Vulture,16-23,0,0,0,0,NaN,NaN
10,0.990,Turkey Vulture,23-5,0,0,0,0,NaN,NaN
10,0.990,Dg,16-23,5,10,0,15,33.333,33.333
10,0.990,Dg,23-5,31,19,0,50,62.000,62.000
10,0.990,Western Kingbird,16-23,0,0,0,0,NaN,NaN
10,0.990,Western Kingbird,23-5,0,0,0,0,NaN,NaN
10,0.990,White Crowned Sparrow,16-23,0,1,0,1,0.000,0.000
10,0.990,White Crowned Sparrow,23-5,0,14,0,14,0.000,0.000
10,0.990,Eared Grebe,16-23,0,0,0,0,NaN,NaN
10,0.990,Eared Grebe,23-5,0,11,0,11,0.000,0.000
10,0.990,cougar,16-23,0,1,0,1,0.000,0.000
10,0.990,cougar,23-5,0,0,0,0,NaN,NaN
10,0.990,Ocean Water,16-23,0,0,0,0,NaN,NaN
10,0.990,Ocean Water,23-5,0,0,0,0,NaN,NaN
10,0.990,Red Tailed Hawk,16-23,0,0,0,0,NaN,NaN
10,0.990,Red Tailed Hawk,23-5,0,4,0,4,0.000,0.000
10,0.990,Dog,16-23,57,74,0,131,43.511,43.511
10,0.990,Dog,23-5,91,118,0,209,43.541,43.541
10,0.990,Human,16-23,1709,726,0,2435,70.185,70.185
10,0.990,Human,23-5,2121,581,0,2702,78.497,78.497
10,0.990,Wild Turkey,16-23,3,12,0,15,20.000,20.000
10,0.990,Wild Turkey,23-5,4,26,0,30,13.333,13.333
10,0.990,Clark Grebe,16-23,0,0,0,0,NaN,NaN
10,0.990,Clark Grebe,23-5,2,3,0,5,40.000,40.000
10,0.990,Seagull,16-23,0,0,0,0,NaN,NaN
10,0.990,Seagull,23-5,12,7,0,19,63.158,63.158
10,0.990,Surf Scoter,16-23,0,0,0,0,NaN,NaN
10,0.990,Surf Scoter,23-5,2,0,0,2,100.000,100.000
10,0.990,Pigeon,16-23,56,135,0,191,29.319,29.319
10,0.990,Pigeon,23-5,90,224,0,314,28.662,28.662
10,0.990,Pacific Ocean Water,16-23,0,0,0,0,NaN,NaN
10,0.990,Pacific Ocean Water,23-5,0,0,0,0,NaN,NaN
10,0.990,Cat,16-23,19,26,0,45,42.222,42.222
10,0.990,Cat,23-5,22,31,0,53,41.509,41.509
10,0.990,Horse,16-23,9,19,0,28,32.143,32.143
10,0.990,Horse,23-5,26,144,0,170,15.294,15.294
10,0.990,orangutan,16-23,0,0,0,0,NaN,NaN
10,0.990,orangutan,23-5,0,0,0,0,NaN,NaN
10,0.990,Bat,16-23,36,29,0,65,55.385,55.385
10,0.990,Bat,23-5,37,31,0,68,54.412,54.412
10,0.990,Deer,16-23,15,39,0,54,27.778,27.778
10,0.990,Deer,23-5,18,111,0,129,13.953,13.953
10,0.990,Great Horned Owl,16-23,0,0,0,0,NaN,NaN
10,0.990,Great Horned Owl,23-5,0,1,0,1,0.000,0.000
10,0.990,Freshwater Lagoon,16-23,0,0,0,0,NaN,NaN
10,0.990,Freshwater Lagoon,23-5,0,0,0,0,NaN,NaN
10,0.990,Unknown Avian,16-23,0,0,0,0,NaN,NaN
10,0.990,Unknown Avian,23-5,0,0,0,0,NaN,NaN
10,0.990,Human UTI,16-23,82,76,0,158,51.899,51.899
10,0.990,Human UTI,23-5,102,80,0,182,56.044,56.044
10,0.990,unknown,16-23,0,0,0,0,NaN,NaN
10,0.990,unknown,23-5,0,6,0,6,0.000,0.000
10,0.990,SLO Creek Water,16-23,0,0,0,0,NaN,NaN
10,0.990,SLO Creek Water,23-5,0,0,0,0,NaN,NaN
10,0.990,Pig/Swine,16-23,6,7,0,13,46.154,46.154
10,0.990,Pig/Swine,23-5,9,10,0,19,47.368,47.368
10,0.990,Klebsiella,16-23,0,0,0,0,NaN,NaN
10,0.990,Klebsiella,23-5,0,0,0,0,NaN,NaN
10,0.990,Hu Cw and Dg,16-23,11,18,0,29,37.931,37.931
10,0.990,Hu Cw and Dg,23-5,11,21,0,32,34.375,34.375
10,0.990,Ground Squirrel,16-23,89,49,0,138,64.493,64.493
10,0.990,Ground Squirrel,23-5,86,80,0,166,51.807,51.807
10,0.990,Opossum,16-23,1,0,0,1,100.000,100.000
10,0.990,Opossum,23-5,2,0,0,2,100.000,100.000
10,0.990,Cow,16-23,1524,1028,0,2552,59.718,59.718
10,0.990,Cow,23-5,1475,1314,0,2789,52.886,52.886
10,0.990,Deer Mouse,16-23,0,0,0,0,NaN,NaN
10,0.990,Deer Mouse,23-5,0,0,0,0,NaN,NaN
10,0.990,OVERALL,16-23,3722,2392,0,6114,60.877,60.877
10,0.990,OVERALL,23-5,4299,3006,0,7305,58.850,58.850
10,1.000,Chicken,16-23,0,0,0,0,NaN,NaN
10,1.000,Chicken,23-5,0,0,0,0,NaN,NaN
10,1.000,Sea Lion,16-23,0,0,0,0,NaN,NaN
10,1.000,Sea Lion,23-5,0,0,0,0,NaN,NaN
10,1.000,Hu and Cw,16-23,0,0,0,0,NaN,NaN
10,1.000,Hu and Cw,23-5,0,0,0,0,NaN,NaN
10,1.000,Sheep,16-23,0,0,0,0,NaN,NaN
10,1.000,Sheep,23-5,0,0,0,0,NaN,NaN
10,1.000,Hu and Dg,16-23,0,0,0,0,NaN,NaN
10,1.000,Hu and Dg,23-5,0,0,0,0,NaN,NaN
10,1.000,Common Loon,16-23,0,0,0,0,NaN,NaN
10,1.000,Common Loon,23-5,0,0,0,0,NaN,NaN
10,1.000,Red-Winged Blackbird,16-23,0,0,0,0,NaN,NaN
10,1.000,Red-Winged Blackbird,23-5,0,0,0,0,NaN,NaN
10,1.000,Cw,16-23,0,0,0,0,NaN,NaN
10,1.000,Cw,23-5,0,0,0,0,NaN,NaN
10,1.000,Cliff Sparrow,16-23,0,0,0,0,NaN,NaN
10,1.000,Cliff Sparrow,23-5,0,0,0,0,NaN,NaN
10,1.000,Pig,16-23,0,0,0,0,NaN,NaN
10,1.000,Pig,23-5,0,0,0,0,NaN,NaN
10,1.000,Barn Owl,16-23,0,0,0,0,NaN,NaN
10,1.000,Barn Owl,23-5,0,0,0,0,NaN,NaN
10,1.000,Wild Pig,16-23,0,0,0,0,NaN,NaN
10,1.000,Wild Pig,23-5,0,0,0,0,NaN,NaN
10,1.000,Pennington Creek Water,16-23,0,0,0,0,NaN,NaN
10,1.000,Pennington Creek Water,23-5,0,0,0,0,NaN,NaN
10,1.000,Guinni,16-23,0,0,0,0,NaN,NaN
10,1.000,Guinni,23-5,0,0,0,0,NaN,NaN
10,1.000,Racoon,16-23,0,0,0,0,NaN,NaN
10,1.000,Racoon,23-5,0,0,0,0,NaN,NaN
10,1.000,Hu,16-23,0,0,0,0,NaN,NaN
10,1.000,Hu,23-5,0,0,0,0,NaN,NaN
10,1.000,Cw and Dg,16-23,0,0,0,0,NaN,NaN
10,1.000,Cw and Dg,23-5,0,0,0,0,NaN,NaN
10,1.000,Red Wind Blackbird,16-23,0,0,0,0,NaN,NaN
10,1.000,Red Wind Blackbird,23-5,0,0,0,0,NaN,NaN
10,1.000,Tree Swallow,16-23,0,0,0,0,NaN,NaN
10,1.000,Tree Swallow,23-5,0,0,0,0,NaN,NaN
10,1.000,Turkey Vulture,16-23,0,0,0,0,NaN,NaN
10,1.000,Turkey Vulture,23-5,0,0,0,0,NaN,NaN
10,1.000,Dg,16-23,0,0,0,0,NaN,NaN
10,1.000,Dg,23-5,0,0,0,0,NaN,NaN
10,1.000,Western Kingbird,16-23,0,0,0,0,NaN,NaN
10,1.000,Western Kingbird,23-5,0,0,0,0,NaN,NaN
10,1.000,White Crowned Sparrow,16-23,0,0,0,0,NaN,NaN
10,1.000,White Crowned Sparrow,23-5,0,0,0,0,NaN,NaN
10,1.000,Eared Grebe,16-23,0,0,0,0,NaN,NaN
10,1.000,Eared Grebe,23-5,0,0,0,0,NaN,NaN
10,1.000,cougar,16-23,0,0,0,0,NaN,NaN
10,1.000,cougar,23-5,0,0,0,0,NaN,NaN
10,1.000,Ocean Water,16-23,0,0,0,0,NaN,NaN
10,1.000,Ocean Water,23-5,0,0,0,0,NaN,NaN
10,1.000,Red Tailed Hawk,16-23,0,0,0,0,NaN,NaN
10,1.000,Red Tailed Hawk,23-5,0,0,0,0,NaN,NaN
10,1.000,Dog,16-23,0,0,0,0,NaN,NaN
10,1.000,Dog,23-5,0,0,0,0,NaN,NaN
10,1.000,Human,16-23,0,0,0,0,NaN,NaN
10,1.000,Human,23-5,0,0,0,0,NaN,NaN
10,1.000,Wild Turkey,16-23,0,0,0,0,NaN,NaN
10,1.000,Wild Turkey,23-5,0,0,0,0,NaN,NaN
10,1.000,Clark Grebe,16-23,0,0,0,0,NaN,NaN
10,1.000,Clark Grebe,23-5,0,0,0,0,NaN,NaN
10,1.000,Seagull,16-23,0,0,0,0,NaN,NaN
10,1.000,Seagull,23-5,0,0,0,0,NaN,NaN
10,1.000,Surf Scoter,16-23,0,0,0,0,NaN,NaN
10,1.000,Surf Scoter,23-5,0,0,0,0,NaN,NaN
10,1.000,Pigeon,16-23,0,0,0,0,NaN,NaN
10,1.000,Pigeon,23-5,0,0,0,0,NaN,NaN
10,1.000,Pacific Ocean Water,16-23,0,0,0,0,NaN,NaN
10,1.000,Pacific Ocean Water,23-5,0,0,0,0,NaN,NaN
10,1.000,Cat,16-23,0,0,0,0,NaN,NaN
10,1.000,Cat,23-5,0,0,0,0,NaN,NaN
10,1.000,Horse,16-23,0,0,0,0,NaN,NaN
10,1.000,Horse,23-5,0,0,0,0,NaN,NaN
10,1.000,orangutan,16-23,0,0,0,0,NaN,NaN
10,1.000,orangutan,23-5,0,0,0,0,NaN,NaN
10,1.000,Bat,16-23,0,0,0,0,NaN,NaN
10,1.000,Bat,23-5,0,0,0,0,NaN,NaN
10,1.000,Deer,16-23,0,0,0,0,NaN,NaN
10,1.000,Deer,23-5,0,0,0,0,NaN,NaN
10,1.000,Great Horned Owl,16-23,0,0,0,0,NaN,NaN
10,1.000,Great Horned Owl,23-5,0,0,0,0,NaN,NaN
10,1.000,Freshwater Lagoon,16-23,0,0,0,0,NaN,NaN
10,1.000,Freshwater Lagoon,23-5,0,0,0,0,NaN,NaN
10,1.000,Unknown Avian,16-23,0,0,0,0,NaN,NaN
10,1.000,Unknown Avian,23-5,0,0,0,0,NaN,NaN
10,1.000,Human UTI,16-23,0,0,0,0,NaN,NaN
10,1.000,Human UTI,23-5,0,0,0,0,NaN,NaN
10,1.000,unknown,16-23,0,0,0,0,NaN,NaN
10,1.000,unknown,23-5,0,0,0,0,NaN,NaN
10,1.000,SLO Creek Water,16-23,0,0,0,0,NaN,NaN
10,1.000,SLO Creek Water,23-5,0,0,0,0,NaN,NaN
10,1.000,Pig/Swine,16-23,0,0,0,0,NaN,NaN
10,1.000,Pig/Swine,23-5,0,0,0,0,NaN,NaN
10,1.000,Klebsiella,16-23,0,0,0,0,NaN,NaN
10,1.000,Klebsiella,23-5,0,0,0,0,NaN,NaN
10,1.000,Hu Cw and Dg,16-23,0,0,0,0,NaN,NaN
10,1.000,Hu Cw and Dg,23-5,0,0,0,0,NaN,NaN
10,1.000,Ground Squirrel,16-23,0,0,0,0,NaN,NaN
10,1.000,Ground Squirrel,23-5,0,0,0,0,NaN,NaN
10,1.000,Opossum,16-23,0,0,0,0,NaN,NaN
10,1.000,Opossum,23-5,0,0,0,0,NaN,NaN
10,1.000,Cow,16-23,0,0,0,0,NaN,NaN
10,1.000,Cow,23-5,0,0,0,0,NaN,NaN
10,1.000,Deer Mouse,16-23,0,0,0,0,NaN,NaN
10,1.000,Deer Mouse,23-5,0,0,0,0,NaN,NaN
10,1.000,OVERALL,16-23,0,0,0,0,NaN,NaN
10,1.000,OVERALL,23-5,0,0,0,0,NaN,NaN
11,0.000,Chicken,16-23,0,1,0,1,0.000,0.000
11,0.000,Chicken,23-5,8,8,0,16,50.000,50.000
11,0.000,Sea Lion,16-23,0,0,0,0,NaN,NaN
11,0.000,Sea Lion,23-5,0,11,0,11,0.000,0.000
11,0.000,Hu and Cw,16-23,1,4,0,5,20.000,20.000
11,0.000,Hu and Cw,23-5,7,8,0,15,46.667,46.667
11,0.000,Sheep,16-23,47,51,0,98,47.959,47.959
11,0.000,Sheep,23-5,53,39,0,92,57.609,57.609
11,0.000,Hu and Dg,16-23,8,13,0,21,38.095,38.095
11,0.000,Hu and Dg,23-5,18,21,0,39,46.154,46.154
11,0.000,Common Loon,16-23,0,0,0,0,NaN,NaN
11,0.000,Common Loon,23-5,0,0,0,0,NaN,NaN
11,0.000,Red-Winged Blackbird,16-23,0,1,0,1,0.000,0.000
11,0.000,Red-Winged Blackbird,23-5,0,0,0,0,NaN,NaN
11,0.000,Cw,16-23,8,13,0,21,38.095,38.095
11,0.000,Cw,23-5,14,25,0,39,35.897,35.897
11,0.000,Cliff Sparrow,16-23,2,9,0,11,18.182,18.182
11,0.000,Cliff Sparrow,23-5,0,0,0,0,NaN,NaN
11,0.000,Pig,16-23,9,7,0,16,56.250,56.250
11,0.000,Pig,23-5,3,3,0,6,50.000,50.000
11,0.000,Barn Owl,16-23,0,0,0,0,NaN,NaN
11,0.000,Barn Owl,23-5,0,0,0,0,NaN,NaN
11,0.000,Wild Pig,16-23,0,0,0,0,NaN,NaN
11,0.000,Wild Pig,23-5,1,3,0,4,25.000,25.000
11,0.000,Pennington Creek Water,16-23,0,0,0,0,NaN,NaN
11,0.000,Pennington Creek Water,23-5,0,0,0,0,NaN,NaN
11,0.000,Guinni,16-23,0,0,0,0,NaN,NaN
11,0.000,Guinni,23-5,0,0,0,0,NaN,NaN
11,0.000,Racoon,16-23,0,0,0,0,NaN,NaN
11,0.000,Racoon,23-5,0,0,0,0,NaN,NaN
11,0.000,Hu,16-23,15,15,0,30,50.000,50.000
11,0.000,Hu,23-5,24,14,0,38,63.158,63.158
11,0.000,Cw and Dg,16-23,6,16,0,22,27.273,27.273
11,0.000,Cw and Dg,23-5,14,18,0,32,43.750,43.750
11,0.000,Red Wind Blackbird,16-23,0,0,0,0,NaN,NaN
11,0.000,Red Wind Blackbird,23-5,0,0,0,0,NaN,NaN
11,0.000,Tree Swallow,16-23,0,0,0,0,NaN,NaN
11,0.000,Tree Swallow,23-5,0,0,0,0,NaN,NaN
11,0.000,Turkey Vulture,16-23,0,0,0,0,NaN,NaN
11,0.000,Turkey Vulture,23-5,0,0,0,0,NaN,NaN
11,0.000,Dg,16-23,6,9,0,15,40.000,40.000
11,0.000,Dg,23-5,32,32,0,64,50.000,50.000
11,0.000,Western Kingbird,16-23,0,0,0,0,NaN,NaN
11,0.000,Western Kingbird,23-5,0,0,0,0,NaN,NaN
11,0.000,White Crowned Sparrow,16-23,0,1,0,1,0.000,0.000
11,0.000,White Crowned Sparrow,23-5,0,8,0,8,0.000,0.000
11,0.000,Eared Grebe,16-23,0,0,0,0,NaN,NaN
11,0.000,Eared Grebe,23-5,0,10,0,10,0.000,0.000
11,0.000,cougar,16-23,0,0,0,0,NaN,NaN
11,0.000,cougar,23-5,0,0,0,0,NaN,NaN
11,0.000,Ocean Water,16-23,0,0,0,0,NaN,NaN
11,0.000,Ocean Water,23-5,0,0,0,0,NaN,NaN
11,0.000,Red Tailed Hawk,16-23,0,0,0,0,NaN,NaN
11,0.000,Red Tailed Hawk,23-5,0,7,0,7,0.000,0.000
11,0.000,Dog,16-23,55,69,0,124,44.355,44.355
11,0.000,Dog,23-5,88,144,0,232,37.931,37.931
11,0.000,Human,16-23,1719,799,0,2518,68.268,68.268
11,0.000,Human,23-5,2143,690,0,2833,75.644,75.644
11,0.000,Wild Turkey,16-23,1,4,0,5,20.000,20.000
11,0.000,Wild Turkey,23-5,0,12,0,12,0.000,0.000
11,0.000,Clark Grebe,16-23,0,0,0,0,NaN,NaN
11,0.000,Clark Grebe,23-5,0,0,0,0,NaN,NaN
11,0.000,Seagull,16-23,0,0,0,0,NaN,NaN
11,0.000,Seagull,23-5,5,8,0,13,38.462,38.462
11,0.000,Surf Scoter,16-23,0,0,0,0,NaN,NaN
11,0.000,Surf Scoter,23-5,0,0,0,0,NaN,NaN
11,0.000,Pigeon,16-23,47,143,0,190,24.737,24.737
11,0.000,Pigeon,23-5,75,156,0,231,32.468,32.468
11,0.000,Pacific Ocean Water,16-23,0,0,0,0,NaN,NaN
11,0.000,Pacific Ocean Water,23-5,0,0,0,0,NaN,NaN
11,0.000,Cat,16-23,19,22,0,41,46.341,46.341
11,0.000,Cat,23-5,20,24,0,44,45.455,45.455
11,0.000,Horse,16-23,5,19,0,24,20.833,20.833
11,0.000,Horse,23-5,25,115,0,140,17.857,17.857
11,0.000,orangutan,16-23,0,0,0,0,NaN,NaN
11,0.000,orangutan,23-5,0,0,0,0,NaN,NaN
11,0.000,Bat,16-23,36,32,0,68,52.941,52.941
11,0.000,Bat,23-5,37,36,0,73,50.685,50.685
11,0.000,Deer,16-23,14,35,0,49,28.571,28.571
11,0.000,Deer,23-5,19,121,0,140,13.571,13.571
11,0.000,Great Horned Owl,16-23,0,0,0,0,NaN,NaN
11,0.000,Great Horned Owl,23-5,0,0,0,0,NaN,NaN
11,0.000,Freshwater Lagoon,16-23,0,0,0,0,NaN,NaN
11,0.000,Freshwater Lagoon,23-5,0,0,0,0,NaN,NaN
11,0.000,Unknown Avian,16-23,0,0,0,0,NaN,NaN
11,0.000,Unknown Avian,23-5,0,0,0,0,NaN,NaN
11,0.000,Human UTI,16-23,75,77,0,152,49.342,49.342
11,0.000,Human UTI,23-5,100,104,0,204,49.020,49.020
11,0.000,unknown,16-23,0,0,0,0,NaN,NaN
11,0.000,unknown,23-5,0,2,0,2,0.000,0.000
11,0.000,SLO Creek Water,16-23,0,0,0,0,NaN,NaN
11,0.000,SLO Creek Water,23-5,0,0,0,0,NaN,NaN
11,0.000,Pig/Swine,16-23,5,6,0,11,45.455,45.455
11,0.000,Pig/Swine,23-5,8,12,0,20,40.000,40.000
11,0.000,Klebsiella,16-23,0,0,0,0,NaN,NaN
11,0.000,Klebsiella,23-5,0,0,0,0,NaN,NaN
11,0.000,Hu Cw and Dg,16-23,7,11,0,18,38.889,38.889
11,0.000,Hu Cw and Dg,23-5,8,14,0,22,36.364,36.364
11,0.000,Ground Squirrel,16-23,87,54,0,141,61.702,61.702
11,0.000,Ground Squirrel,23-5,84,72,0,156,53.846,53.846
11,0.000,Opossum,16-23,0,0,0,0,NaN,NaN
11,0.000,Opossum,23-5,0,0,0,0,NaN,NaN
11,0.000,Cow,16-23,1575,1190,0,2765,56.962,56.962
11,0.000,Cow,23-5,1536,1571,0,3107,49.437,49.437
11,0.000,Deer Mouse,16-23,0,0,0,0,NaN,NaN
11,0.000,Deer Mouse,23-5,0,0,0,0,NaN,NaN
11,0.000,OVERALL,16-23,3747,2601,0,6348,59.026,59.026
11,0.000,OVERALL,23-5,4322,3288,0,7610,56.794,56.794
11,0.500,Chicken,16-23,0,1,0,1,0.000,0.000
11,0.500,Chicken,23-5,8,8,0,16,50.000,50.000
11,0.500,Sea Lion,16-23,0,0,0,0,NaN,NaN
11,0.500,Sea Lion,23-5,0,11,0,11,0.000,0.000
11,0.500,Hu and Cw,16-23,1,4,0,5,20.000,20.000
11,0.500,Hu and Cw,23-5,7,8,0,15,46.667,46.667
11,0.500,Sheep,16-23,47,51,0,98,47.959,47.959
11,0.500,Sheep,23-5,53,39,0,92,57.609,57.609
11,0.500,Hu and Dg,16-23,8,13,0,21,38.095,38.095
11,0.500,Hu and Dg,23-5,18,21,0,39,46.154,46.154
11,0.500,Common Loon,16-23,0,0,0,0,NaN,NaN
11,0.500,Common Loon,23-5,0,0,0,0,NaN,NaN
11,0.500,Red-Winged Blackbird,16-23,0,1,0,1,0.000,0.000
11,0.500,Red-Winged Blackbird,23-5,0,0,0,0,NaN,NaN
11,0.500,Cw,16-23,8,13,0,21,38.095,38.095
11,0.500,Cw,23-5,14,25,0,39,35.897,35.897
11,0.500,Cliff Sparrow,16-23,2,9,0,11,18.182,18.182
11,0.500,Cliff Sparrow,23-5,0,0,0,0,NaN,NaN
11,0.500,Pig,16-23,9,7,0,16,56.250,56.250
11,0.500,Pig,23-5,3,3,0,6,50.000,50.000
11,0.500,Barn Owl,16-23,0,0,0,0,NaN,NaN
11,0.500,Barn Owl,23-5,0,0,0,0,NaN,NaN
11,0.500,Wild Pig,16-23,0,0,0,0,NaN,NaN
11,0.500,Wild Pig,23-5,1,3,0,4,25.000,25.000
11,0.500,Pennington Creek Water,16-23,0,0,0,0,NaN,NaN
11,0.500,Pennington Creek Water,23-5,0,0,0,0,NaN,NaN
11,0.500,Guinni,16-23,0,0,0,0,NaN,NaN
11,0.500,Guinni,23-5,0,0,0,0,NaN,NaN
11,0.500,Racoon,16-23,0,0,0,0,NaN,NaN
11,0.500,Racoon,23-5,0,0,0,0,NaN,NaN
11,0.500,Hu,16-23,15,15,0,30,50.000,50.000
11,0.500,Hu,23-5,24,14,0,38,63.158,63.158
11,0.500,Cw and Dg,16-23,6,16,0,22,27.273,27.273
11,0.500,Cw and Dg,23-5,14,18,0,32,43.750,43.750
11,0.500,Red Wind Blackbird,16-23,0,0,0,0,NaN,NaN
11,0.500,Red Wind Blackbird,23-5,0,0,0,0,NaN,NaN
11,0.500,Tree Swallow,16-23,0,0,0,0,NaN,NaN
11,0.500,Tree Swallow,23-5,0,0,0,0,NaN,NaN
11,0.500,Turkey Vulture,16-23,0,0,0,0,NaN,NaN
11,0.500,Turkey Vulture,23-5,0,0,0,0,NaN,NaN
11,0.500,Dg,16-23,6,9,0,15,40.000,40.000
11,0.500,Dg,23-5,32,32,0,64,50.000,50.000
11,0.500,Western Kingbird,16-23,0,0,0,0,NaN,NaN
11,0.500,Western Kingbird,23-5,0,0,0,0,NaN,NaN
11,0.500,White Crowned Sparrow,16-23,0,1,0,1,0.000,0.000
11,0.500,White Crowned Sparrow,23-5,0,8,0,8,0.000,0.000
11,0.500,Eared Grebe,16-23,0,0,0,0,NaN,NaN
11,0.500,Eared Grebe,23-5,0,10,0,10,0.000,0.000
11,0.500,cougar,16-23,0,0,0,0,NaN,NaN
11,0.500,cougar,23-5,0,0,0,0,NaN,NaN
11,0.500,Ocean Water,16-23,0,0,0,0,NaN,NaN
11,0.500,Ocean Water,23-5,0,0,0,0,NaN,NaN
11,0.500,Red Tailed Hawk,16-23,0,0,0,0,NaN,NaN
11,0.500,Red Tailed Hawk,23-5,0,7,0,7,0.000,0.000
11,0.500,Dog,16-23,55,69,0,124,44.355,44.355
11,0.500,Dog,23-5,88,144,0,232,37.931,37.931
11,0.500,Human,16-23,1719,799,0,2518,68.268,68.268
11,0.500,Human,23-5,2143,690,0,2833,75.644,75.644
11,0.500,Wild Turkey,16-23,1,4,0,5,20.000,20.000
11,0.500,Wild Turkey,23-5,0,12,0,12,0.000,0.000
11,0.500,Clark Grebe,16-23,0,0,0,0,NaN,NaN
11,0.500,Clark Grebe,23-5,0,0,0,0,NaN,NaN
11,0.500,Seagull,16-23,0,0,0,0,NaN,NaN
11,0.500,Seagull,23-5,5,8,0,13,38.462,38.462
11,0.500,Surf Scoter,16-23,0,0,0,0,NaN,NaN
11,0.500,Surf Scoter,23-5,0,0,0,0,NaN,NaN
11,0.500,Pigeon,16-23,47,143,0,190,24.737,24.737
11,0.500,Pigeon,23-5,75,156,0,231,32.468,32.468
11,0.500,Pacific Ocean Water,16-23,0,0,0,0,NaN,NaN
11,0.500,Pacific Ocean Water,23-5,0,0,0,0,NaN,NaN
11,0.500,Cat,16-23,19,22,0,41,46.341,46.341
11,0.500,Cat,23-5,20,24,0,44,45.455,45.455
11,0.500,Horse,16-23,5,19,0,24,20.833,20.833
11,0.500,Horse,23-5,25,115,0,140,17.857,17.857
11,0.500,orangutan,16-23,0,0,0,0,NaN,NaN
11,0.500,orangutan,23-5,0,0,0,0,NaN,NaN
11,0.500,Bat,16-23,36,32,0,68,52.941,52.941
11,0.500,Bat,23-5,37,36,0,73,50.685,50.685
11,0.500,Deer,16-23,14,35,0,49,28.571,28.571
11,0.500,Deer,23-5,19,121,0,140,13.571,13.571
11,0.500,Great Horned Owl,16-23,0,0,0,0,NaN,NaN
11,0.500,Great Horned Owl,23-5,0,0,0,0,NaN,NaN
11,0.500,Freshwater Lagoon,16-23,0,0,0,0,NaN,NaN
11,0.500,Freshwater Lagoon,23-5,0,0,0,0,NaN,NaN
11,0.500,Unknown Avian,16-23,0,0,0,0,NaN,NaN
11,0.500,Unknown Avian,23-5,0,0,0,0,NaN,NaN
11,0.500,Human UTI,16-23,75,77,0,152,49.342,49.342
11,0.500,Human UTI,23-5,100,104,0,204,49.020,49.020
11,0.500,unknown,16-23,0,0,0,0,NaN,NaN
11,0.500,unknown,23-5,0,2,0,2,0.000,0.000
11,0.500,SLO Creek Water,16-23,0,0,0,0,NaN,NaN
11,0.500,SLO Creek Water,23-5,0,0,0,0,NaN,NaN
11,0.500,Pig/Swine,16-23,5,6,0,11,45.455,45.455
11,0.500,Pig/Swine,23-5,8,12,0,20,40.000,40.000
11,0.500,Klebsiella,16-23,0,0,0,0,NaN,NaN
11,0.500,Klebsiella,23-5,0,0,0,0,NaN,NaN
11,0.500,Hu Cw and Dg,16-23,7,11,0,18,38.889,38.889
11,0.500,Hu Cw and Dg,23-5,8,14,0,22,36.364,36.364
11,0.500,Ground Squirrel,16-23,87,54,0,141,61.702,61.702
11,0.500,Ground Squirrel,23-5,84,72,0,156,53.846,53.846
11,0.500,Opossum,16-23,0,0,0,0,NaN,NaN
11,0.500,Opossum,23-5,0,0,0,0,NaN,NaN
11,0.500,Cow,16-23,1575,1190,0,2765,56.962,56.962
11,0.500,Cow,23-5,1536,1571,0,3107,49.437,49.437
11,0.500,Deer Mouse,16-23,0,0,0,0,NaN,NaN
11,0.500,Deer Mouse,23-5,0,0,0,0,NaN,NaN
11,0.500,OVERALL,16-23,3747,2601,0,6348,59.026,59.026
11,0.500,OVERALL,23-5,4322,3288,0,7610,56.794,56.794
11,0.900,Chicken,16-23,0,1,0,1,0.000,0.000
11,0.900,Chicken,23-5,8,8,0,16,50.000,50.000
11,0.900,Sea Lion,16-23,0,0,0,0,NaN,NaN
11,0.900,Sea Lion,23-5,0,11,0,11,0.000,0.000
11,0.900,Hu and Cw,16-23,1,4,0,5,20.000,20.000
11,0.900,Hu and Cw,23-5,7,8,0,15,46.667,46.667
11,0.900,Sheep,16-23,47,51,0,98,47.959,47.959
11,0.900,Sheep,23-5,53,39,0,92,57.609,57.609
11,0.900,Hu and Dg,16-23,8,13,0,21,38.095,38.095
11,0.900,Hu and Dg,23-5,18,21,0,39,46.154,46.154
11,0.900,Common Loon,16-23,0,0,0,0,NaN,NaN
11,0.900,Common Loon,23-5,0,0,0,0,NaN,NaN
11,0.900,Red-Winged Blackbird,16-23,0,1,0,1,0.000,0.000
11,0.900,Red-Winged Blackbird,23-5,0,0,0,0,NaN,NaN
11,0.900,Cw,16-23,8,13,0,21,38.095,38.095
11,0.900,Cw,23-5,14,25,0,39,35.897,35.897
11,0.900,Cliff Sparrow,16-23,2,9,0,11,18.182,18.182
11,0.900,Cliff Sparrow,23-5,0,0,0,0,NaN,NaN
11,0.900,Pig,16-23,9,7,0,16,56.250,56.250
11,0.900,Pig,23-5,3,3,0,6,50.000,50.000
11,0.900,Barn Owl,16-23,0,0,0,0,NaN,NaN
11,0.900,Barn Owl,23-5,0,0,0,0,NaN,NaN
11,0.900,Wild Pig,16-23,0,0,0,0,NaN,NaN
11,0.900,Wild Pig,23-5,1,3,0,4,25.000,25.000
11,0.900,Pennington Creek Water,16-23,0,0,0,0,NaN,NaN
11,0.900,Pennington Creek Water,23-5,0,0,0,0,NaN,NaN
11,0.900,Guinni,16-23,0,0,0,0,NaN,NaN
11,0.900,Guinni,23-5,0,0,0,0,NaN,NaN
11,0.900,Racoon,16-23,0,0,0,0,NaN,NaN
11,0.900,Racoon,23-5,0,0,0,0,NaN,NaN
11,0.900,Hu,16-23,15,15,0,30,50.000,50.000
11,0.900,Hu,23-5,24,14,0,38,63.158,63.158
11,0.900,Cw and Dg,16-23,6,16,0,22,27.273,27.273
11,0.900,Cw and Dg,23-5,14,18,0,32,43.750,43.750
11,0.900,Red Wind Blackbird,16-23,0,0,0,0,NaN,NaN
11,0.900,Red Wind Blackbird,23-5,0,0,0,0,NaN,NaN
11,0.900,Tree Swallow,16-23,0,0,0,0,NaN,NaN
11,0.900,Tree Swallow,23-5,0,0,0,0,NaN,NaN
11,0.900,Turkey Vulture,16-23,0,0,0,0,NaN,NaN
11,0.900,Turkey Vulture,23-5,0,0,0,0,NaN,NaN
11,0.900,Dg,16-23,6,9,0,15,40.000,40.000
11,0.900,Dg,23-5,32,32,0,64,50.000,50.000
11,0.900,Western Kingbird,16-23,0,0,0,0,NaN,NaN
11,0.900,Western Kingbird,23-5,0,0,0,0,NaN,NaN
11,0.900,White Crowned Sparrow,16-23,0,1,0,1,0.000,0.000
11,0.900,White Crowned Sparrow,23-5,0,8,0,8,0.000,0.000
11,0.900,Eared Grebe,16-23,0,0,0,0,NaN,NaN
11,0.900,Eared Grebe,23-5,0,10,0,10,0.000,0.000
11,0.900,cougar,16-23,0,0,0,0,NaN,NaN
11,0.900,cougar,23-5,0,0,0,0,NaN,NaN
11,0.900,Ocean Water,16-23,0,0,0,0,NaN,NaN
11,0.900,Ocean Water,23-5,0,0,0,0,NaN,NaN
11,0.900,Red Tailed Hawk,16-23,0,0,0,0,NaN,NaN
11,0.900,Red Tailed Hawk,23-5,0,7,0,7,0.000,0.000
11,0.900,Dog,16-23,55,69,0,124,44.355,44.355
11,0.900,Dog,23-5,88,139,0,227,38.767,38.767
11,0.900,Human,16-23,1719,798,0,2517,68.296,68.296
11,0.900,Human,23-5,2143,686,0,2829,75.751,75.751
11,0.900,Wild Turkey,16-23,1,4,0,5,20.000,20.000
11,0.900,Wild Turkey,23-5,0,12,0,12,0.000,0.000
11,0.900,Clark Grebe,16-23,0,0,0,0,NaN,NaN
11,0.900,Clark Grebe,23-5,0,0,0,0,NaN,NaN
11,0.900,Seagull,16-23,0,0,0,0,NaN,NaN
11,0.900,Seagull,23-5,5,9,0,14,35.714,35.714
11,0.900,Surf Scoter,16-23,0,0,0,0,NaN,NaN
11,0.900,Surf Scoter,23-5,0,0,0,0,NaN,NaN
11,0.900,Pigeon,16-23,47,144,0,191,24.607,24.607
11,0.900,Pigeon,23-5,75,156,0,231,32.468,32.468
11,0.900,Pacific Ocean Water,16-23,0,0,0,0,NaN,NaN
11,0.900,Pacific Ocean Water,23-5,0,0,0,0,NaN,NaN
11,0.900,Cat,16-23,19,22,0,41,46.341,46.341
11,0.900,Cat,23-5,20,24,0,44,45.455,45.455
11,0.900,Horse,16-23,5,19,0,24,20.833,20.833
11,0.900,Horse,23-5,25,115,0,140,17.857,17.857
11,0.900,orangutan,16-23,0,0,0,0,NaN,NaN
11,0.900,orangutan,23-5,0,0,0,0,NaN,NaN
11,0.900,Bat,16-23,36,32,0,68,52.941,52.941
11,0.900,Bat,23-5,37,36,0,73,50.685,50.685
11,0.900,Deer,16-23,14,35,0,49,28.571,28.571
11,0.900,Deer,23-5,19,121,0,140,13.571,13.571
11,0.900,Great Horned Owl,16-23,0,0,0,0,NaN,NaN
11,0.900,Great Horned Owl,23-5,0,0,0,0,NaN,NaN
11,0.900,Freshwater Lagoon,16-23,0,0,0,0,NaN,NaN
11,0.900,Freshwater Lagoon,23-5,0,0,0,0,NaN,NaN
11,0.900,Unknown Avian,16-23,0,0,0,0,NaN,NaN
11,0.900,Unknown Avian,23-5,0,0,0,0,NaN,NaN
11,0.900,Human UTI,16-23,75,77,0,152,49.342,49.342
11,0.900,Human UTI,23-5,103,104,0,207,49.758,49.758
11,0.900,unknown,16-23,0,0,0,0,NaN,NaN
11,0.900,unknown,23-5,0,2,0,2,0.000,0.000
11,0.900,SLO Creek Water,16-23,0,0,0,0,NaN,NaN
11,0.900,SLO Creek Water,23-5,0,0,0,0,NaN,NaN
11,0.900,Pig/Swine,16-23,5,6,0,11,45.455,45.455
11,0.900,Pig/Swine,23-5,8,12,0,20,40.000,40.000
11,0.900,Klebsiella,16-23,0,0,0,0,NaN,NaN
11,0.900,Klebsiella,23-5,0,0,0,0,NaN,NaN
11,0.900,Hu Cw and Dg,16-23,7,11,0,18,38.889,38.889
11,0.900,Hu Cw and Dg,23-5,8,14,0,22,36.364,36.364
11,0.900,Ground Squirrel,16-23,87,54,0,141,61.702,61.702
11,0.900,Ground Squirrel,23-5,84,72,0,156,53.846,53.846
11,0.900,Opossum,16-23,0,0,0,0,NaN,NaN
11,0.900,Opossum,23-5,0,0,0,0,NaN,NaN
11,0.900,Cow,16-23,1575,1186,0,2761,57.045,57.045
11,0.900,Cow,23-5,1536,1568,0,3104,49.485,49.485
11,0.900,Deer Mouse,16-23,0,0,0,0,NaN,NaN
11,0.900,Deer Mouse,23-5,0,0,0,0,NaN,NaN
11,0.900,OVERALL,16-23,3747,2597,0,6344,59.064,59.064
11,0.900,OVERALL,23-5,4325,3277,0,7602,56.893,56.893
11,0.950,Chicken,16-23,0,1,0,1,0.000,0.000
11,0.950,Chicken,23-5,8,8,0,16,50.000,50.000
11,0.950,Sea Lion,16-23,0,0,0,0,NaN,NaN
11,0.950,Sea Lion,23-5,0,11,0,11,0.000,0.000
11,0.950,Hu and Cw,16-23,1,4,0,5,20.000,20.000
11,0.950,Hu and Cw,23-5,7,8,0,15,46.667,46.667
11,0.950,Sheep,16-23,47,51,0,98,47.959,47.959
11,0.950,Sheep,23-5,53,39,0,92,57.609,57.609
11,0.950,Hu and Dg,16-23,8,13,0,21,38.095,38.095
11,0.950,Hu and Dg,23-5,18,21,0,39,46.154,46.154
11,0.950,Common Loon,16-23,0,0,0,0,NaN,NaN
11,0.950,Common Loon,23-5,0,0,0,0,NaN,NaN
11,0.950,Red-Winged Blackbird,16-23,0,1,0,1,0.000,0.000
11,0.950,Red-Winged Blackbird,23-5,0,0,0,0,NaN,NaN
11,0.950,Cw,16-23,8,13,0,21,38.095,38.095
11,0.950,Cw,23-5,14,25,0,39,35.897,35.897
11,0.950,Cliff Sparrow,16-23,2,9,0,11,18.182,18.182
11,0.950,Cliff Sparrow,23-5,0,0,0,0,NaN,NaN
11,0.950,Pig,16-23,9,7,0,16,56.250,56.250
11,0.950,Pig,23-5,3,3,0,6,50.000,50.000
11,0.950,Barn Owl,16-23,0,0,0,0,NaN,NaN
11,0.950,Barn Owl,23-5,0,0,0,0,NaN,NaN
11,0.950,Wild Pig,16-23,0,0,0,0,NaN,NaN
11,0.950,Wild Pig,23-5,1,3,0,4,25.000,25.000
11,0.950,Pennington Creek Water,16-23,0,0,0,0,NaN,NaN
11,0.950,Pennington Creek Water,23-5,0,0,0,0,NaN,NaN
11,0.950,Guinni,16-23,0,0,0,0,NaN,NaN
11,0.950,Guinni,23-5,0,0,0,0,NaN,NaN
11,0.950,Racoon,16-23,0,0,0,0,NaN,NaN
11,0.950,Racoon,23-5,0,0,0,0,NaN,NaN
11,0.950,Hu,16-23,15,15,0,30,50.000,50.000
11,0.950,Hu,23-5,24,14,0,38,63.158,63.158
11,0.950,Cw and Dg,16-23,6,16,0,22,27.273,27.273
11,0.950,Cw and Dg,23-5,14,18,0,32,43.750,43.750
11,0.950,Red Wind Blackbird,16-23,0,0,0,0,NaN,NaN
11,0.950,Red Wind Blackbird,23-5,0,0,0,0,NaN,NaN
11,0.950,Tree Swallow,16-23,0,0,0,0,NaN,NaN
11,0.950,Tree Swallow,23-5,0,0,0,0,NaN,NaN
11,0.950,Turkey Vulture,16-23,0,0,0,0,NaN,NaN
11,0.950,Turkey Vulture,23-5,0,0,0,0,NaN,NaN
11,0.950,Dg,16-23,6,9,0,15,40.000,40.000
11,0.950,Dg,23-5,32,32,0,64,50.000,50.000
11,0.950,Western Kingbird,16-23,0,0,0,0,NaN,NaN
11,0.950,Western Kingbird,23-5,0,0,0,0,NaN,NaN
11,0.950,White Crowned Sparrow,16-23,0,1,0,1,0.000,0.000
11,0.950,White Crowned Sparrow,23-5,0,8,0,8,0.000,0.000
11,0.950,Eared Grebe,16-23,0,0,0,0,NaN,NaN
11,0.950,Eared Grebe,23-5,0,10,0,10,0.000,0.000
11,0.950,cougar,16-23,0,0,0,0,NaN,NaN
11,0.950,cougar,23-5,0,0,0,0,NaN,NaN
11,0.950,Ocean Water,16-23,0,0,0,0,NaN,NaN
11,0.950,Ocean Water,23-5,0,0,0,0,NaN,NaN
11,0.950,Red Tailed Hawk,16-23,0,0,0,0,NaN,NaN
11,0.950,Red Tailed Hawk,23-5,0,7,0,7,0.000,0.000
11,0.950,Dog,16-23,55,69,0,124,44.355,44.355
11,0.950,Dog,23-5,88,137,0,225,39.111,39.111
11,0.950,Human,16-23,1719,796,0,2515,68.350,68.350
11,0.950,Human,23-5,2137,679,0,2816,75.888,75.888
11,0.950,Wild Turkey,16-23,1,4,0,5,20.000,20.000
11,0.950,Wild Turkey,23-5,0,11,0,11,0.000,0.000
11,0.950,Clark Grebe,16-23,0,0,0,0,NaN,NaN
11,0.950,Clark Grebe,23-5,0,0,0,0,NaN,NaN
11,0.950,Seagull,16-23,0,0,0,0,NaN,NaN
11,0.950,Seagull,23-5,5,8,0,13,38.462,38.462
11,0.950,Surf Scoter,16-23,0,0,0,0,NaN,NaN
11,0.950,Surf Scoter,23-5,0,0,0,0,NaN,NaN
11,0.950,Pigeon,16-23,48,143,0,191,25.131,25.131
11,0.950,Pigeon,23-5,75,157,0,232,32.328,32.328
11,0.950,Pacific Ocean Water,16-23,0,0,0,0,NaN,NaN
11,0.950,Pacific Ocean Water,23-5,0,0,0,0,NaN,NaN
11,0.950,Cat,16-23,19,22,0,41,46.341,46.341
11,0.950,Cat,23-5,20,30,0,50,40.000,40.000
11,0.950,Horse,16-23,5,19,0,24,20.833,20.833
11,0.950,Horse,23-5,25,115,0,140,17.857,17.857
11,0.950,orangutan,16-23,0,0,0,0,NaN,NaN
11,0.950,orangutan,23-5,0,0,0,0,NaN,NaN
11,0.950,Bat,16-23,36,32,0,68,52.941,52.941
11,0.950,Bat,23-5,37,35,0,72,51.389,51.389
11,0.950,Deer,16-23,14,35,0,49,28.571,28.571
11,0.950,Deer,23-5,19,121,0,140,13.571,13.571
11,0.950,Great Horned Owl,16-23,0,0,0,0,NaN,NaN
11,0.950,Great Horned Owl,23-5,0,0,0,0,NaN,NaN
11,0.950,Freshwater Lagoon,16-23,0,0,0,0,NaN,NaN
11,0.950,Freshwater Lagoon,23-5,0,0,0,0,NaN,NaN
11,0.950,Unknown Avian,16-23,0,0,0,0,NaN,NaN
11,0.950,Unknown Avian,23-5,0,0,0,0,NaN,NaN
11,0.950,Human UTI,16-23,78,78,0,156,50.000,50.000
11,0.950,Human UTI,23-5,102,106,0,208,49.038,49.038
11,0.950,unknown,16-23,0,0,0,0,NaN,NaN
11,0.950,unknown,23-5,0,2,0,2,0.000,0.000
11,0.950,SLO Creek Water,16-23,0,0,0,0,NaN,NaN
11,0.950,SLO Creek Water,23-5,0,0,0,0,NaN,NaN
11,0.950,Pig/Swine,16-23,5,6,0,11,45.455,45.455
11,0.950,Pig/Swine,23-5,8,12,0,20,40.000,40.000
11,0.950,Klebsiella,16-23,0,0,0,0,NaN,NaN
11,0.950,Klebsiella,23-5,0,0,0,0,NaN,NaN
11,0.950,Hu Cw and Dg,16-23,7,11,0,18,38.889,38.889
11,0.950,Hu Cw and Dg,23-5,8,14,0,22,36.364,36.364
11,0.950,Ground Squirrel,16-23,87,54,0,141,61.702,61.702
11,0.950,Ground Squirrel,23-5,84,71,0,155,54.194,54.194
11,0.950,Opossum,16-23,0,0,0,0,NaN,NaN
11,0.950,Opossum,23-5,0,0,0,0,NaN,NaN
11,0.950,Cow,16-23,1576,1166,0,2742,57.476,57.476
11,0.950,Cow,23-5,1535,1566,0,3101,49.500,49.500
11,0.950,Deer Mouse,16-23,0,0,0,0,NaN,NaN
11,0.950,Deer Mouse,23-5,0,0,0,0,NaN,NaN
11,0.950,OVERALL,16-23,3752,2575,0,6327,59.301,59.301
11,0.950,OVERALL,23-5,4317,3271,0,7588,56.892,56.892
11,0.960,Chicken,16-23,0,1,0,1,0.000,0.000
11,0.960,Chicken,23-5,8,8,0,16,50.000,50.000
11,0.960,Sea Lion,16-23,0,0,0,0,NaN,NaN
11,0.960,Sea Lion,23-5,0,11,0,11,0.000,0.000
11,0.960,Hu and Cw,16-23,1,4,0,5,20.000,20.000
11,0.960,Hu and Cw,23-5,7,8,0,15,46.667,46.667
11,0.960,Sheep,16-23,47,51,0,98,47.959,47.959
11,0.960,Sheep,23-5,53,40,0,93,56.989,56.989
11,0.960,Hu and Dg,16-23,8,13,0,21,38.095,38.095
11,0.960,Hu and Dg,23-5,18,21,0,39,46.154,46.154
11,0.960,Common Loon,16-23,0,0,0,0,NaN,NaN
11,0.960,Common Loon,23-5,0,0,0,0,NaN,NaN
11,0.960,Red-Winged Blackbird,16-23,0,1,0,1,0.000,0.000
11,0.960,Red-Winged Blackbird,23-5,0,0,0,0,NaN,NaN
11,0.960,Cw,16-23,8,13,0,21,38.095,38.095
11,0.960,Cw,23-5,14,25,0,39,35.897,35.897
11,0.960,Cliff Sparrow,16-23,2,9,0,11,18.182,18.182
11,0.960,Cliff Sparrow,23-5,0,0,0,0,NaN,NaN
11,0.960,Pig,16-23,9,7,0,16,56.250,56.250
11,0.960,Pig,23-5,3,3,0,6,50.000,50.000
11,0.960,Barn Owl,16-23,0,0,0,0,NaN,NaN
11,0.960,Barn Owl,23-5,0,0,0,0,NaN,NaN
11,0.960,Wild Pig,16-23,0,0,0,0,NaN,NaN
11,0.960,Wild Pig,23-5,1,3,0,4,25.000,25.000
11,0.960,Pennington Creek Water,16-23,0,0,0,0,NaN,NaN
11,0.960,Pennington Creek Water,23-5,0,0,0,0,NaN,NaN
11,0.960,Guinni,16-23,0,0,0,0,NaN,NaN
11,0.960,Guinni,23-5,0,0,0,0,NaN,NaN
11,0.960,Racoon,16-23,0,0,0,0,NaN,NaN
11,0.960,Racoon,23-5,0,0,0,0,NaN,NaN
11,0.960,Hu,16-23,15,15,0,30,50.000,50.000
11,0.960,Hu,23-5,24,14,0,38,63.158,63.158
11,0.960,Cw and Dg,16-23,6,16,0,22,27.273,27.273
11,0.960,Cw and Dg,23-5,14,18,0,32,43.750,43.750
11,0.960,Red Wind Blackbird,16-23,0,0,0,0,NaN,NaN
11,0.960,Red Wind Blackbird,23-5,0,0,0,0,NaN,NaN
11,0.960,Tree Swallow,16-23,0,0,0,0,NaN,NaN
11,0.960,Tree Swallow,23-5,0,0,0,0,NaN,NaN
11,0.960,Turkey Vulture,16-23,0,0,0,0,NaN,NaN
11,0.960,Turkey Vulture,23-5,0,0,0,0,NaN,NaN
11,0.960,Dg,16-23,6,9,0,15,40.000,40.000
11,0.960,Dg,23-5,32,32,0,64,50.000,50.000
11,0.960,Western Kingbird,16-23,0,0,0,0,NaN,NaN
11,0.960,Western Kingbird,23-5,0,0,0,0,NaN,NaN
11,0.960,White Crowned Sparrow,16-23,0,1,0,1,0.000,0.000
11,0.960,White Crowned Sparrow,23-5,0,8,0,8,0.000,0.000
11,0.960,Eared Grebe,16-23,0,0,0,0,NaN,NaN
11,0.960,Eared Grebe,23-5,0,10,0,10,0.000,0.000
11,0.960,cougar,16-23,0,0,0,0,NaN,NaN
11,0.960,cougar,23-5,0,0,0,0,NaN,NaN
11,0.960,Ocean Water,16-23,0,0,0,0,NaN,NaN
11,0.960,Ocean Water,23-5,0,0,0,0,NaN,NaN
11,0.960,Red Tailed Hawk,16-23,0,0,0,0,NaN,NaN
11,0.960,Red Tailed Hawk,23-5,0,7,0,7,0.000,0.000
11,0.960,Dog,16-23,55,69,0,124,44.355,44.355
11,0.960,Dog,23-5,88,132,0,220,40.000,40.000
11,0.960,Human,16-23,1720,794,0,2514,68.417,68.417
11,0.960,Human,23-5,2142,665,0,2807,76.309,76.309
11,0.960,Wild Turkey,16-23,1,4,0,5,20.000,20.000
11,0.960,Wild Turkey,23-5,0,15,0,15,0.000,0.000
11,0.960,Clark Grebe,16-23,0,0,0,0,NaN,NaN
11,0.960,Clark Grebe,23-5,0,0,0,0,NaN,NaN
11,0.960,Seagull,16-23,0,0,0,0,NaN,NaN
11,0.960,Seagull,23-5,5,9,0,14,35.714,35.714
11,0.960,Surf Scoter,16-23,0,0,0,0,NaN,NaN
11,0.960,Surf Scoter,23-5,0,2,0,2,0.000,0.000
11,0.960,Pigeon,16-23,47,143,0,190,24.737,24.737
11,0.960,Pigeon,23-5,76,171,0,247,30.769,30.769
11,0.960,Pacific Ocean Water,16-23,0,0,0,0,NaN,NaN
11,0.960,Pacific Ocean Water,23-5,0,0,0,0,NaN,NaN
11,0.960,Cat,16-23,19,22,0,41,46.341,46.341
11,0.960,Cat,23-5,20,31,0,51,39.216,39.216
11,0.960,Horse,16-23,5,19,0,24,20.833,20.833
11,0.960,Horse,23-5,25,115,0,140,17.857,17.857
11,0.960,orangutan,16-23,0,0,0,0,NaN,NaN
11,0.960,orangutan,23-5,0,0,0,0,NaN,NaN
11,0.960,Bat,16-23,36,32,0,68,52.941,52.941
11,0.960,Bat,23-5,37,35,0,72,51.389,51.389
11,0.960,Deer,16-23,14,35,0,49,28.571,28.571
11,0.960,Deer,23-5,19,121,0,140,13.571,13.571
11,0.960,Great Horned Owl,16-23,0,0,0,0,NaN,NaN
11,0.960,Great Horned Owl,23-5,0,0,0,0,NaN,NaN
11,0.960,Freshwater Lagoon,16-23,0,0,0,0,NaN,NaN
11,0.960,Freshwater Lagoon,23-5,0,0,0,0,NaN,NaN
11,0.960,Unknown Avian,16-23,0,0,0,0,NaN,NaN
11,0.960,Unknown Avian,23-5,0,0,0,0,NaN,NaN
11,0.960,Human UTI,16-23,78,79,0,157,49.682,49.682
11,0.960,Human UTI,23-5,102,105,0,207,49.275,49.275
11,0.960,unknown,16-23,0,0,0,0,NaN,NaN
11,0.960,unknown,23-5,0,2,0,2,0.000,0.000
11,0.960,SLO Creek Water,16-23,0,0,0,0,NaN,NaN
11,0.960,SLO Creek Water,23-5,0,0,0,0,NaN,NaN
11,0.960,Pig/Swine,16-23,5,6,0,11,45.455,45.455
11,0.960,Pig/Swine,23-5,8,12,0,20,40.000,40.000
11,0.960,Klebsiella,16-23,0,0,0,0,NaN,NaN
11,0.960,Klebsiella,23-5,0,0,0,0,NaN,NaN
11,0.960,Hu Cw and Dg,16-23,7,11,0,18,38.889,38.889
11,0.960,Hu Cw and Dg,23-5,8,14,0,22,36.364,36.364
11,0.960,Ground Squirrel,16-23,87,54,0,141,61.702,61.702
11,0.960,Ground Squirrel,23-5,84,73,0,157,53.503,53.503
11,0.960,Opossum,16-23,0,0,0,0,NaN,NaN
11,0.960,Opossum,23-5,0,0,0,0,NaN,NaN
11,0.960,Cow,16-23,1574,1158,0,2732,57.613,57.613
11,0.960,Cow,23-5,1535,1544,0,3079,49.854,49.854
11,0.960,Deer Mouse,16-23,0,0,0,0,NaN,NaN
11,0.960,Deer Mouse,23-5,0,0,0,0,NaN,NaN
11,0.960,OVERALL,16-23,3750,2566,0,6316,59.373,59.373
11,0.960,OVERALL,23-5,4323,3254,0,7577,57.054,57.054
11,0.970,Chicken,16-23,0,1,0,1,0.000,0.000
11,0.970,Chicken,23-5,8,8,0,16,50.000,50.000
11,0.970,Sea Lion,16-23,0,0,0,0,NaN,NaN
11,0.970,Sea Lion,23-5,0,11,0,11,0.000,0.000
11,0.970,Hu and Cw,16-23,1,4,0,5,20.000,20.000
11,0.970,Hu and Cw,23-5,7,8,0,15,46.667,46.667
11,0.970,Sheep,16-23,48,52,0,100,48.000,48.000
11,0.970,Sheep,23-5,53,39,0,92,57.609,57.609
11,0.970,Hu and Dg,16-23,8,13,0,21,38.095,38.095
11,0.970,Hu and Dg,23-5,18,21,0,39,46.154,46.154
11,0.970,Common Loon,16-23,0,0,0,0,NaN,NaN
11,0.970,Common Loon,23-5,0,0,0,0,NaN,NaN
11,0.970,Red-Winged Blackbird,16-23,0,1,0,1,0.000,0.000
11,0.970,Red-Winged Blackbird,23-5,0,0,0,0,NaN,NaN
11,0.970,Cw,16-23,8,14,0,22,36.364,36.364
11,0.970,Cw,23-5,14,25,0,39,35.897,35.897
11,0.970,Cliff Sparrow,16-23,2,9,0,11,18.182,18.182
11,0.970,Cliff Sparrow,23-5,0,0,0,0,NaN,NaN
11,0.970,Pig,16-23,9,7,0,16,56.250,56.250
11,0.970,Pig,23-5,3,3,0,6,50.000,50.000
11,0.970,Barn Owl,16-23,0,0,0,0,NaN,NaN
11,0.970,Barn Owl,23-5,0,0,0,0,NaN,NaN
11,0.970,Wild Pig,16-23,0,0,0,0,NaN,NaN
11,0.970,Wild Pig,23-5,0,3,0,3,0.000,0.000
11,0.970,Pennington Creek Water,16-23,0,0,0,0,NaN,NaN
11,0.970,Pennington Creek Water,23-5,0,0,0,0,NaN,NaN
11,0.970,Guinni,16-23,0,0,0,0,NaN,NaN
11,0.970,Guinni,23-5,0,0,0,0,NaN,NaN
11,0.970,Racoon,16-23,0,0,0,0,NaN,NaN
11,0.970,Racoon,23-5,0,0,0,0,NaN,NaN
11,0.970,Hu,16-23,15,15,0,30,50.000,50.000
11,0.970,Hu,23-5,24,14,0,38,63.158,63.158
11,0.970,Cw and Dg,16-23,6,16,0,22,27.273,27.273
11,0.970,Cw and Dg,23-5,14,18,0,32,43.750,43.750
11,0.970,Red Wind Blackbird,16-23,0,0,0,0,NaN,NaN
11,0.970,Red Wind Blackbird,23-5,0,0,0,0,NaN,NaN
11,0.970,Tree Swallow,16-23,0,0,0,0,NaN,NaN
11,0.970,Tree Swallow,23-5,0,0,0,0,NaN,NaN
11,0.970,Turkey Vulture,16-23,0,0,0,0,NaN,NaN
11,0.970,Turkey Vulture,23-5,0,0,0,0,NaN,NaN
11,0.970,Dg,16-23,6,9,0,15,40.000,40.000
11,0.970,Dg,23-5,32,31,0,63,50.794,50.794
11,0.970,Western Kingbird,16-23,0,0,0,0,NaN,NaN
11,0.970,Western Kingbird,23-5,0,0,0,0,NaN,NaN
11,0.970,White Crowned Sparrow,16-23,0,1,0,1,0.000,0.000
11,0.970,White Crowned Sparrow,23-5,0,8,0,8,0.000,0.000
11,0.970,Eared Grebe,16-23,0,0,0,0,NaN,NaN
11,0.970,Eared Grebe,23-5,0,10,0,10,0.000,0.000
11,0.970,cougar,16-23,0,0,0,0,NaN,NaN
11,0.970,cougar,23-5,0,0,0,0,NaN,NaN
11,0.970,Ocean Water,16-23,0,0,0,0,NaN,NaN
11,0.970,Ocean Water,23-5,0,0,0,0,NaN,NaN
11,0.970,Red Tailed Hawk,16-23,0,0,0,0,NaN,NaN
11,0.970,Red Tailed Hawk,23-5,0,7,0,7,0.000,0.000
11,0.970,Dog,16-23,55,69,0,124,44.355,44.355
11,0.970,Dog,23-5,88,130,0,218,40.367,40.367
11,0.970,Human,16-23,1719,792,0,2511,68.459,68.459
11,0.970,Human,23-5,2141,665,0,2806,76.301,76.301
11,0.970,Wild Turkey,16-23,1,6,0,7,14.286,14.286
11,0.970,Wild Turkey,23-5,2,15,0,17,11.765,11.765
11,0.970,Clark Grebe,16-23,0,0,0,0,NaN,NaN
11,0.970,Clark Grebe,23-5,0,0,0,0,NaN,NaN
11,0.970,Seagull,16-23,0,0,0,0,NaN,NaN
11,0.970,Seagull,23-5,5,10,0,15,33.333,33.333
11,0.970,Surf Scoter,16-23,0,0,0,0,NaN,NaN
11,0.970,Surf Scoter,23-5,0,2,0,2,0.000,0.000
11,0.970,Pigeon,16-23,45,142,0,187,24.064,24.064
11,0.970,Pigeon,23-5,76,188,0,264,28.788,28.788
11,0.970,Pacific Ocean Water,16-23,0,0,0,0,NaN,NaN
11,0.970,Pacific Ocean Water,23-5,0,0,0,0,NaN,NaN
11,0.970,Cat,16-23,19,22,0,41,46.341,46.341
11,0.970,Cat,23-5,20,28,0,48,41.667,41.667
11,0.970,Horse,16-23,5,19,0,24,20.833,20.833
11,0.970,Horse,23-5,25,116,0,141,17.730,17.730
11,0.970,orangutan,16-23,0,0,0,0,NaN,NaN
11,0.970,orangutan,23-5,0,0,0,0,NaN,NaN
11,0.970,Bat,16-23,36,32,0,68,52.941,52.941
11,0.970,Bat,23-5,37,35,0,72,51.389,51.389
11,0.970,Deer,16-23,14,35,0,49,28.571,28.571
11,0.970,Deer,23-5,19,121,0,140,13.571,13.571
11,0.970,Great Horned Owl,16-23,0,0,0,0,NaN,NaN
11,0.970,Great Horned Owl,23-5,0,0,0,0,NaN,NaN
11,0.970,Freshwater Lagoon,16-23,0,0,0,0,NaN,NaN
11,0.970,Freshwater Lagoon,23-5,0,0,0,0,NaN,NaN
11,0.970,Unknown Avian,16-23,0,0,0,0,NaN,NaN
11,0.970,Unknown Avian,23-5,0,0,0,0,NaN,NaN
11,0.970,Human UTI,16-23,78,80,0,158,49.367,49.367
11,0.970,Human UTI,23-5,101,105,0,206,49.029,49.029
11,0.970,unknown,16-23,0,0,0,0,NaN,NaN
11,0.970,unknown,23-5,0,2,0,2,0.000,0.000
11,0.970,SLO Creek Water,16-23,0,0,0,0,NaN,NaN
11,0.970,SLO Creek Water,23-5,0,0,0,0,NaN,NaN
11,0.970,Pig/Swine,16-23,5,6,0,11,45.455,45.455
11,0.970,Pig/Swine,23-5,8,12,0,20,40.000,40.000
11,0.970,Klebsiella,16-23,0,0,0,0,NaN,NaN
11,0.970,Klebsiella,23-5,0,0,0,0,NaN,NaN
11,0.970,Hu Cw and Dg,16-23,7,11,0,18,38.889,38.889
11,0.970,Hu Cw and Dg,23-5,8,14,0,22,36.364,36.364
11,0.970,Ground Squirrel,16-23,87,52,0,139,62.590,62.590
11,0.970,Ground Squirrel,23-5,84,71,0,155,54.194,54.194
11,0.970,Opossum,16-23,0,0,0,0,NaN,NaN
11,0.970,Opossum,23-5,0,0,0,0,NaN,NaN
11,0.970,Cow,16-23,1568,1156,0,2724,57.562,57.562
11,0.970,Cow,23-5,1532,1517,0,3049,50.246,50.246
11,0.970,Deer Mouse,16-23,0,0,0,0,NaN,NaN
11,0.970,Deer Mouse,23-5,0,0,0,0,NaN,NaN
11,0.970,OVERALL,16-23,3742,2564,0,6306,59.340,59.340
11,0.970,OVERALL,23-5,4319,3237,0,7556,57.160,57.160
11,0.980,Chicken,16-23,0,1,0,1,0.000,0.000
11,0.980,Chicken,23-5,9,8,0,17,52.941,52.941
11,0.980,Sea Lion,16-23,0,0,0,0,NaN,NaN
11,0.980,Sea Lion,23-5,0,10,0,10,0.000,0.000
11,0.980,Hu and Cw,16-23,1,4,0,5,20.000,20.000
11,0.980,Hu and Cw,23-5,7,18,0,25,28.000,28.000
11,0.980,Sheep,16-23,50,50,0,100,50.000,50.000
11,0.980,Sheep,23-5,52,38,0,90,57.778,57.778
11,0.980,Hu and Dg,16-23,8,12,0,20,40.000,40.000
11,0.980,Hu and Dg,23-5,18,18,0,36,50.000,50.000
11,0.980,Common Loon,16-23,0,0,0,0,NaN,NaN
11,0.980,Common Loon,23-5,0,0,0,0,NaN,NaN
11,0.980,Red-Winged Blackbird,16-23,0,1,0,1,0.000,0.000
11,0.980,Red-Winged Blackbird,23-5,0,0,0,0,NaN,NaN
11,0.980,Cw,16-23,8,13,0,21,38.095,38.095
11,0.980,Cw,23-5,14,26,0,40,35.000,35.000
11,0.980,Cliff Sparrow,16-23,2,9,0,11,18.182,18.182
11,0.980,Cliff Sparrow,23-5,0,0,0,0,NaN,NaN
11,0.980,Pig,16-23,9,7,0,16,56.250,56.250
11,0.980,Pig,23-5,3,3,0,6,50.000,50.000
11,0.980,Barn Owl,16-23,0,0,0,0,NaN,NaN
11,0.980,Barn Owl,23-5,0,0,0,0,NaN,NaN
11,0.980,Wild Pig,16-23,0,0,0,0,NaN,NaN
11,0.980,Wild Pig,23-5,0,3,0,3,0.000,0.000
11,0.980,Pennington Creek Water,16-23,0,0,0,0,NaN,NaN
11,0.980,Pennington Creek Water,23-5,0,0,0,0,NaN,NaN
11,0.980,Guinni,16-23,0,0,0,0,NaN,NaN
11,0.980,Guinni,23-5,0,0,0,0,NaN,NaN
11,0.980,Racoon,16-23,0,0,0,0,NaN,NaN
11,0.980,Racoon,23-5,0,0,0,0,NaN,NaN
11,0.980,Hu,16-23,15,15,0,30,50.000,50.000
11,0.980,Hu,23-5,24,15,0,39,61.538,61.538
11,0.980,Cw and Dg,16-23,6,16,0,22,27.273,27.273
11,0.980,Cw and Dg,23-5,14,19,0,33,42.424,42.424
11,0.980,Red Wind Blackbird,16-23,0,0,0,0,NaN,NaN
11,0.980,Red Wind Blackbird,23-5,0,0,0,0,NaN,NaN
11,0.980,Tree Swallow,16-23,0,0,0,0,NaN,NaN
11,0.980,Tree Swallow,23-5,0,0,0,0,NaN,NaN
11,0.980,Turkey Vulture,16-23,0,0,0,0,NaN,NaN
11,0.980,Turkey Vulture,23-5,0,0,0,0,NaN,NaN
11,0.980,Dg,16-23,6,9,0,15,40.000,40.000
11,0.980,Dg,23-5,32,24,0,56,57.143,57.143
11,0.980,Western Kingbird,16-23,0,0,0,0,NaN,NaN
11,0.980,Western Kingbird,23-5,0,0,0,0,NaN,NaN
11,0.980,White Crowned Sparrow,16-23,0,1,0,1,0.000,0.000
11,0.980,White Crowned Sparrow,23-5,0,9,0,9,0.000,0.000
11,0.980,Eared Grebe,16-23,0,0,0,0,NaN,NaN
11,0.980,Eared Grebe,23-5,0,10,0,10,0.000,0.000
11,0.980,cougar,16-23,0,0,0,0,NaN,NaN
11,0.980,cougar,23-5,0,0,0,0,NaN,NaN
11,0.980,Ocean Water,16-23,0,0,0,0,NaN,NaN
11,0.980,Ocean Water,23-5,0,0,0,0,NaN,NaN
11,0.980,Red Tailed Hawk,16-23,0,0,0,0,NaN,NaN
11,0.980,Red Tailed Hawk,23-5,0,6,0,6,0.000,0.000
11,0.980,Dog,16-23,54,73,0,127,42.520,42.520
11,0.980,Dog,23-5,88,127,0,215,40.930,40.930
11,0.980,Human,16-23,1719,780,0,2499,68.788,68.788
11,0.980,Human,23-5,2140,652,0,2792,76.648,76.648
11,0.980,Wild Turkey,16-23,1,6,0,7,14.286,14.286
11,0.980,Wild Turkey,23-5,4,23,0,27,14.815,14.815
11,0.980,Clark Grebe,16-23,0,0,0,0,NaN,NaN
11,0.980,Clark Grebe,23-5,0,0,0,0,NaN,NaN
11,0.980,Seagull,16-23,0,0,0,0,NaN,NaN
11,0.980,Seagull,23-5,7,8,0,15,46.667,46.667
11,0.980,Surf Scoter,16-23,0,0,0,0,NaN,NaN
11,0.980,Surf Scoter,23-5,2,0,0,2,100.000,100.000
11,0.980,Pigeon,16-23,45,139,0,184,24.457,24.457
11,0.980,Pigeon,23-5,75,195,0,270,27.778,27.778
11,0.980,Pacific Ocean Water,16-23,0,0,0,0,NaN,NaN
11,0.980,Pacific Ocean Water,23-5,0,0,0,0,NaN,NaN
11,0.980,Cat,16-23,19,22,0,41,46.341,46.341
11,0.980,Cat,23-5,21,24,0,45,46.667,46.667
11,0.980,Horse,16-23,5,19,0,24,20.833,20.833
11,0.980,Horse,23-5,25,113,0,138,18.116,18.116
11,0.980,orangutan,16-23,0,0,0,0,NaN,NaN
11,0.980,orangutan,23-5,0,0,0,0,NaN,NaN
11,0.980,Bat,16-23,36,32,0,68,52.941,52.941
11,0.980,Bat,23-5,37,34,0,71,52.113,52.113
11,0.980,Deer,16-23,14,35,0,49,28.571,28.571
11,0.980,Deer,23-5,19,121,0,140,13.571,13.571
11,0.980,Great Horned Owl,16-23,0,0,0,0,NaN,NaN
11,0.980,Great Horned Owl,23-5,0,0,0,0,NaN,NaN
11,0.980,Freshwater Lagoon,16-23,0,0,0,0,NaN,NaN
11,0.980,Freshwater Lagoon,23-5,0,0,0,0,NaN,NaN
11,0.980,Unknown Avian,16-23,0,0,0,0,NaN,NaN
11,0.980,Unknown Avian,23-5,0,0,0,0,NaN,NaN
11,0.980,Human UTI,16-23,78,83,0,161,48.447,48.447
11,0.980,Human UTI,23-5,101,104,0,205,49.268,49.268
11,0.980,unknown,16-23,0,0,0,0,NaN,NaN
11,0.980,unknown,23-5,0,3,0,3,0.000,0.000
11,0.980,SLO Creek Water,16-23,0,0,0,0,NaN,NaN
11,0.980,SLO Creek Water,23-5,0,0,0,0,NaN,NaN
11,0.980,Pig/Swine,16-23,5,6,0,11,45.455,45.455
11,0.980,Pig/Swine,23-5,8,12,0,20,40.000,40.000
11,0.980,Klebsiella,16-23,0,0,0,0,NaN,NaN
11,0.980,Klebsiella,23-5,0,0,0,0,NaN,NaN
11,0.980,Hu Cw and Dg,16-23,7,11,0,18,38.889,38.889
11,0.980,Hu Cw and Dg,23-5,8,13,0,21,38.095,38.095
11,0.980,Ground Squirrel,16-23,90,54,0,144,62.500,62.500
11,0.980,Ground Squirrel,23-5,85,69,0,154,55.195,55.195
11,0.980,Opossum,16-23,0,0,0,0,NaN,NaN
11,0.980,Opossum,23-5,0,0,0,0,NaN,NaN
11,0.980,Cow,16-23,1562,1138,0,2700,57.852,57.852
11,0.980,Cow,23-5,1526,1487,0,3013,50.647,50.647
11,0.980,Deer Mouse,16-23,0,0,0,0,NaN,NaN
11,0.980,Deer Mouse,23-5,0,0,0,0,NaN,NaN
11,0.980,OVERALL,16-23,3740,2536,0,6276,59.592,59.592
11,0.980,OVERALL,23-5,4319,3192,0,7511,57.502,57.502
11,0.990,Chicken,16-23,2,7,0,9,22.222,22.222
11,0.990,Chicken,23-5,10,8,0,18,55.556,55.556
11,0.990,Sea Lion,16-23,0,0,0,0,NaN,NaN
11,0.990,Sea Lion,23-5,2,7,0,9,22.222,22.222
11,0.990,Hu and Cw,16-23,2,4,0,6,33.333,33.333
11,0.990,Hu and Cw,23-5,9,25,0,34,26.471,26.471
11,0.990,Sheep,16-23,49,50,0,99,49.495,49.495
11,0.990,Sheep,23-5,54,37,0,91,59.341,59.341
11,0.990,Hu and Dg,16-23,8,13,0,21,38.095,38.095
11,0.990,Hu and Dg,23-5,18,17,0,35,51.429,51.429
11,0.990,Common Loon,16-23,0,0,0,0,NaN,NaN
11,0.990,Common Loon,23-5,0,2,0,2,0.000,0.000
11,0.990,Red-Winged Blackbird,16-23,0,3,0,3,0.000,0.000
11,0.990,Red-Winged Blackbird,23-5,0,0,0,0,NaN,NaN
11,0.990,Cw,16-23,9,13,0,22,40.909,40.909
11,0.990,Cw,23-5,20,27,0,47,42.553,42.553
11,0.990,Cliff Sparrow,16-23,2,10,0,12,16.667,16.667
11,0.990,Cliff Sparrow,23-5,0,4,0,4,0.000,0.000
11,0.990,Pig,16-23,9,8,0,17,52.941,52.941
11,0.990,Pig,23-5,7,9,0,16,43.750,43.750
11,0.990,Barn Owl,16-23,0,0,0,0,NaN,NaN
11,0.990,Barn Owl,23-5,0,0,0,0,NaN,NaN
11,0.990,Wild Pig,16-23,0,2,0,2,0.000,0.000
11,0.990,Wild Pig,23-5,0,3,0,3,0.000,0.000
11,0.990,Pennington Creek Water,16-23,0,0,0,0,NaN,NaN
11,0.990,Pennington Creek Water,23-5,0,0,0,0,NaN,NaN
11,0.990,Guinni,16-23,0,0,0,0,NaN,NaN
11,0.990,Guinni,23-5,0,0,0,0,NaN,NaN
11,0.990,Racoon,16-23,0,0,0,0,NaN,NaN
11,0.990,Racoon,23-5,0,1,0,1,0.000,0.000
11,0.990,Hu,16-23,15,14,0,29,51.724,51.724
11,0.990,Hu,23-5,24,12,0,36,66.667,66.667
11,0.990,Cw and Dg,16-23,6,16,0,22,27.273,27.273
11,0.990,Cw and Dg,23-5,14,11,0,25,56.000,56.000
11,0.990,Red Wind Blackbird,16-23,0,0,0,0,NaN,NaN
11,0.990,Red Wind Blackbird,23-5,0,0,0,0,NaN,NaN
11,0.990,Tree Swallow,16-23,0,0,0,0,NaN,NaN
11,0.990,Tree Swallow,23-5,0,0,0,0,NaN,NaN
11,0.990,Turkey Vulture,16-23,0,0,0,0,NaN,NaN
11,0.990,Turkey Vulture,23-5,0,0,0,0,NaN,NaN
11,0.990,Dg,16-23,6,10,0,16,37.500,37.500
11,0.990,Dg,23-5,32,19,0,51,62.745,62.745
11,0.990,Western Kingbird,16-23,0,0,0,0,NaN,NaN
11,0.990,Western Kingbird,23-5,0,0,0,0,NaN,NaN
11,0.990,White Crowned Sparrow,16-23,0,1,0,1,0.000,0.000
11,0.990,White Crowned Sparrow,23-5,0,10,0,10,0.000,0.000
11,0.990,Eared Grebe,16-23,0,0,0,0,NaN,NaN
11,0.990,Eared Grebe,23-5,0,11,0,11,0.000,0.000
11,0.990,cougar,16-23,0,1,0,1,0.000,0.000
11,0.990,cougar,23-5,0,0,0,0,NaN,NaN
11,0.990,Ocean Water,16-23,0,0,0,0,NaN,NaN
11,0.990,Ocean Water,23-5,0,0,0,0,NaN,NaN
11,0.990,Red Tailed Hawk,16-23,0,0,0,0,NaN,NaN
11,0.990,Red Tailed Hawk,23-5,0,6,0,6,0.000,0.000
11,0.990,Dog,16-23,57,73,0,130,43.846,43.846
11,0.990,Dog,23-5,91,118,0,209,43.541,43.541
11,0.990,Human,16-23,1699,741,0,2440,69.631,69.631
11,0.990,Human,23-5,2119,597,0,2716,78.019,78.019
11,0.990,Wild Turkey,16-23,3,11,0,14,21.429,21.429
11,0.990,Wild Turkey,23-5,4,23,0,27,14.815,14.815
11,0.990,Clark Grebe,16-23,0,0,0,0,NaN,NaN
11,0.990,Clark Grebe,23-5,2,3,0,5,40.000,40.000
11,0.990,Seagull,16-23,0,0,0,0,NaN,NaN
11,0.990,Seagull,23-5,12,7,0,19,63.158,63.158
11,0.990,Surf Scoter,16-23,0,0,0,0,NaN,NaN
11,0.990,Surf Scoter,23-5,2,0,0,2,100.000,100.000
11,0.990,Pigeon,16-23,53,134,0,187,28.342,28.342
11,0.990,Pigeon,23-5,81,211,0,292,27.740,27.740
11,0.990,Pacific Ocean Water,16-23,0,0,0,0,NaN,NaN
11,0.990,Pacific Ocean Water,23-5,0,0,0,0,NaN,NaN
11,0.990,Cat,16-23,19,24,0,43,44.186,44.186
11,0.990,Cat,23-5,21,27,0,48,43.750,43.750
11,0.990,Horse,16-23,8,19,0,27,29.630,29.630
11,0.990,Horse,23-5,25,121,0,146,17.123,17.123
11,0.990,orangutan,16-23,0,0,0,0,NaN,NaN
11,0.990,orangutan,23-5,0,0,0,0,NaN,NaN
11,0.990,Bat,16-23,36,29,0,65,55.385,55.385
11,0.990,Bat,23-5,37,33,0,70,52.857,52.857
11,0.990,Deer,16-23,14,36,0,50,28.000,28.000
11,0.990,Deer,23-5,19,110,0,129,14.729,14.729
11,0.990,Great Horned Owl,16-23,0,0,0,0,NaN,NaN
11,0.990,Great Horned Owl,23-5,0,0,0,0,NaN,NaN
11,0.990,Freshwater Lagoon,16-23,0,0,0,0,NaN,NaN
11,0.990,Freshwater Lagoon,23-5,0,0,0,0,NaN,NaN
11,0.990,Unknown Avian,16-23,0,0,0,0,NaN,NaN
11,0.990,Unknown Avian,23-5,0,0,0,0,NaN,NaN
11,0.990,Human UTI,16-23,82,77,0,159,51.572,51.572
11,0.990,Human UTI,23-5,101,80,0,181,55.801,55.801
11,0.990,unknown,16-23,0,0,0,0,NaN,NaN
11,0.990,unknown,23-5,0,5,0,5,0.000,0.000
11,0.990,SLO Creek Water,16-23,0,0,0,0,NaN,NaN
11,0.990,SLO Creek Water,23-5,0,0,0,0,NaN,NaN
11,0.990,Pig/Swine,16-23,5,7,0,12,41.667,41.667
11,0.990,Pig/Swine,23-5,8,11,0,19,42.105,42.105
11,0.990,Klebsiella,16-23,0,0,0,0,NaN,NaN
11,0.990,Klebsiella,23-5,0,0,0,0,NaN,NaN
11,0.990,Hu Cw and Dg,16-23,7,11,0,18,38.889,38.889
11,0.990,Hu Cw and Dg,23-5,8,14,0,22,36.364,36.364
11,0.990,Ground Squirrel,16-23,93,53,0,146,63.699,63.699
11,0.990,Ground Squirrel,23-5,87,74,0,161,54.037,54.037
11,0.990,Opossum,16-23,1,0,0,1,100.000,100.000
11,0.990,Opossum,23-5,2,0,0,2,100.000,100.000
11,0.990,Cow,16-23,1525,1037,0,2562,59.524,59.524
11,0.990,Cow,23-5,1487,1366,0,2853,52.121,52.121
11,0.990,Deer Mouse,16-23,0,0,0,0,NaN,NaN
11,0.990,Deer Mouse,23-5,0,0,0,0,NaN,NaN
11,0.990,OVERALL,16-23,3710,2404,0,6114,60.680,60.680
11,0.990,OVERALL,23-5,4296,3009,0,7305,58.809,58.809
11,1.000,Chicken,16-23,0,0,0,0,NaN,NaN
11,1.000,Chicken,23-5,0,0,0,0,NaN,NaN
11,1.000,Sea Lion,16-23,0,0,0,0,NaN,NaN
11,1.000,Sea Lion,23-5,0,0,0,0,NaN,NaN
11,1.000,Hu and Cw,16-23,0,0,0,0,NaN,NaN
11,1.000,Hu and Cw,23-5,0,0,0,0,NaN,NaN
11,1.000,Sheep,16-23,0,0,0,0,NaN,NaN
11,1.000,Sheep,23-5,0,0,0,0,NaN,NaN
11,1.000,Hu and Dg,16-23,0,0,0,0,NaN,NaN
11,1.000,Hu and Dg,23-5,0,0,0,0,NaN,NaN
11,1.000,Common Loon,16-23,0,0,0,0,NaN,NaN
11,1.000,Common Loon,23-5,0,0,0,0,NaN,NaN
11,1.000,Red-Winged Blackbird,16-23,0,0,0,0,NaN,NaN
11,1.000,Red-Winged Blackbird,23-5,0,0,0,0,NaN,NaN
11,1.000,Cw,16-23,0,0,0,0,NaN,NaN
11,1.000,Cw,23-5,0,0,0,0,NaN,NaN
11,1.000,Cliff Sparrow,16-23,0,0,0,0,NaN,NaN
11,1.000,Cliff Sparrow,23-5,0,0,0,0,NaN,NaN
11,1.000,Pig,16-23,0,0,0,0,NaN,NaN
11,1.000,Pig,23-5,0,0,0,0,NaN,NaN
11,1.000,Barn Owl,16-23,0,0,0,0,NaN,NaN
11,1.000,Barn Owl,23-5,0,0,0,0,NaN,NaN
11,1.000,Wild Pig,16-23,0,0,0,0,NaN,NaN
11,1.000,Wild Pig,23-5,0,0,0,0,NaN,NaN
11,1.000,Pennington Creek Water,16-23,0,0,0,0,NaN,NaN
11,1.000,Pennington Creek Water,23-5,0,0,0,0,NaN,NaN
11,1.000,Guinni,16-23,0,0,0,0,NaN,NaN
11,1.000,Guinni,23-5,0,0,0,0,NaN,NaN
11,1.000,Racoon,16-23,0,0,0,0,NaN,NaN
11,1.000,Racoon,23-5,0,0,0,0,NaN,NaN
11,1.000,Hu,16-23,0,0,0,0,NaN,NaN
11,1.000,Hu,23-5,0,0,0,0,NaN,NaN
11,1.000,Cw and Dg,16-23,0,0,0,0,NaN,NaN
11,1.000,Cw and Dg,23-5,0,0,0,0,NaN,NaN
11,1.000,Red Wind Blackbird,16-23,0,0,0,0,NaN,NaN
11,1.000,Red Wind Blackbird,23-5,0,0,0,0,NaN,NaN
11,1.000,Tree Swallow,16-23,0,0,0,0,NaN,NaN
11,1.000,Tree Swallow,23-5,0,0,0,0,NaN,NaN
11,1.000,Turkey Vulture,16-23,0,0,0,0,NaN,NaN
11,1.000,Turkey Vulture,23-5,0,0,0,0,NaN,NaN
11,1.000,Dg,16-23,0,0,0,0,NaN,NaN
11,1.000,Dg,23-5,0,0,0,0,NaN,NaN
11,1.000,Western Kingbird,16-23,0,0,0,0,NaN,NaN
11,1.000,Western Kingbird,23-5,0,0,0,0,NaN,NaN
11,1.000,White Crowned Sparrow,16-23,0,0,0,0,NaN,NaN
11,1.000,White Crowned Sparrow,23-5,0,0,0,0,NaN,NaN
11,1.000,Eared Grebe,16-23,0,0,0,0,NaN,NaN
11,1.000,Eared Grebe,23-5,0,0,0,0,NaN,NaN
11,1.000,cougar,16-23,0,0,0,0,NaN,NaN
11,1.000,cougar,23-5,0,0,0,0,NaN,NaN
11,1.000,Ocean Water,16-23,0,0,0,0,NaN,NaN
11,1.000,Ocean Water,23-5,0,0,0,0,NaN,NaN
11,1.000,Red Tailed Hawk,16-23,0,0,0,0,NaN,NaN
11,1.000,Red Tailed Hawk,23-5,0,0,0,0,NaN,NaN
11,1.000,Dog,16-23,0,0,0,0,NaN,NaN
11,1.000,Dog,23-5,0,0,0,0,NaN,NaN
11,1.000,Human,16-23,0,0,0,0,NaN,NaN
11,1.000,Human,23-5,0,0,0,0,NaN,NaN
11,1.000,Wild Turkey,16-23,0,0,0,0,NaN,NaN
11,1.000,Wild Turkey,23-5,0,0,0,0,NaN,NaN
11,1.000,Clark Grebe,16-23,0,0,0,0,NaN,NaN
11,1.000,Clark Grebe,23-5,0,0,0,0,NaN,NaN
11,1.000,Seagull,16-23,0,0,0,0,NaN,NaN
11,1.000,Seagull,23-5,0,0,0,0,NaN,NaN
11,1.000,Surf Scoter,16-23,0,0,0,0,NaN,NaN
11,1.000,Surf Scoter,23-5,0,0,0,0,NaN,NaN
11,1.000,Pigeon,16-23,0,0,0,0,NaN,NaN
11,1.000,Pigeon,23-5,0,0,0,0,NaN,NaN
11,1.000,Pacific Ocean Water,16-23,0,0,0,0,NaN,NaN
11,1.000,Pacific Ocean Water,23-5,0,0,0,0,NaN,NaN
11,1.000,Cat,16-23,0,0,0,0,NaN,NaN
11,1.000,Cat,23-5,0,0,0,0,NaN,NaN
11,1.000,Horse,16-23,0,0,0,0,NaN,NaN
11,1.000,Horse,23-5,0,0,0,0,NaN,NaN
11,1.000,orangutan,16-23,0,0,0,0,NaN,NaN
11,1.000,orangutan,23-5,0,0,0,0,NaN,NaN
11,1.000,Bat,16-23,0,0,0,0,NaN,NaN
11,1.000,Bat,23-5,0,0,0,0,NaN,NaN
11,1.000,Deer,16-23,0,0,0,0,NaN,NaN
11,1.000,Deer,23-5,0,0,0,0,NaN,NaN
11,1.000,Great Horned Owl,16-23,0,0,0,0,NaN,NaN
11,1.000,Great Horned Owl,23-5,0,0,0,0,NaN,NaN
11,1.000,Freshwater Lagoon,16-23,0,0,0,0,NaN,NaN
11,1.000,Freshwater Lagoon,23-5,0,0,0,0,NaN,NaN
11,1.000,Unknown Avian,16-23,0,0,0,0,NaN,NaN
11,1.000,Unknown Avian,23-5,0,0,0,0,NaN,NaN
11,1.000,Human UTI,16-23,0,0,0,0,NaN,NaN
11,1.000,Human UTI,23-5,0,0,0,0,NaN,NaN
11,1.000,unknown,16-23,0,0,0,0,NaN,NaN
11,1.000,unknown,23-5,0,0,0,0,NaN,NaN
11,1.000,SLO Creek Water,16-23,0,0,0,0,NaN,NaN
11,1.000,SLO Creek Water,23-5,0,0,0,0,NaN,NaN
11,1.000,Pig/Swine,16-23,0,0,0,0,NaN,NaN
11,1.000,Pig/Swine,23-5,0,0,0,0,NaN,NaN
11,1.000,Klebsiella,16-23,0,0,0,0,NaN,NaN
11,1.000,Klebsiella,23-5,0,0,0,0,NaN,NaN
11,1.000,Hu Cw and Dg,16-23,0,0,0,0,NaN,NaN
11,1.000,Hu Cw and Dg,23-5,0,0,0,0,NaN,NaN
11,1.000,Ground Squirrel,16-23,0,0,0,0,NaN,NaN
11,1.000,Ground Squirrel,23-5,0,0,0,0,NaN,NaN
11,1.000,Opossum,16-23,0,0,0,0,NaN,NaN
11,1.000,Opossum,23-5,0,0,0,0,NaN,NaN
11,1.000,Cow,16-23,0,0,0,0,NaN,NaN
11,1.000,Cow,23-5,0,0,0,0,NaN,NaN
11,1.000,Deer Mouse,16-23,0,0,0,0,NaN,NaN
11,1.000,Deer Mouse,23-5,0,0,0,0,NaN,NaN
11,1.000,OVERALL,16-23,0,0,0,0,NaN,NaN
11,1.000,OVERALL,23-5,0,0,0,0,NaN,NaN
12,0.000,Chicken,16-23,0,1,0,1,0.000,0.000
12,0.000,Chicken,23-5,5,6,0,11,45.455,45.455
12,0.000,Sea Lion,16-23,0,0,0,0,NaN,NaN
12,0.000,Sea Lion,23-5,0,11,0,11,0.000,0.000
12,0.000,Hu and Cw,16-23,2,5,0,7,28.571,28.571
12,0.000,Hu and Cw,23-5,7,8,0,15,46.667,46.667
12,0.000,Sheep,16-23,44,51,0,95,46.316,46.316
12,0.000,Sheep,23-5,56,40,0,96,58.333,58.333
12,0.000,Hu and Dg,16-23,6,13,0,19,31.579,31.579
12,0.000,Hu and Dg,23-5,19,23,0,42,45.238,45.238
12,0.000,Common Loon,16-23,0,0,0,0,NaN,NaN
12,0.000,Common Loon,23-5,0,0,0,0,NaN,NaN
12,0.000,Red-Winged Blackbird,16-23,0,2,0,2,0.000,0.000
12,0.000,Red-Winged Blackbird,23-5,0,0,0,0,NaN,NaN
12,0.000,Cw,16-23,7,11,0,18,38.889,38.889
12,0.000,Cw,23-5,13,24,0,37,35.135,35.135
12,0.000,Cliff Sparrow,16-23,1,10,0,11,9.091,9.091
12,0.000,Cliff Sparrow,23-5,0,0,0,0,NaN,NaN
12,0.000,Pig,16-23,6,7,0,13,46.154,46.154
12,0.000,Pig,23-5,3,1,0,4,75.000,75.000
12,0.000,Barn Owl,16-23,0,0,0,0,NaN,NaN
12,0.000,Barn Owl,23-5,0,0,0,0,NaN,NaN
12,0.000,Wild Pig,16-23,0,0,0,0,NaN,NaN
12,0.000,Wild Pig,23-5,1,0,0,1,100.000,100.000
12,0.000,Pennington Creek Water,16-23,0,0,0,0,NaN,NaN
12,0.000,Pennington Creek Water,23-5,0,0,0,0,NaN,NaN
12,0.000,Guinni,16-23,0,0,0,0,NaN,NaN
12,0.000,Guinni,23-5,0,0,0,0,NaN,NaN
12,0.000,Racoon,16-23,0,0,0,0,NaN,NaN
12,0.000,Racoon,23-5,0,0,0,0,NaN,NaN
12,0.000,Hu,16-23,12,14,0,26,46.154,46.154
12,0.000,Hu,23-5,23,16,0,39,58.974,58.974
12,0.000,Cw and Dg,16-23,8,15,0,23,34.783,34.783
12,0.000,Cw and Dg,23-5,13,18,0,31,41.935,41.935
12,0.000,Red Wind Blackbird,16-23,0,0,0,0,NaN,NaN
12,0.000,Red Wind Blackbird,23-5,0,0,0,0,NaN,NaN
12,0.000,Tree Swallow,16-23,0,0,0,0,NaN,NaN
12,0.000,Tree Swallow,23-5,0,0,0,0,NaN,NaN
12,0.000,Turkey Vulture,16-23,0,0,0,0,NaN,NaN
12,0.000,Turkey Vulture,23-5,0,0,0,0,NaN,NaN
12,0.000,Dg,16-23,7,11,0,18,38.889,38.889
12,0.000,Dg,23-5,32,32,0,64,50.000,50.000
12,0.000,Western Kingbird,16-23,0,0,0,0,NaN,NaN
12,0.000,Western Kingbird,23-5,0,0,0,0,NaN,NaN
12,0.000,White Crowned Sparrow,16-23,0,2,0,2,0.000,0.000
12,0.000,White Crowned Sparrow,23-5,0,7,0,7,0.000,0.000
12,0.000,Eared Grebe,16-23,0,0,0,0,NaN,NaN
12,0.000,Eared Grebe,23-5,0,7,0,7,0.000,0.000
12,0.000,cougar,16-23,0,0,0,0,NaN,NaN
12,0.000,cougar,23-5,0,0,0,0,NaN,NaN
12,0.000,Ocean Water,16-23,0,0,0,0,NaN,NaN
12,0.000,Ocean Water,23-5,0,0,0,0,NaN,NaN
12,0.000,Red Tailed Hawk,16-23,0,0,0,0,NaN,NaN
12,0.000,Red Tailed Hawk,23-5,0,6,0,6,0.000,0.000
12,0.000,Dog,16-23,54,68,0,122,44.262,44.262
12,0.000,Dog,23-5,85,143,0,228,37.281,37.281
12,0.000,Human,16-23,1727,821,0,2548,67.779,67.779
12,0.000,Human,23-5,2139,722,0,2861,74.764,74.764
12,0.000,Wild Turkey,16-23,1,3,0,4,25.000,25.000
12,0.000,Wild Turkey,23-5,0,11,0,11,0.000,0.000
12,0.000,Clark Grebe,16-23,0,0,0,0,NaN,NaN
12,0.000,Clark Grebe,23-5,0,0,0,0,NaN,NaN
12,0.000,Seagull,16-23,0,0,0,0,NaN,NaN
12,0.000,Seagull,23-5,4,8,0,12,33.333,33.333
12,0.000,Surf Scoter,16-23,0,0,0,0,NaN,NaN
12,0.000,Surf Scoter,23-5,0,0,0,0,NaN,NaN
12,0.000,Pigeon,16-23,38,136,0,174,21.839,21.839
12,0.000,Pigeon,23-5,75,140,0,215,34.884,34.884
12,0.000,Pacific Ocean Water,16-23,0,0,0,0,NaN,NaN
12,0.000,Pacific Ocean Water,23-5,0,0,0,0,NaN,NaN
12,0.000,Cat,16-23,17,19,0,36,47.222,47.222
12,0.000,Cat,23-5,20,21,0,41,48.780,48.780
12,0.000,Horse,16-23,6,16,0,22,27.273,27.273
12,0.000,Horse,23-5,24,103,0,127,18.898,18.898
12,0.000,orangutan,16-23,0,0,0,0,NaN,NaN
12,0.000,orangutan,23-5,0,0,0,0,NaN,NaN
12,0.000,Bat,16-23,36,35,0,71,50.704,50.704
12,0.000,Bat,23-5,37,37,0,74,50.000,50.000
12,0.000,Deer,16-23,13,37,0,50,26.000,26.000
12,0.000,Deer,23-5,17,121,0,138,12.319,12.319
12,0.000,Great Horned Owl,16-23,0,0,0,0,NaN,NaN
12,0.000,Great Horned Owl,23-5,0,1,0,1,0.000,0.000
12,0.000,Freshwater Lagoon,16-23,0,0,0,0,NaN,NaN
12,0.000,Freshwater Lagoon,23-5,0,0,0,0,NaN,NaN
12,0.000,Unknown Avian,16-23,0,0,0,0,NaN,NaN
12,0.000,Unknown Avian,23-5,0,0,0,0,NaN,NaN
12,0.000,Human UTI,16-23,75,77,0,152,49.342,49.342
12,0.000,Human UTI,23-5,101,105,0,206,49.029,49.029
12,0.000,unknown,16-23,0,0,0,0,NaN,NaN
12,0.000,unknown,23-5,0,3,0,3,0.000,0.000
12,0.000,SLO Creek Water,16-23,0,0,0,0,NaN,NaN
12,0.000,SLO Creek Water,23-5,0,0,0,0,NaN,NaN
12,0.000,Pig/Swine,16-23,4,5,0,9,44.444,44.444
12,0.000,Pig/Swine,23-5,7,10,0,17,41.176,41.176
12,0.000,Klebsiella,16-23,0,0,0,0,NaN,NaN
12,0.000,Klebsiella,23-5,0,0,0,0,NaN,NaN
12,0.000,Hu Cw and Dg,16-23,6,8,0,14,42.857,42.857
12,0.000,Hu Cw and Dg,23-5,8,13,0,21,38.095,38.095
12,0.000,Ground Squirrel,16-23,82,49,0,131,62.595,62.595
12,0.000,Ground Squirrel,23-5,83,75,0,158,52.532,52.532
12,0.000,Opossum,16-23,0,0,0,0,NaN,NaN
12,0.000,Opossum,23-5,0,0,0,0,NaN,NaN
12,0.000,Cow,16-23,1556,1224,0,2780,55.971,55.971
12,0.000,Cow,23-5,1521,1605,0,3126,48.656,48.656
12,0.000,Deer Mouse,16-23,0,0,0,0,NaN,NaN
12,0.000,Deer Mouse,23-5,0,0,0,0,NaN,NaN
12,0.000,OVERALL,16-23,3708,2640,0,6348,58.412,58.412
12,0.000,OVERALL,23-5,4293,3317,0,7610,56.413,56.413
12,0.500,Chicken,16-23,0,1,0,1,0.000,0.000
12,0.500,Chicken,23-5,5,6,0,11,45.455,45.455
12,0.500,Sea Lion,16-23,0,0,0,0,NaN,NaN
12,0.500,Sea Lion,23-5,0,11,0,11,0.000,0.000
12,0.500,Hu and Cw,16-23,2,5,0,7,28.571,28.571
12,0.500,Hu and Cw,23-5,7,8,0,15,46.667,46.667
12,0.500,Sheep,16-23,44,51,0,95,46.316,46.316
12,0.500,Sheep,23-5,56,40,0,96,58.333,58.333
12,0.500,Hu and Dg,16-23,6,13,0,19,31.579,31.579
12,0.500,Hu and Dg,23-5,19,23,0,42,45.238,45.238
12,0.500,Common Loon,16-23,0,0,0,0,NaN,NaN
12,0.500,Common Loon,23-5,0,0,0,0,NaN,NaN
12,0.500,Red-Winged Blackbird,16-23,0,2,0,2,0.000,0.000
12,0.500,Red-Winged Blackbird,23-5,0,0,0,0,NaN,NaN
12,0.500,Cw,16-23,7,11,0,18,38.889,38.889
12,0.500,Cw,23-5,13,24,0,37,35.135,35.135
12,0.500,Cliff Sparrow,16-23,1,10,0,11,9.091,9.091
12,0.500,Cliff Sparrow,23-5,0,0,0,0,NaN,NaN
12,0.500,Pig,16-23,6,7,0,13,46.154,46.154
12,0.500,Pig,23-5,3,1,0,4,75.000,75.000
12,0.500,Barn Owl,16-23,0,0,0,0,NaN,NaN
12,0.500,Barn Owl,23-5,0,0,0,0,NaN,NaN
12,0.500,Wild Pig,16-23,0,0,0,0,NaN,NaN
12,0.500,Wild Pig,23-5,1,0,0,1,100.000,100.000
12,0.500,Pennington Creek Water,16-23,0,0,0,0,NaN,NaN
12,0.500,Pennington Creek Water,23-5,0,0,0,0,NaN,NaN
12,0.500,Guinni,16-23,0,0,0,0,NaN,NaN
12,0.500,Guinni,23-5,0,0,0,0,NaN,NaN
12,0.500,Racoon,16-23,0,0,0,0,NaN,NaN
12,0.500,Racoon,23-5,0,0,0,0,NaN,NaN
12,0.500,Hu,16-23,12,14,0,26,46.154,46.154
12,0.500,Hu,23-5,23,16,0,39,58.974,58.974
12,0.500,Cw and Dg,16-23,8,15,0,23,34.783,34.783
12,0.500,Cw and Dg,23-5,13,18,0,31,41.935,41.935
12,0.500,Red Wind Blackbird,16-23,0,0,0,0,NaN,NaN
12,0.500,Red Wind Blackbird,23-5,0,0,0,0,NaN,NaN
12,0.500,Tree Swallow,16-23,0,0,0,0,NaN,NaN
12,0.500,Tree Swallow,23-5,0,0,0,0,NaN,NaN
12,0.500,Turkey Vulture,16-23,0,0,0,0,NaN,NaN
12,0.500,Turkey Vulture,23-5,0,0,0,0,NaN,NaN
12,0.500,Dg,16-23,7,11,0,18,38.889,38.889
12,0.500,Dg,23-5,32,32,0,64,50.000,50.000
12,0.500,Western Kingbird,16-23,0,0,0,0,NaN,NaN
12,0.500,Western Kingbird,23-5,0,0,0,0,NaN,NaN
12,0.500,White Crowned Sparrow,16-23,0,2,0,2,0.000,0.000
12,0.500,White Crowned Sparrow,23-5,0,7,0,7,0.000,0.000
12,0.500,Eared Grebe,16-23,0,0,0,0,NaN,NaN
12,0.500,Eared Grebe,23-5,0,7,0,7,0.000,0.000
12,0.500,cougar,16-23,0,0,0,0,NaN,NaN
12,0.500,cougar,23-5,0,0,0,0,NaN,NaN
12,0.500,Ocean Water,16-23,0,0,0,0,NaN,NaN
12,0.500,Ocean Water,23-5,0,0,0,0,NaN,NaN
12,0.500,Red Tailed Hawk,16-23,0,0,0,0,NaN,NaN
12,0.500,Red Tailed Hawk,23-5,0,6,0,6,0.000,0.000
12,0.500,Dog,16-23,54,68,0,122,44.262,44.262
12,0.500,Dog,23-5,85,143,0,228,37.281,37.281
12,0.500,Human,16-23,1727,821,0,2548,67.779,67.779
12,0.500,Human,23-5,2139,722,0,2861,74.764,74.764
12,0.500,Wild Turkey,16-23,1,3,0,4,25.000,25.000
12,0.500,Wild Turkey,23-5,0,11,0,11,0.000,0.000
12,0.500,Clark Grebe,16-23,0,0,0,0,NaN,NaN
12,0.500,Clark Grebe,23-5,0,0,0,0,NaN,NaN
12,0.500,Seagull,16-23,0,0,0,0,NaN,NaN
12,0.500,Seagull,23-5,4,8,0,12,33.333,33.333
12,0.500,Surf Scoter,16-23,0,0,0,0,NaN,NaN
12,0.500,Surf Scoter,23-5,0,0,0,0,NaN,NaN
12,0.500,Pigeon,16-23,38,136,0,174,21.839,21.839
12,0.500,Pigeon,23-5,75,140,0,215,34.884,34.884
12,0.500,Pacific Ocean Water,16-23,0,0,0,0,NaN,NaN
12,0.500,Pacific Ocean Water,23-5,0,0,0,0,NaN,NaN
12,0.500,Cat,16-23,17,19,0,36,47.222,47.222
12,0.500,Cat,23-5,20,21,0,41,48.780,48.780
12,0.500,Horse,16-23,6,16,0,22,27.273,27.273
12,0.500,Horse,23-5,24,103,0,127,18.898,18.898
12,0.500,orangutan,16-23,0,0,0,0,NaN,NaN
12,0.500,orangutan,23-5,0,0,0,0,NaN,NaN
12,0.500,Bat,16-23,36,35,0,71,50.704,50.704
12,0.500,Bat,23-5,37,37,0,74,50.000,50.000
12,0.500,Deer,16-23,13,37,0,50,26.000,26.000
12,0.500,Deer,23-5,17,121,0,138,12.319,12.319
12,0.500,Great Horned Owl,16-23,0,0,0,0,NaN,NaN
12,0.500,Great Horned Owl,23-5,0,1,0,1,0.000,0.000
12,0.500,Freshwater Lagoon,16-23,0,0,0,0,NaN,NaN
12,0.500,Freshwater Lagoon,23-5,0,0,0,0,NaN,NaN
12,0.500,Unknown Avian,16-23,0,0,0,0,NaN,NaN
12,0.500,Unknown Avian,23-5,0,0,0,0,NaN,NaN
12,0.500,Human UTI,16-23,75,77,0,152,49.342,49.342
12,0.500,Human UTI,23-5,101,105,0,206,49.029,49.029
12,0.500,unknown,16-23,0,0,0,0,NaN,NaN
12,0.500,unknown,23-5,0,3,0,3,0.000,0.000
12,0.500,SLO Creek Water,16-23,0,0,0,0,NaN,NaN
12,0.500,SLO Creek Water,23-5,0,0,0,0,NaN,NaN
12,0.500,Pig/Swine,16-23,4,5,0,9,44.444,44.444
12,0.500,Pig/Swine,23-5,7,10,0,17,41.176,41.176
12,0.500,Klebsiella,16-23,0,0,0,0,NaN,NaN
12,0.500,Klebsiella,23-5,0,0,0,0,NaN,NaN
12,0.500,Hu Cw and Dg,16-23,6,8,0,14,42.857,42.857
12,0.500,Hu Cw and Dg,23-5,8,13,0,21,38.095,38.095
12,0.500,Ground Squirrel,16-23,82,49,0,131,62.595,62.595
12,0.500,Ground Squirrel,23-5,83,75,0,158,52.532,52.532
12,0.500,Opossum,16-23,0,0,0,0,NaN,NaN
12,0.500,Opossum,23-5,0,0,0,0,NaN,NaN
12,0.500,Cow,16-23,1556,1224,0,2780,55.971,55.971
12,0.500,Cow,23-5,1521,1605,0,3126,48.656,48.656
12,0.500,Deer Mouse,16-23,0,0,0,0,NaN,NaN
12,0.500,Deer Mouse,23-5,0,0,0,0,NaN,NaN
12,0.500,OVERALL,16-23,3708,2640,0,6348,58.412,58.412
12,0.500,OVERALL,23-5,4293,3317,0,7610,56.413,56.413
12,0.900,Chicken,16-23,0,1,0,1,0.000,0.000
12,0.900,Chicken,23-5,5,6,0,11,45.455,45.455
12,0.900,Sea Lion,16-23,0,0,0,0,NaN,NaN
12,0.900,Sea Lion,23-5,0,11,0,11,0.000,0.000
12,0.900,Hu and Cw,16-23,2,5,0,7,28.571,28.571
12,0.900,Hu and Cw,23-5,7,8,0,15,46.667,46.667
12,0.900,Sheep,16-23,44,51,0,95,46.316,46.316
12,0.900,Sheep,23-5,56,40,0,96,58.333,58.333
12,0.900,Hu and Dg,16-23,6,13,0,19,31.579,31.579
12,0.900,Hu and Dg,23-5,19,23,0,42,45.238,45.238
12,0.900,Common Loon,16-23,0,0,0,0,NaN,NaN
12,0.900,Common Loon,23-5,0,0,0,0,NaN,NaN
12,0.900,Red-Winged Blackbird,16-23,0,2,0,2,0.000,0.000
12,0.900,Red-Winged Blackbird,23-5,0,0,0,0,NaN,NaN
12,0.900,Cw,16-23,7,11,0,18,38.889,38.889
12,0.900,Cw,23-5,13,24,0,37,35.135,35.135
12,0.900,Cliff Sparrow,16-23,1,10,0,11,9.091,9.091
12,0.900,Cliff Sparrow,23-5,0,0,0,0,NaN,NaN
12,0.900,Pig,16-23,6,7,0,13,46.154,46.154
12,0.900,Pig,23-5,3,1,0,4,75.000,75.000
12,0.900,Barn Owl,16-23,0,0,0,0,NaN,NaN
12,0.900,Barn Owl,23-5,0,0,0,0,NaN,NaN
12,0.900,Wild Pig,16-23,0,0,0,0,NaN,NaN
12,0.900,Wild Pig,23-5,1,0,0,1,100.000,100.000
12,0.900,Pennington Creek Water,16-23,0,0,0,0,NaN,NaN
12,0.900,Pennington Creek Water,23-5,0,0,0,0,NaN,NaN
12,0.900,Guinni,16-23,0,0,0,0,NaN,NaN
12,0.900,Guinni,23-5,0,0,0,0,NaN,NaN
12,0.900,Racoon,16-23,0,0,0,0,NaN,NaN
12,0.900,Racoon,23-5,0,0,0,0,NaN,NaN
12,0.900,Hu,16-23,12,14,0,26,46.154,46.154
12,0.900,Hu,23-5,23,16,0,39,58.974,58.974
12,0.900,Cw and Dg,16-23,8,15,0,23,34.783,34.783
12,0.900,Cw and Dg,23-5,13,18,0,31,41.935,41.935
12,0.900,Red Wind Blackbird,16-23,0,0,0,0,NaN,NaN
12,0.900,Red Wind Blackbird,23-5,0,0,0,0,NaN,NaN
12,0.900,Tree Swallow,16-23,0,0,0,0,NaN,NaN
12,0.900,Tree Swallow,23-5,0,0,0,0,NaN,NaN
12,0.900,Turkey Vulture,16-23,0,0,0,0,NaN,NaN
12,0.900,Turkey Vulture,23-5,0,0,0,0,NaN,NaN
12,0.900,Dg,16-23,7,11,0,18,38.889,38.889
12,0.900,Dg,23-5,32,32,0,64,50.000,50.000
12,0.900,Western Kingbird,16-23,0,0,0,0,NaN,NaN
12,0.900,Western Kingbird,23-5,0,0,0,0,NaN,NaN
12,0.900,White Crowned Sparrow,16-23,0,2,0,2,0.000,0.000
12,0.900,White Crowned Sparrow,23-5,0,7,0,7,0.000,0.000
12,0.900,Eared Grebe,16-23,0,0,0,0,NaN,NaN
12,0.900,Eared Grebe,23-5,0,7,0,7,0.000,0.000
12,0.900,cougar,16-23,0,0,0,0,NaN,NaN
12,0.900,cougar,23-5,0,0,0,0,NaN,NaN
12,0.900,Ocean Water,16-23,0,0,0,0,NaN,NaN
12,0.900,Ocean Water,23-5,0,0,0,0,NaN,NaN
12,0.900,Red Tailed Hawk,16-23,0,0,0,0,NaN,NaN
12,0.900,Red Tailed Hawk,23-5,0,6,0,6,0.000,0.000
12,0.900,Dog,16-23,54,68,0,122,44.262,44.262
12,0.900,Dog,23-5,85,138,0,223,38.117,38.117
12,0.900,Human,16-23,1727,820,0,2547,67.805,67.805
12,0.900,Human,23-5,2139,718,0,2857,74.869,74.869
12,0.900,Wild Turkey,16-23,1,3,0,4,25.000,25.000
12,0.900,Wild Turkey,23-5,0,11,0,11,0.000,0.000
12,0.900,Clark Grebe,16-23,0,0,0,0,NaN,NaN
12,0.900,Clark Grebe,23-5,0,0,0,0,NaN,NaN
12,0.900,Seagull,16-23,0,0,0,0,NaN,NaN
12,0.900,Seagull,23-5,4,9,0,13,30.769,30.769
12,0.900,Surf Scoter,16-23,0,0,0,0,NaN,NaN
12,0.900,Surf Scoter,23-5,0,0,0,0,NaN,NaN
12,0.900,Pigeon,16-23,38,137,0,175,21.714,21.714
12,0.900,Pigeon,23-5,75,140,0,215,34.884,34.884
12,0.900,Pacific Ocean Water,16-23,0,0,0,0,NaN,NaN
12,0.900,Pacific Ocean Water,23-5,0,0,0,0,NaN,NaN
12,0.900,Cat,16-23,17,19,0,36,47.222,47.222
12,0.900,Cat,23-5,20,21,0,41,48.780,48.780
12,0.900,Horse,16-23,6,16,0,22,27.273,27.273
12,0.900,Horse,23-5,24,103,0,127,18.898,18.898
12,0.900,orangutan,16-23,0,0,0,0,NaN,NaN
12,0.900,orangutan,23-5,0,0,0,0,NaN,NaN
12,0.900,Bat,16-23,36,35,0,71,50.704,50.704
12,0.900,Bat,23-5,37,37,0,74,50.000,50.000
12,0.900,Deer,16-23,13,37,0,50,26.000,26.000
12,0.900,Deer,23-5,17,121,0,138,12.319,12.319
12,0.900,Great Horned Owl,16-23,0,0,0,0,NaN,NaN
12,0.900,Great Horned Owl,23-5,0,1,0,1,0.000,0.000
12,0.900,Freshwater Lagoon,16-23,0,0,0,0,NaN,NaN
12,0.900,Freshwater Lagoon,23-5,0,0,0,0,NaN,NaN
12,0.900,Unknown Avian,16-23,0,0,0,0,NaN,NaN
12,0.900,Unknown Avian,23-5,0,0,0,0,NaN,NaN
12,0.900,Human UTI,16-23,75,77,0,152,49.342,49.342
12,0.900,Human UTI,23-5,104,105,0,209,49.761,49.761
12,0.900,unknown,16-23,0,0,0,0,NaN,NaN
12,0.900,unknown,23-5,0,3,0,3,0.000,0.000
12,0.900,SLO Creek Water,16-23,0,0,0,0,NaN,NaN
12,0.900,SLO Creek Water,23-5,0,0,0,0,NaN,NaN
12,0.900,Pig/Swine,16-23,4,5,0,9,44.444,44.444
12,0.900,Pig/Swine,23-5,7,10,0,17,41.176,41.176
12,0.900,Klebsiella,16-23,0,0,0,0,NaN,NaN
12,0.900,Klebsiella,23-5,0,0,0,0,NaN,NaN
12,0.900,Hu Cw and Dg,16-23,6,8,0,14,42.857,42.857
12,0.900,Hu Cw and Dg,23-5,8,13,0,21,38.095,38.095
12,0.900,Ground Squirrel,16-23,82,49,0,131,62.595,62.595
12,0.900,Ground Squirrel,23-5,83,75,0,158,52.532,52.532
12,0.900,Opossum,16-23,0,0,0,0,NaN,NaN
12,0.900,Opossum,23-5,0,0,0,0,NaN,NaN
12,0.900,Cow,16-23,1556,1220,0,2776,56.052,56.052
12,0.900,Cow,23-5,1521,1602,0,3123,48.703,48.703
12,0.900,Deer Mouse,16-23,0,0,0,0,NaN,NaN
12,0.900,Deer Mouse,23-5,0,0,0,0,NaN,NaN
12,0.900,OVERALL,16-23,3708,2636,0,6344,58.449,58.449
12,0.900,OVERALL,23-5,4296,3306,0,7602,56.511,56.511
12,0.950,Chicken,16-23,0,1,0,1,0.000,0.000
12,0.950,Chicken,23-5,5,6,0,11,45.455,45.455
12,0.950,Sea Lion,16-23,0,0,0,0,NaN,NaN
12,0.950,Sea Lion,23-5,0,11,0,11,0.000,0.000
12,0.950,Hu and Cw,16-23,2,5,0,7,28.571,28.571
12,0.950,Hu and Cw,23-5,7,8,0,15,46.667,46.667
12,0.950,Sheep,16-23,44,51,0,95,46.316,46.316
12,0.950,Sheep,23-5,56,40,0,96,58.333,58.333
12,0.950,Hu and Dg,16-23,6,13,0,19,31.579,31.579
12,0.950,Hu and Dg,23-5,19,23,0,42,45.238,45.238
12,0.950,Common Loon,16-23,0,0,0,0,NaN,NaN
12,0.950,Common Loon,23-5,0,0,0,0,NaN,NaN
12,0.950,Red-Winged Blackbird,16-23,0,2,0,2,0.000,0.000
12,0.950,Red-Winged Blackbird,23-5,0,0,0,0,NaN,NaN
12,0.950,Cw,16-23,7,11,0,18,38.889,38.889
12,0.950,Cw,23-5,13,24,0,37,35.135,35.135
12,0.950,Cliff Sparrow,16-23,1,10,0,11,9.091,9.091
12,0.950,Cliff Sparrow,23-5,0,0,0,0,NaN,NaN
12,0.950,Pig,16-23,6,7,0,13,46.154,46.154
12,0.950,Pig,23-5,3,1,0,4,75.000,75.000
12,0.950,Barn Owl,16-23,0,0,0,0,NaN,NaN
12,0.950,Barn Owl,23-5,0,0,0,0,NaN,NaN
12,0.950,Wild Pig,16-23,0,0,0,0,NaN,NaN
12,0.950,Wild Pig,23-5,1,0,0,1,100.000,100.000
12,0.950,Pennington Creek Water,16-23,0,0,0,0,NaN,NaN
12,0.950,Pennington Creek Water,23-5,0,0,0,0,NaN,NaN
12,0.950,Guinni,16-23,0,0,0,0,NaN,NaN
12,0.950,Guinni,23-5,0,0,0,0,NaN,NaN
12,0.950,Racoon,16-23,0,0,0,0,NaN,NaN
12,0.950,Racoon,23-5,0,0,0,0,NaN,NaN
12,0.950,Hu,16-23,12,14,0,26,46.154,46.154
12,0.950,Hu,23-5,23,16,0,39,58.974,58.974
12,0.950,Cw and Dg,16-23,8,15,0,23,34.783,34.783
12,0.950,Cw and Dg,23-5,13,18,0,31,41.935,41.935
12,0.950,Red Wind Blackbird,16-23,0,0,0,0,NaN,NaN
12,0.950,Red Wind Blackbird,23-5,0,0,0,0,NaN,NaN
12,0.950,Tree Swallow,16-23,0,0,0,0,NaN,NaN
12,0.950,Tree Swallow,23-5,0,0,0,0,NaN,NaN
12,0.950,Turkey Vulture,16-23,0,0,0,0,NaN,NaN
12,0.950,Turkey Vulture,23-5,0,0,0,0,NaN,NaN
12,0.950,Dg,16-23,7,11,0,18,38.889,38.889
12,0.950,Dg,23-5,32,32,0,64,50.000,50.000
12,0.950,Western Kingbird,16-23,0,0,0,0,NaN,NaN
12,0.950,Western Kingbird,23-5,0,0,0,0,NaN,NaN
12,0.950,White Crowned Sparrow,16-23,0,2,0,2,0.000,0.000
12,0.950,White Crowned Sparrow,23-5,0,7,0,7,0.000,0.000
12,0.950,Eared Grebe,16-23,0,0,0,0,NaN,NaN
12,0.950,Eared Grebe,23-5,0,7,0,7,0.000,0.000
12,0.950,cougar,16-23,0,0,0,0,NaN,NaN
12,0.950,cougar,23-5,0,0,0,0,NaN,NaN
12,0.950,Ocean Water,16-23,0,0,0,0,NaN,NaN
12,0.950,Ocean Water,23-5,0,0,0,0,NaN,NaN
12,0.950,Red Tailed Hawk,16-23,0,0,0,0,NaN,NaN
12,0.950,Red Tailed Hawk,23-5,0,6,0,6,0.000,0.000
12,0.950,Dog,16-23,54,68,0,122,44.262,44.262
12,0.950,Dog,23-5,85,136,0,221,38.462,38.462
12,0.950,Human,16-23,1727,818,0,2545,67.859,67.859
12,0.950,Human,23-5,2133,709,0,2842,75.053,75.053
12,0.950,Wild Turkey,16-23,1,3,0,4,25.000,25.000
12,0.950,Wild Turkey,23-5,0,10,0,10,0.000,0.000
12,0.950,Clark Grebe,16-23,0,0,0,0,NaN,NaN
12,0.950,Clark Grebe,23-5,0,0,0,0,NaN,NaN
12,0.950,Seagull,16-23,0,0,0,0,NaN,NaN
12,0.950,Seagull,23-5,4,8,0,12,33.333,33.333
12,0.950,Surf Scoter,16-23,0,0,0,0,NaN,NaN
12,0.950,Surf Scoter,23-5,0,0,0,0,NaN,NaN
12,0.950,Pigeon,16-23,39,136,0,175,22.286,22.286
12,0.950,Pigeon,23-5,75,141,0,216,34.722,34.722
12,0.950,Pacific Ocean Water,16-23,0,0,0,0,NaN,NaN
12,0.950,Pacific Ocean Water,23-5,0,0,0,0,NaN,NaN
12,0.950,Cat,16-23,17,19,0,36,47.222,47.222
12,0.950,Cat,23-5,20,27,0,47,42.553,42.553
12,0.950,Horse,16-23,6,16,0,22,27.273,27.273
12,0.950,Horse,23-5,24,103,0,127,18.898,18.898
12,0.950,orangutan,16-23,0,0,0,0,NaN,NaN
12,0.950,orangutan,23-5,0,0,0,0,NaN,NaN
12,0.950,Bat,16-23,36,35,0,71,50.704,50.704
12,0.950,Bat,23-5,37,36,0,73,50.685,50.685
12,0.950,Deer,16-23,13,37,0,50,26.000,26.000
12,0.950,Deer,23-5,17,121,0,138,12.319,12.319
12,0.950,Great Horned Owl,16-23,0,0,0,0,NaN,NaN
12,0.950,Great Horned Owl,23-5,0,1,0,1,0.000,0.000
12,0.950,Freshwater Lagoon,16-23,0,0,0,0,NaN,NaN
12,0.950,Freshwater Lagoon,23-5,0,0,0,0,NaN,NaN
12,0.950,Unknown Avian,16-23,0,0,0,0,NaN,NaN
12,0.950,Unknown Avian,23-5,0,0,0,0,NaN,NaN
12,0.950,Human UTI,16-23,78,78,0,156,50.000,50.000
12,0.950,Human UTI,23-5,103,108,0,211,48.815,48.815
12,0.950,unknown,16-23,0,0,0,0,NaN,NaN
12,0.950,unknown,23-5,0,3,0,3,0.000,0.000
12,0.950,SLO Creek Water,16-23,0,0,0,0,NaN,NaN
12,0.950,SLO Creek Water,23-5,0,0,0,0,NaN,NaN
12,0.950,Pig/Swine,16-23,4,5,0,9,44.444,44.444
12,0.950,Pig/Swine,23-5,7,10,0,17,41.176,41.176
12,0.950,Klebsiella,16-23,0,0,0,0,NaN,NaN
12,0.950,Klebsiella,23-5,0,0,0,0,NaN,NaN
12,0.950,Hu Cw and Dg,16-23,6,8,0,14,42.857,42.857
12,0.950,Hu Cw and Dg,23-5,8,13,0,21,38.095,38.095
12,0.950,Ground Squirrel,16-23,82,49,0,131,62.595,62.595
12,0.950,Ground Squirrel,23-5,83,74,0,157,52.866,52.866
12,0.950,Opossum,16-23,0,0,0,0,NaN,NaN
12,0.950,Opossum,23-5,0,0,0,0,NaN,NaN
12,0.950,Cow,16-23,1558,1199,0,2757,56.511,56.511
12,0.950,Cow,23-5,1520,1601,0,3121,48.702,48.702
12,0.950,Deer Mouse,16-23,0,0,0,0,NaN,NaN
12,0.950,Deer Mouse,23-5,0,0,0,0,NaN,NaN
12,0.950,OVERALL,16-23,3714,2613,0,6327,58.701,58.701
12,0.950,OVERALL,23-5,4288,3300,0,7588,56.510,56.510
12,0.960,Chicken,16-23,0,1,0,1,0.000,0.000
12,0.960,Chicken,23-5,5,6,0,11,45.455,45.455
12,0.960,Sea Lion,16-23,0,0,0,0,NaN,NaN
12,0.960,Sea Lion,23-5,0,11,0,11,0.000,0.000
12,0.960,Hu and Cw,16-23,2,5,0,7,28.571,28.571
12,0.960,Hu and Cw,23-5,7,8,0,15,46.667,46.667
12,0.960,Sheep,16-23,44,51,0,95,46.316,46.316
12,0.960,Sheep,23-5,56,41,0,97,57.732,57.732
12,0.960,Hu and Dg,16-23,6,13,0,19,31.579,31.579
12,0.960,Hu and Dg,23-5,19,23,0,42,45.238,45.238
12,0.960,Common Loon,16-23,0,0,0,0,NaN,NaN
12,0.960,Common Loon,23-5,0,0,0,0,NaN,NaN
12,0.960,Red-Winged Blackbird,16-23,0,2,0,2,0.000,0.000
12,0.960,Red-Winged Blackbird,23-5,0,0,0,0,NaN,NaN
12,0.960,Cw,16-23,7,11,0,18,38.889,38.889
12,0.960,Cw,23-5,13,24,0,37,35.135,35.135
12,0.960,Cliff Sparrow,16-23,1,10,0,11,9.091,9.091
12,0.960,Cliff Sparrow,23-5,0,0,0,0,NaN,NaN
12,0.960,Pig,16-23,6,7,0,13,46.154,46.154
12,0.960,Pig,23-5,3,1,0,4,75.000,75.000
12,0.960,Barn Owl,16-23,0,0,0,0,NaN,NaN
12,0.960,Barn Owl,23-5,0,0,0,0,NaN,NaN
12,0.960,Wild Pig,16-23,0,0,0,0,NaN,NaN
12,0.960,Wild Pig,23-5,1,0,0,1,100.000,100.000
12,0.960,Pennington Creek Water,16-23,0,0,0,0,NaN,NaN
12,0.960,Pennington Creek Water,23-5,0,0,0,0,NaN,NaN
12,0.960,Guinni,16-23,0,0,0,0,NaN,NaN
12,0.960,Guinni,23-5,0,0,0,0,NaN,NaN
12,0.960,Racoon,16-23,0,0,0,0,NaN,NaN
12,0.960,Racoon,23-5,0,0,0,0,NaN,NaN
12,0.960,Hu,16-23,12,14,0,26,46.154,46.154
12,0.960,Hu,23-5,23,16,0,39,58.974,58.974
12,0.960,Cw and Dg,16-23,8,15,0,23,34.783,34.783
12,0.960,Cw and Dg,23-5,13,18,0,31,41.935,41.935
12,0.960,Red Wind Blackbird,16-23,0,0,0,0,NaN,NaN
12,0.960,Red Wind Blackbird,23-5,0,0,0,0,NaN,NaN
12,0.960,Tree Swallow,16-23,0,0,0,0,NaN,NaN
12,0.960,Tree Swallow,23-5,0,0,0,0,NaN,NaN
12,0.960,Turkey Vulture,16-23,0,0,0,0,NaN,NaN
12,0.960,Turkey Vulture,23-5,0,0,0,0,NaN,NaN
12,0.960,Dg,16-23,7,11,0,18,38.889,38.889
12,0.960,Dg,23-5,32,32,0,64,50.000,50.000
12,0.960,Western Kingbird,16-23,0,0,0,0,NaN,NaN
12,0.960,Western Kingbird,23-5,0,0,0,0,NaN,NaN
12,0.960,White Crowned Sparrow,16-23,0,2,0,2,0.000,0.000
12,0.960,White Crowned Sparrow,23-5,0,7,0,7,0.000,0.000
12,0.960,Eared Grebe,16-23,0,0,0,0,NaN,NaN
12,0.960,Eared Grebe,23-5,0,7,0,7,0.000,0.000
12,0.960,cougar,16-23,0,0,0,0,NaN,NaN
12,0.960,cougar,23-5,0,0,0,0,NaN,NaN
12,0.960,Ocean Water,16-23,0,0,0,0,NaN,NaN
12,0.960,Ocean Water,23-5,0,0,0,0,NaN,NaN
12,0.960,Red Tailed Hawk,16-23,0,0,0,0,NaN,NaN
12,0.960,Red Tailed Hawk,23-5,0,6,0,6,0.000,0.000
12,0.960,Dog,16-23,54,68,0,122,44.262,44.262
12,0.960,Dog,23-5,85,131,0,216,39.352,39.352
12,0.960,Human,16-23,1728,817,0,2545,67.898,67.898
12,0.960,Human,23-5,2138,694,0,2832,75.494,75.494
12,0.960,Wild Turkey,16-23,1,3,0,4,25.000,25.000
12,0.960,Wild Turkey,23-5,0,14,0,14,0.000,0.000
12,0.960,Clark Grebe,16-23,0,0,0,0,NaN,NaN
12,0.960,Clark Grebe,23-5,0,0,0,0,NaN,NaN
12,0.960,Seagull,16-23,0,0,0,0,NaN,NaN
12,0.960,Seagull,23-5,4,9,0,13,30.769,30.769
12,0.960,Surf Scoter,16-23,0,0,0,0,NaN,NaN
12,0.960,Surf Scoter,23-5,0,2,0,2,0.000,0.000
12,0.960,Pigeon,16-23,38,136,0,174,21.839,21.839
12,0.960,Pigeon,23-5,76,156,0,232,32.759,32.759
12,0.960,Pacific Ocean Water,16-23,0,0,0,0,NaN,NaN
12,0.960,Pacific Ocean Water,23-5,0,0,0,0,NaN,NaN
12,0.960,Cat,16-23,17,19,0,36,47.222,47.222
12,0.960,Cat,23-5,20,28,0,48,41.667,41.667
12,0.960,Horse,16-23,6,16,0,22,27.273,27.273
12,0.960,Horse,23-5,24,103,0,127,18.898,18.898
12,0.960,orangutan,16-23,0,0,0,0,NaN,NaN
12,0.960,orangutan,23-5,0,0,0,0,NaN,NaN
12,0.960,Bat,16-23,36,35,0,71,50.704,50.704
12,0.960,Bat,23-5,37,36,0,73,50.685,50.685
12,0.960,Deer,16-23,13,37,0,50,26.000,26.000
12,0.960,Deer,23-5,17,121,0,138,12.319,12.319
12,0.960,Great Horned Owl,16-23,0,0,0,0,NaN,NaN
12,0.960,Great Horned Owl,23-5,0,1,0,1,0.000,0.000
12,0.960,Freshwater Lagoon,16-23,0,0,0,0,NaN,NaN
12,0.960,Freshwater Lagoon,23-5,0,0,0,0,NaN,NaN
12,0.960,Unknown Avian,16-23,0,0,0,0,NaN,NaN
12,0.960,Unknown Avian,23-5,0,0,0,0,NaN,NaN
12,0.960,Human UTI,16-23,78,79,0,157,49.682,49.682
12,0.960,Human UTI,23-5,103,107,0,210,49.048,49.048
12,0.960,unknown,16-23,0,0,0,0,NaN,NaN
12,0.960,unknown,23-5,0,3,0,3,0.000,0.000
12,0.960,SLO Creek Water,16-23,0,0,0,0,NaN,NaN
12,0.960,SLO Creek Water,23-5,0,0,0,0,NaN,NaN
12,0.960,Pig/Swine,16-23,4,5,0,9,44.444,44.444
12,0.960,Pig/Swine,23-5,7,10,0,17,41.176,41.176
12,0.960,Klebsiella,16-23,0,0,0,0,NaN,NaN
12,0.960,Klebsiella,23-5,0,0,0,0,NaN,NaN
12,0.960,Hu Cw and Dg,16-23,6,8,0,14,42.857,42.857
12,0.960,Hu Cw and Dg,23-5,8,13,0,21,38.095,38.095
12,0.960,Ground Squirrel,16-23,82,49,0,131,62.595,62.595
12,0.960,Ground Squirrel,23-5,83,76,0,159,52.201,52.201
12,0.960,Opossum,16-23,0,0,0,0,NaN,NaN
12,0.960,Opossum,23-5,0,0,0,0,NaN,NaN
12,0.960,Cow,16-23,1556,1190,0,2746,56.664,56.664
12,0.960,Cow,23-5,1520,1579,0,3099,49.048,49.048
12,0.960,Deer Mouse,16-23,0,0,0,0,NaN,NaN
12,0.960,Deer Mouse,23-5,0,0,0,0,NaN,NaN
12,0.960,OVERALL,16-23,3712,2604,0,6316,58.771,58.771
12,0.960,OVERALL,23-5,4294,3283,0,7577,56.672,56.672
12,0.970,Chicken,16-23,0,1,0,1,0.000,0.000
12,0.970,Chicken,23-5,5,6,0,11,45.455,45.455
12,0.970,Sea Lion,16-23,0,0,0,0,NaN,NaN
12,0.970,Sea Lion,23-5,0,11,0,11,0.000,0.000
12,0.970,Hu and Cw,16-23,2,5,0,7,28.571,28.571
12,0.970,Hu and Cw,23-5,7,8,0,15,46.667,46.667
12,0.970,Sheep,16-23,45,52,0,97,46.392,46.392
12,0.970,Sheep,23-5,56,40,0,96,58.333,58.333
12,0.970,Hu and Dg,16-23,6,13,0,19,31.579,31.579
12,0.970,Hu and Dg,23-5,19,23,0,42,45.238,45.238
12,0.970,Common Loon,16-23,0,0,0,0,NaN,NaN
12,0.970,Common Loon,23-5,0,0,0,0,NaN,NaN
12,0.970,Red-Winged Blackbird,16-23,0,2,0,2,0.000,0.000
12,0.970,Red-Winged Blackbird,23-5,0,0,0,0,NaN,NaN
12,0.970,Cw,16-23,7,12,0,19,36.842,36.842
12,0.970,Cw,23-5,13,24,0,37,35.135,35.135
12,0.970,Cliff Sparrow,16-23,1,10,0,11,9.091,9.091
12,0.970,Cliff Sparrow,23-5,0,0,0,0,NaN,NaN
12,0.970,Pig,16-23,6,7,0,13,46.154,46.154
12,0.970,Pig,23-5,3,1,0,4,75.000,75.000
12,0.970,Barn Owl,16-23,0,0,0,0,NaN,NaN
12,0.970,Barn Owl,23-5,0,0,0,0,NaN,NaN
12,0.970,Wild Pig,16-23,0,0,0,0,NaN,NaN
12,0.970,Wild Pig,23-5,0,0,0,0,NaN,NaN
12,0.970,Pennington Creek Water,16-23,0,0,0,0,NaN,NaN
12,0.970,Pennington Creek Water,23-5,0,0,0,0,NaN,NaN
12,0.970,Guinni,16-23,0,0,0,0,NaN,NaN
12,0.970,Guinni,23-5,0,0,0,0,NaN,NaN
12,0.970,Racoon,16-23,0,0,0,0,NaN,NaN
12,0.970,Racoon,23-5,0,0,0,0,NaN,NaN
12,0.970,Hu,16-23,12,14,0,26,46.154,46.154
12,0.970,Hu,23-5,23,16,0,39,58.974,58.974
12,0.970,Cw and Dg,16-23,8,15,0,23,34.783,34.783
12,0.970,Cw and Dg,23-5,13,18,0,31,41.935,41.935
12,0.970,Red Wind Blackbird,16-23,0,0,0,0,NaN,NaN
12,0.970,Red Wind Blackbird,23-5,0,0,0,0,NaN,NaN
12,0.970,Tree Swallow,16-23,0,0,0,0,NaN,NaN
12,0.970,Tree Swallow,23-5,0,0,0,0,NaN,NaN
12,0.970,Turkey Vulture,16-23,0,0,0,0,NaN,NaN
12,0.970,Turkey Vulture,23-5,0,0,0,0,NaN,NaN
12,0.970,Dg,16-23,7,11,0,18,38.889,38.889
12,0.970,Dg,23-5,32,31,0,63,50.794,50.794
12,0.970,Western Kingbird,16-23,0,0,0,0,NaN,NaN
12,0.970,Western Kingbird,23-5,0,0,0,0,NaN,NaN
12,0.970,White Crowned Sparrow,16-23,0,2,0,2,0.000,0.000
12,0.970,White Crowned Sparrow,23-5,0,7,0,7,0.000,0.000
12,0.970,Eared Grebe,16-23,0,0,0,0,NaN,NaN
12,0.970,Eared Grebe,23-5,0,7,0,7,0.000,0.000
12,0.970,cougar,16-23,0,0,0,0,NaN,NaN
12,0.970,cougar,23-5,0,0,0,0,NaN,NaN
12,0.970,Ocean Water,16-23,0,0,0,0,NaN,NaN
12,0.970,Ocean Water,23-5,0,0,0,0,NaN,NaN
12,0.970,Red Tailed Hawk,16-23,0,0,0,0,NaN,NaN
12,0.970,Red Tailed Hawk,23-5,0,6,0,6,0.000,0.000
12,0.970,Dog,16-23,54,68,0,122,44.262,44.262
12,0.970,Dog,23-5,86,129,0,215,40.000,40.000
12,0.970,Human,16-23,1727,815,0,2542,67.939,67.939
12,0.970,Human,23-5,2137,693,0,2830,75.512,75.512
12,0.970,Wild Turkey,16-23,1,5,0,6,16.667,16.667
12,0.970,Wild Turkey,23-5,2,13,0,15,13.333,13.333
12,0.970,Clark Grebe,16-23,0,0,0,0,NaN,NaN
12,0.970,Clark Grebe,23-5,0,0,0,0,NaN,NaN
12,0.970,Seagull,16-23,0,0,0,0,NaN,NaN
12,0.970,Seagull,23-5,4,10,0,14,28.571,28.571
12,0.970,Surf Scoter,16-23,0,0,0,0,NaN,NaN
12,0.970,Surf Scoter,23-5,0,2,0,2,0.000,0.000
12,0.970,Pigeon,16-23,36,135,0,171,21.053,21.053
12,0.970,Pigeon,23-5,76,173,0,249,30.522,30.522
12,0.970,Pacific Ocean Water,16-23,0,0,0,0,NaN,NaN
12,0.970,Pacific Ocean Water,23-5,0,0,0,0,NaN,NaN
12,0.970,Cat,16-23,17,19,0,36,47.222,47.222
12,0.970,Cat,23-5,20,25,0,45,44.444,44.444
12,0.970,Horse,16-23,6,16,0,22,27.273,27.273
12,0.970,Horse,23-5,24,104,0,128,18.750,18.750
12,0.970,orangutan,16-23,0,0,0,0,NaN,NaN
12,0.970,orangutan,23-5,0,0,0,0,NaN,NaN
12,0.970,Bat,16-23,36,35,0,71,50.704,50.704
12,0.970,Bat,23-5,37,36,0,73,50.685,50.685
12,0.970,Deer,16-23,13,37,0,50,26.000,26.000
12,0.970,Deer,23-5,17,121,0,138,12.319,12.319
12,0.970,Great Horned Owl,16-23,0,0,0,0,NaN,NaN
12,0.970,Great Horned Owl,23-5,0,1,0,1,0.000,0.000
12,0.970,Freshwater Lagoon,16-23,0,0,0,0,NaN,NaN
12,0.970,Freshwater Lagoon,23-5,0,0,0,0,NaN,NaN
12,0.970,Unknown Avian,16-23,0,0,0,0,NaN,NaN
12,0.970,Unknown Avian,23-5,0,0,0,0,NaN,NaN
12,0.970,Human UTI,16-23,78,80,0,158,49.367,49.367
12,0.970,Human UTI,23-5,102,107,0,209,48.804,48.804
12,0.970,unknown,16-23,0,0,0,0,NaN,NaN
12,0.970,unknown,23-5,0,3,0,3,0.000,0.000
12,0.970,SLO Creek Water,16-23,0,0,0,0,NaN,NaN
12,0.970,SLO Creek Water,23-5,0,0,0,0,NaN,NaN
12,0.970,Pig/Swine,16-23,4,5,0,9,44.444,44.444
12,0.970,Pig/Swine,23-5,7,10,0,17,41.176,41.176
12,0.970,Klebsiella,16-23,0,0,0,0,NaN,NaN
12,0.970,Klebsiella,23-5,0,0,0,0,NaN,NaN
12,0.970,Hu Cw and Dg,16-23,6,8,0,14,42.857,42.857
12,0.970,Hu Cw and Dg,23-5,8,13,0,21,38.095,38.095
12,0.970,Ground Squirrel,16-23,82,47,0,129,63.566,63.566
12,0.970,Ground Squirrel,23-5,83,74,0,157,52.866,52.866
12,0.970,Opossum,16-23,0,0,0,0,NaN,NaN
12,0.970,Opossum,23-5,0,0,0,0,NaN,NaN
12,0.970,Cow,16-23,1550,1188,0,2738,56.611,56.611
12,0.970,Cow,23-5,1517,1553,0,3070,49.414,49.414
12,0.970,Deer Mouse,16-23,0,0,0,0,NaN,NaN
12,0.970,Deer Mouse,23-5,0,0,0,0,NaN,NaN
12,0.970,OVERALL,16-23,3704,2602,0,6306,58.738,58.738
12,0.970,OVERALL,23-5,4291,3265,0,7556,56.789,56.789
12,0.980,Chicken,16-23,0,1,0,1,0.000,0.000
12,0.980,Chicken,23-5,6,6,0,12,50.000,50.000
12,0.980,Sea Lion,16-23,0,0,0,0,NaN,NaN
12,0.980,Sea Lion,23-5,0,10,0,10,0.000,0.000
12,0.980,Hu and Cw,16-23,2,5,0,7,28.571,28.571
12,0.980,Hu and Cw,23-5,7,18,0,25,28.000,28.000
12,0.980,Sheep,16-23,48,50,0,98,48.980,48.980
12,0.980,Sheep,23-5,55,39,0,94,58.511,58.511
12,0.980,Hu and Dg,16-23,6,12,0,18,33.333,33.333
12,0.980,Hu and Dg,23-5,19,20,0,39,48.718,48.718
12,0.980,Common Loon,16-23,0,0,0,0,NaN,NaN
12,0.980,Common Loon,23-5,0,0,0,0,NaN,NaN
12,0.980,Red-Winged Blackbird,16-23,0,2,0,2,0.000,0.000
12,0.980,Red-Winged Blackbird,23-5,0,0,0,0,NaN,NaN
12,0.980,Cw,16-23,7,11,0,18,38.889,38.889
12,0.980,Cw,23-5,13,25,0,38,34.211,34.211
12,0.980,Cliff Sparrow,16-23,1,10,0,11,9.091,9.091
12,0.980,Cliff Sparrow,23-5,0,0,0,0,NaN,NaN
12,0.980,Pig,16-23,6,7,0,13,46.154,46.154
12,0.980,Pig,23-5,3,1,0,4,75.000,75.000
12,0.980,Barn Owl,16-23,0,0,0,0,NaN,NaN
12,0.980,Barn Owl,23-5,0,0,0,0,NaN,NaN
12,0.980,Wild Pig,16-23,0,0,0,0,NaN,NaN
12,0.980,Wild Pig,23-5,0,0,0,0,NaN,NaN
12,0.980,Pennington Creek Water,16-23,0,0,0,0,NaN,NaN
12,0.980,Pennington Creek Water,23-5,0,0,0,0,NaN,NaN
12,0.980,Guinni,16-23,0,0,0,0,NaN,NaN
12,0.980,Guinni,23-5,0,0,0,0,NaN,NaN
12,0.980,Racoon,16-23,0,0,0,0,NaN,NaN
12,0.980,Racoon,23-5,0,0,0,0,NaN,NaN
12,0.980,Hu,16-23,12,14,0,26,46.154,46.154
12,0.980,Hu,23-5,23,17,0,40,57.500,57.500
12,0.980,Cw and Dg,16-23,8,15,0,23,34.783,34.783
12,0.980,Cw and Dg,23-5,13,19,0,32,40.625,40.625
12,0.980,Red Wind Blackbird,16-23,0,0,0,0,NaN,NaN
12,0.980,Red Wind Blackbird,23-5,0,0,0,0,NaN,NaN
12,0.980,Tree Swallow,16-23,0,0,0,0,NaN,NaN
12,0.980,Tree Swallow,23-5,0,0,0,0,NaN,NaN
12,0.980,Turkey Vulture,16-23,0,0,0,0,NaN,NaN
12,0.980,Turkey Vulture,23-5,0,0,0,0,NaN,NaN
12,0.980,Dg,16-23,7,11,0,18,38.889,38.889
12,0.980,Dg,23-5,32,24,0,56,57.143,57.143
12,0.980,Western Kingbird,16-23,0,0,0,0,NaN,NaN
12,0.980,Western Kingbird,23-5,0,0,0,0,NaN,NaN
12,0.980,White Crowned Sparrow,16-23,0,2,0,2,0.000,0.000
12,0.980,White Crowned Sparrow,23-5,0,8,0,8,0.000,0.000
12,0.980,Eared Grebe,16-23,0,0,0,0,NaN,NaN
12,0.980,Eared Grebe,23-5,0,7,0,7,0.000,0.000
12,0.980,cougar,16-23,0,0,0,0,NaN,NaN
12,0.980,cougar,23-5,0,0,0,0,NaN,NaN
12,0.980,Ocean Water,16-23,0,0,0,0,NaN,NaN
12,0.980,Ocean Water,23-5,0,0,0,0,NaN,NaN
12,0.980,Red Tailed Hawk,16-23,0,0,0,0,NaN,NaN
12,0.980,Red Tailed Hawk,23-5,0,5,0,5,0.000,0.000
12,0.980,Dog,16-23,53,72,0,125,42.400,42.400
12,0.980,Dog,23-5,87,125,0,212,41.038,41.038
12,0.980,Human,16-23,1727,804,0,2531,68.234,68.234
12,0.980,Human,23-5,2137,678,0,2815,75.915,75.915
12,0.980,Wild Turkey,16-23,1,5,0,6,16.667,16.667
12,0.980,Wild Turkey,23-5,4,21,0,25,16.000,16.000
12,0.980,Clark Grebe,16-23,0,0,0,0,NaN,NaN
12,0.980,Clark Grebe,23-5,0,0,0,0,NaN,NaN
12,0.980,Seagull,16-23,0,0,0,0,NaN,NaN
12,0.980,Seagull,23-5,6,8,0,14,42.857,42.857
12,0.980,Surf Scoter,16-23,0,0,0,0,NaN,NaN
12,0.980,Surf Scoter,23-5,2,0,0,2,100.000,100.000
12,0.980,Pigeon,16-23,36,132,0,168,21.429,21.429
12,0.980,Pigeon,23-5,75,181,0,256,29.297,29.297
12,0.980,Pacific Ocean Water,16-23,0,0,0,0,NaN,NaN
12,0.980,Pacific Ocean Water,23-5,0,0,0,0,NaN,NaN
12,0.980,Cat,16-23,17,19,0,36,47.222,47.222
12,0.980,Cat,23-5,21,21,0,42,50.000,50.000
12,0.980,Horse,16-23,6,16,0,22,27.273,27.273
12,0.980,Horse,23-5,24,101,0,125,19.200,19.200
12,0.980,orangutan,16-23,0,0,0,0,NaN,NaN
12,0.980,orangutan,23-5,0,0,0,0,NaN,NaN
12,0.980,Bat,16-23,36,35,0,71,50.704,50.704
12,0.980,Bat,23-5,37,35,0,72,51.389,51.389
12,0.980,Deer,16-23,13,37,0,50,26.000,26.000
12,0.980,Deer,23-5,17,121,0,138,12.319,12.319
12,0.980,Great Horned Owl,16-23,0,0,0,0,NaN,NaN
12,0.980,Great Horned Owl,23-5,0,1,0,1,0.000,0.000
12,0.980,Freshwater Lagoon,16-23,0,0,0,0,NaN,NaN
12,0.980,Freshwater Lagoon,23-5,0,0,0,0,NaN,NaN
12,0.980,Unknown Avian,16-23,0,0,0,0,NaN,NaN
12,0.980,Unknown Avian,23-5,0,0,0,0,NaN,NaN
12,0.980,Human UTI,16-23,78,82,0,160,48.750,48.750
12,0.980,Human UTI,23-5,102,107,0,209,48.804,48.804
12,0.980,unknown,16-23,0,0,0,0,NaN,NaN
12,0.980,unknown,23-5,0,4,0,4,0.000,0.000
12,0.980,SLO Creek Water,16-23,0,0,0,0,NaN,NaN
12,0.980,SLO Creek Water,23-5,0,0,0,0,NaN,NaN
12,0.980,Pig/Swine,16-23,4,5,0,9,44.444,44.444
12,0.980,Pig/Swine,23-5,7,10,0,17,41.176,41.176
12,0.980,Klebsiella,16-23,0,0,0,0,NaN,NaN
12,0.980,Klebsiella,23-5,0,0,0,0,NaN,NaN
12,0.980,Hu Cw and Dg,16-23,6,8,0,14,42.857,42.857
12,0.980,Hu Cw and Dg,23-5,8,12,0,20,40.000,40.000
12,0.980,Ground Squirrel,16-23,85,49,0,134,63.433,63.433
12,0.980,Ground Squirrel,23-5,84,73,0,157,53.503,53.503
12,0.980,Opossum,16-23,0,0,0,0,NaN,NaN
12,0.980,Opossum,23-5,0,0,0,0,NaN,NaN
12,0.980,Cow,16-23,1544,1169,0,2713,56.911,56.911
12,0.980,Cow,23-5,1510,1522,0,3032,49.802,49.802
12,0.980,Deer Mouse,16-23,0,0,0,0,NaN,NaN
12,0.980,Deer Mouse,23-5,0,0,0,0,NaN,NaN
12,0.980,OVERALL,16-23,3703,2573,0,6276,59.003,59.003
12,0.980,OVERALL,23-5,4292,3219,0,7511,57.143,57.143
12,0.990,Chicken,16-23,2,7,0,9,22.222,22.222
12,0.990,Chicken,23-5,7,6,0,13,53.846,53.846
12,0.990,Sea Lion,16-23,0,0,0,0,NaN,NaN
12,0.990,Sea Lion,23-5,2,7,0,9,22.222,22.222
12,0.990,Hu and Cw,16-23,3,5,0,8,37.500,37.500
12,0.990,Hu and Cw,23-5,9,25,0,34,26.471,26.471
12,0.990,Sheep,16-23,47,50,0,97,48.454,48.454
12,0.990,Sheep,23-5,56,38,0,94,59.574,59.574
12,0.990,Hu and Dg,16-23,6,14,0,20,30.000,30.000
12,0.990,Hu and Dg,23-5,19,17,0,36,52.778,52.778
12,0.990,Common Loon,16-23,0,0,0,0,NaN,NaN
12,0.990,Common Loon,23-5,0,2,0,2,0.000,0.000
12,0.990,Red-Winged Blackbird,16-23,0,4,0,4,0.000,0.000
12,0.990,Red-Winged Blackbird,23-5,0,0,0,0,NaN,NaN
12,0.990,Cw,16-23,8,11,0,19,42.105,42.105
12,0.990,Cw,23-5,19,26,0,45,42.222,42.222
12,0.990,Cliff Sparrow,16-23,1,11,0,12,8.333,8.333
12,0.990,Cliff Sparrow,23-5,0,4,0,4,0.000,0.000
12,0.990,Pig,16-23,6,8,0,14,42.857,42.857
12,0.990,Pig,23-5,7,8,0,15,46.667,46.667
12,0.990,Barn Owl,16-23,0,0,0,0,NaN,NaN
12,0.990,Barn Owl,23-5,0,0,0,0,NaN,NaN
12,0.990,Wild Pig,16-23,0,2,0,2,0.000,0.000
12,0.990,Wild Pig,23-5,0,1,0,1,0.000,0.000
12,0.990,Pennington Creek Water,16-23,0,0,0,0,NaN,NaN
12,0.990,Pennington Creek Water,23-5,0,0,0,0,NaN,NaN
12,0.990,Guinni,16-23,0,0,0,0,NaN,NaN
12,0.990,Guinni,23-5,0,0,0,0,NaN,NaN
12,0.990,Racoon,16-23,0,0,0,0,NaN,NaN
12,0.990,Racoon,23-5,0,1,0,1,0.000,0.000
12,0.990,Hu,16-23,12,13,0,25,48.000,48.000
12,0.990,Hu,23-5,23,12,0,35,65.714,65.714
12,0.990,Cw and Dg,16-23,8,15,0,23,34.783,34.783
12,0.990,Cw and Dg,23-5,13,13,0,26,50.000,50.000
12,0.990,Red Wind Blackbird,16-23,0,0,0,0,NaN,NaN
12,0.990,Red Wind Blackbird,23-5,0,0,0,0,NaN,NaN
12,0.990,Tree Swallow,16-23,0,0,0,0,NaN,NaN
12,0.990,Tree Swallow,23-5,0,0,0,0,NaN,NaN
12,0.990,Turkey Vulture,16-23,0,0,0,0,NaN,NaN
12,0.990,Turkey Vulture,23-5,0,0,0,0,NaN,NaN
12,0.990,Dg,16-23,7,12,0,19,36.842,36.842
12,0.990,Dg,23-5,32,19,0,51,62.745,62.745
12,0.990,Western Kingbird,16-23,0,0,0,0,NaN,NaN
12,0.990,Western Kingbird,23-5,0,0,0,0,NaN,NaN
12,0.990,White Crowned Sparrow,16-23,0,2,0,2,0.000,0.000
12,0.990,White Crowned Sparrow,23-5,0,9,0,9,0.000,0.000
12,0.990,Eared Grebe,16-23,0,0,0,0,NaN,NaN
12,0.990,Eared Grebe,23-5,0,8,0,8,0.000,0.000
12,0.990,cougar,16-23,0,1,0,1,0.000,0.000
12,0.990,cougar,23-5,0,0,0,0,NaN,NaN
12,0.990,Ocean Water,16-23,0,0,0,0,NaN,NaN
12,0.990,Ocean Water,23-5,0,0,0,0,NaN,NaN
12,0.990,Red Tailed Hawk,16-23,0,0,0,0,NaN,NaN
12,0.990,Red Tailed Hawk,23-5,0,5,0,5,0.000,0.000
12,0.990,Dog,16-23,56,72,0,128,43.750,43.750
12,0.990,Dog,23-5,90,117,0,207,43.478,43.478
12,0.990,Human,16-23,1706,766,0,2472,69.013,69.013
12,0.990,Human,23-5,2124,623,0,2747,77.321,77.321
12,0.990,Wild Turkey,16-23,3,10,0,13,23.077,23.077
12,0.990,Wild Turkey,23-5,4,22,0,26,15.385,15.385
12,0.990,Clark Grebe,16-23,0,0,0,0,NaN,NaN
12,0.990,Clark Grebe,23-5,2,3,0,5,40.000,40.000
12,0.990,Seagull,16-23,0,0,0,0,NaN,NaN
12,0.990,Seagull,23-5,12,7,0,19,63.158,63.158
12,0.990,Surf Scoter,16-23,0,0,0,0,NaN,NaN
12,0.990,Surf Scoter,23-5,2,0,0,2,100.000,100.000
12,0.990,Pigeon,16-23,46,128,0,174,26.437,26.437
12,0.990,Pigeon,23-5,81,198,0,279,29.032,29.032
12,0.990,Pacific Ocean Water,16-23,0,0,0,0,NaN,NaN
12,0.990,Pacific Ocean Water,23-5,0,0,0,0,NaN,NaN
12,0.990,Cat,16-23,18,21,0,39,46.154,46.154
12,0.990,Cat,23-5,21,24,0,45,46.667,46.667
12,0.990,Horse,16-23,9,17,0,26,34.615,34.615
12,0.990,Horse,23-5,24,114,0,138,17.391,17.391
12,0.990,orangutan,16-23,0,0,0,0,NaN,NaN
12,0.990,orangutan,23-5,0,0,0,0,NaN,NaN
12,0.990,Bat,16-23,36,31,0,67,53.731,53.731
12,0.990,Bat,23-5,37,34,0,71,52.113,52.113
12,0.990,Deer,16-23,13,38,0,51,25.490,25.490
12,0.990,Deer,23-5,17,110,0,127,13.386,13.386
12,0.990,Great Horned Owl,16-23,0,0,0,0,NaN,NaN
12,0.990,Great Horned Owl,23-5,0,1,0,1,0.000,0.000
12,0.990,Freshwater Lagoon,16-23,0,0,0,0,NaN,NaN
12,0.990,Freshwater Lagoon,23-5,0,0,0,0,NaN,NaN
12,0.990,Unknown Avian,16-23,0,0,0,0,NaN,NaN
12,0.990,Unknown Avian,23-5,0,0,0,0,NaN,NaN
12,0.990,Human UTI,16-23,82,75,0,157,52.229,52.229
12,0.990,Human UTI,23-5,101,83,0,184,54.891,54.891
12,0.990,unknown,16-23,0,0,0,0,NaN,NaN
12,0.990,unknown,23-5,0,6,0,6,0.000,0.000
12,0.990,SLO Creek Water,16-23,0,0,0,0,NaN,NaN
12,0.990,SLO Creek Water,23-5,0,0,0,0,NaN,NaN
12,0.990,Pig/Swine,16-23,4,6,0,10,40.000,40.000
12,0.990,Pig/Swine,23-5,7,9,0,16,43.750,43.750
12,0.990,Klebsiella,16-23,0,0,0,0,NaN,NaN
12,0.990,Klebsiella,23-5,0,0,0,0,NaN,NaN
12,0.990,Hu Cw and Dg,16-23,6,8,0,14,42.857,42.857
12,0.990,Hu Cw and Dg,23-5,8,13,0,21,38.095,38.095
12,0.990,Ground Squirrel,16-23,88,49,0,137,64.234,64.234
12,0.990,Ground Squirrel,23-5,86,75,0,161,53.416,53.416
12,0.990,Opossum,16-23,1,0,0,1,100.000,100.000
12,0.990,Opossum,23-5,2,0,0,2,100.000,100.000
12,0.990,Cow,16-23,1509,1061,0,2570,58.716,58.716
12,0.990,Cow,23-5,1473,1387,0,2860,51.503,51.503
12,0.990,Deer Mouse,16-23,0,0,0,0,NaN,NaN
12,0.990,Deer Mouse,23-5,0,0,0,0,NaN,NaN
12,0.990,OVERALL,16-23,3677,2437,0,6114,60.141,60.141
12,0.990,OVERALL,23-5,4278,3027,0,7305,58.563,58.563
12,1.000,Chicken,16-23,0,0,0,0,NaN,NaN
12,1.000,Chicken,23-5,0,0,0,0,NaN,NaN
12,1.000,Sea Lion,16-23,0,0,0,0,NaN,NaN
12,1.000,Sea Lion,23-5,0,0,0,0,NaN,NaN
12,1.000,Hu and Cw,16-23,0,0,0,0,NaN,NaN
12,1.000,Hu and Cw,23-5,0,0,0,0,NaN,NaN
12,1.000,Sheep,16-23,0,0,0,0,NaN,NaN
12,1.000,Sheep,23-5,0,0,0,0,NaN,NaN
12,1.000,Hu and Dg,16-23,0,0,0,0,NaN,NaN
12,1.000,Hu and Dg,23-5,0,0,0,0,NaN,NaN
12,1.000,Common Loon,16-23,0,0,0,0,NaN,NaN
12,1.000,Common Loon,23-5,0,0,0,0,NaN,NaN
12,1.000,Red-Winged Blackbird,16-23,0,0,0,0,NaN,NaN
12,1.000,Red-Winged Blackbird,23-5,0,0,0,0,NaN,NaN
12,1.000,Cw,16-23,0,0,0,0,NaN,NaN
12,1.000,Cw,23-5,0,0,0,0,NaN,NaN
12,1.000,Cliff Sparrow,16-23,0,0,0,0,NaN,NaN
12,1.000,Cliff Sparrow,23-5,0,0,0,0,NaN,NaN
12,1.000,Pig,16-23,0,0,0,0,NaN,NaN
12,1.000,Pig,23-5,0,0,0,0,NaN,NaN
12,1.000,Barn Owl,16-23,0,0,0,0,NaN,NaN
12,1.000,Barn Owl,23-5,0,0,0,0,NaN,NaN
12,1.000,Wild Pig,16-23,0,0,0,0,NaN,NaN
12,1.000,Wild Pig,23-5,0,0,0,0,NaN,NaN
12,1.000,Pennington Creek Water,16-23,0,0,0,0,NaN,NaN
12,1.000,Pennington Creek Water,23-5,0,0,0,0,NaN,NaN
12,1.000,Guinni,16-23,0,0,0,0,NaN,NaN
12,1.000,Guinni,23-5,0,0,0,0,NaN,NaN
12,1.000,Racoon,16-23,0,0,0,0,NaN,NaN
12,1.000,Racoon,23-5,0,0,0,0,NaN,NaN
12,1.000,Hu,16-23,0,0,0,0,NaN,NaN
12,1.000,Hu,23-5,0,0,0,0,NaN,NaN
12,1.000,Cw and Dg,16-23,0,0,0,0,NaN,NaN
12,1.000,Cw and Dg,23-5,0,0,0,0,NaN,NaN
12,1.000,Red Wind Blackbird,16-23,0,0,0,0,NaN,NaN
12,1.000,Red Wind Blackbird,23-5,0,0,0,0,NaN,NaN
12,1.000,Tree Swallow,16-23,0,0,0,0,NaN,NaN
12,1.000,Tree Swallow,23-5,0,0,0,0,NaN,NaN
12,1.000,Turkey Vulture,16-23,0,0,0,0,NaN,NaN
12,1.000,Turkey Vulture,23-5,0,0,0,0,NaN,NaN
12,1.000,Dg,16-23,0,0,0,0,NaN,NaN
12,1.000,Dg,23-5,0,0,0,0,NaN,NaN
12,1.000,Western Kingbird,16-23,0,0,0,0,NaN,NaN
12,1.000,Western Kingbird,23-5,0,0,0,0,NaN,NaN
12,1.000,White Crowned Sparrow,16-23,0,0,0,0,NaN,NaN
12,1.000,White Crowned Sparrow,23-5,0,0,0,0,NaN,NaN
12,1.000,Eared Grebe,16-23,0,0,0,0,NaN,NaN
12,1.000,Eared Grebe,23-5,0,0,0,0,NaN,NaN
12,1.000,cougar,16-23,0,0,0,0,NaN,NaN
12,1.000,cougar,23-5,0,0,0,0,NaN,NaN
12,1.000,Ocean Water,16-23,0,0,0,0,NaN,NaN
12,1.000,Ocean Water,23-5,0,0,0,0,NaN,NaN
12,1.000,Red Tailed Hawk,16-23,0,0,0,0,NaN,NaN
12,1.000,Red Tailed Hawk,23-5,0,0,0,0,NaN,NaN
12,1.000,Dog,16-23,0,0,0,0,NaN,NaN
12,1.000,Dog,23-5,0,0,0,0,NaN,NaN
12,1.000,Human,16-23,0,0,0,0,NaN,NaN
12,1.000,Human,23-5,0,0,0,0,NaN,NaN
12,1.000,Wild Turkey,16-23,0,0,0,0,NaN,NaN
12,1.000,Wild Turkey,23-5,0,0,0,0,NaN,NaN
12,1.000,Clark Grebe,16-23,0,0,0,0,NaN,NaN
12,1.000,Clark Grebe,23-5,0,0,0,0,NaN,NaN
12,1.000,Seagull,16-23,0,0,0,0,NaN,NaN
12,1.000,Seagull,23-5,0,0,0,0,NaN,NaN
12,1.000,Surf Scoter,16-23,0,0,0,0,NaN,NaN
12,1.000,Surf Scoter,23-5,0,0,0,0,NaN,NaN
12,1.000,Pigeon,16-23,0,0,0,0,NaN,NaN
12,1.000,Pigeon,23-5,0,0,0,0,NaN,NaN
12,1.000,Pacific Ocean Water,16-23,0,0,0,0,NaN,NaN
12,1.000,Pacific Ocean Water,23-5,0,0,0,0,NaN,NaN
12,1.000,Cat,16-23,0,0,0,0,NaN,NaN
12,1.000,Cat,23-5,0,0,0,0,NaN,NaN
12,1.000,Horse,16-23,0,0,0,0,NaN,NaN
12,1.000,Horse,23-5,0,0,0,0,NaN,NaN
12,1.000,orangutan,16-23,0,0,0,0,NaN,NaN
12,1.000,orangutan,23-5,0,0,0,0,NaN,NaN
12,1.000,Bat,16-23,0,0,0,0,NaN,NaN
12,1.000,Bat,23-5,0,0,0,0,NaN,NaN
12,1.000,Deer,16-23,0,0,0,0,NaN,NaN
12,1.000,Deer,23-5,0,0,0,0,NaN,NaN
12,1.000,Great Horned Owl,16-23,0,0,0,0,NaN,NaN
12,1.000,Great Horned Owl,23-5,0,0,0,0,NaN,NaN
12,1.000,Freshwater Lagoon,16-23,0,0,0,0,NaN,NaN
12,1.000,Freshwater Lagoon,23-5,0,0,0,0,NaN,NaN
12,1.000,Unknown Avian,16-23,0,0,0,0,NaN,NaN
12,1.000,Unknown Avian,23-5,0,0,0,0,NaN,NaN
12,1.000,Human UTI,16-23,0,0,0,0,NaN,NaN
12,1.000,Human UTI,23-5,0,0,0,0,NaN,NaN
12,1.000,unknown,16-23,0,0,0,0,NaN,NaN
12,1.000,unknown,23-5,0,0,0,0,NaN,NaN
12,1.000,SLO Creek Water,16-23,0,0,0,0,NaN,NaN
12,1.000,SLO Creek Water,23-5,0,0,0,0,NaN,NaN
12,1.000,Pig/Swine,16-23,0,0,0,0,NaN,NaN
12,1.000,Pig/Swine,23-5,0,0,0,0,NaN,NaN
12,1.000,Klebsiella,16-23,0,0,0,0,NaN,NaN
12,1.000,Klebsiella,23-5,0,0,0,0,NaN,NaN
12,1.000,Hu Cw and Dg,16-23,0,0,0,0,NaN,NaN
12,1.000,Hu Cw and Dg,23-5,0,0,0,0,NaN,NaN
12,1.000,Ground Squirrel,16-23,0,0,0,0,NaN,NaN
12,1.000,Ground Squirrel,23-5,0,0,0,0,NaN,NaN
12,1.000,Opossum,16-23,0,0,0,0,NaN,NaN
12,1.000,Opossum,23-5,0,0,0,0,NaN,NaN
12,1.000,Cow,16-23,0,0,0,0,NaN,NaN
12,1.000,Cow,23-5,0,0,0,0,NaN,NaN
12,1.000,Deer Mouse,16-23,0,0,0,0,NaN,NaN
12,1.000,Deer Mouse,23-5,0,0,0,0,NaN,NaN
12,1.000,OVERALL,16-23,0,0,0,0,NaN,NaN
12,1.000,OVERALL,23-5,0,0,0,0,NaN,NaN
13,0.000,Chicken,16-23,0,0,0,0,NaN,NaN
13,0.000,Chicken,23-5,4,6,0,10,40.000,40.000
13,0.000,Sea Lion,16-23,0,0,0,0,NaN,NaN
13,0.000,Sea Lion,23-5,0,11,0,11,0.000,0.000
13,0.000,Hu and Cw,16-23,1,5,0,6,16.667,16.667
13,0.000,Hu and Cw,23-5,8,8,0,16,50.000,50.000
13,0.000,Sheep,16-23,44,52,0,96,45.833,45.833
13,0.000,Sheep,23-5,55,37,0,92,59.783,59.783
13,0.000,Hu and Dg,16-23,6,9,0,15,40.000,40.000
13,0.000,Hu and Dg,23-5,20,27,0,47,42.553,42.553
13,0.000,Common Loon,16-23,0,0,0,0,NaN,NaN
13,0.000,Common Loon,23-5,0,0,0,0,NaN,NaN
13,0.000,Red-Winged Blackbird,16-23,0,0,0,0,NaN,NaN
13,0.000,Red-Winged Blackbird,23-5,0,0,0,0,NaN,NaN
13,0.000,Cw,16-23,6,10,0,16,37.500,37.500
13,0.000,Cw,23-5,9,18,0,27,33.333,33.333
13,0.000,Cliff Sparrow,16-23,1,8,0,9,11.111,11.111
13,0.000,Cliff Sparrow,23-5,0,0,0,0,NaN,NaN
13,0.000,Pig,16-23,4,7,0,11,36.364,36.364
13,0.000,Pig,23-5,0,1,0,1,0.000,0.000
13,0.000,Barn Owl,16-23,0,0,0,0,NaN,NaN
13,0.000,Barn Owl,23-5,0,0,0,0,NaN,NaN
13,0.000,Wild Pig,16-23,0,0,0,0,NaN,NaN
13,0.000,Wild Pig,23-5,0,0,0,0,NaN,NaN
13,0.000,Pennington Creek Water,16-23,0,0,0,0,NaN,NaN
13,0.000,Pennington Creek Water,23-5,0,0,0,0,NaN,NaN
13,0.000,Guinni,16-23,0,0,0,0,NaN,NaN
13,0.000,Guinni,23-5,0,0,0,0,NaN,NaN
13,0.000,Racoon,16-23,0,0,0,0,NaN,NaN
13,0.000,Racoon,23-5,0,0,0,0,NaN,NaN
13,0.000,Hu,16-23,11,10,0,21,52.381,52.381
13,0.000,Hu,23-5,23,17,0,40,57.500,57.500
13,0.000,Cw and Dg,16-23,8,15,0,23,34.783,34.783
13,0.000,Cw and Dg,23-5,12,14,0,26,46.154,46.154
13,0.000,Red Wind Blackbird,16-23,0,0,0,0,NaN,NaN
13,0.000,Red Wind Blackbird,23-5,0,0,0,0,NaN,NaN
13,0.000,Tree Swallow,16-23,0,0,0,0,NaN,NaN
13,0.000,Tree Swallow,23-5,0,0,0,0,NaN,NaN
13,0.000,Turkey Vulture,16-23,0,0,0,0,NaN,NaN
13,0.000,Turkey Vulture,23-5,0,0,0,0,NaN,NaN
13,0.000,Dg,16-23,6,9,0,15,40.000,40.000
13,0.000,Dg,23-5,31,32,0,63,49.206,49.206
13,0.000,Western Kingbird,16-23,0,0,0,0,NaN,NaN
13,0.000,Western Kingbird,23-5,0,0,0,0,NaN,NaN
13,0.000,White Crowned Sparrow,16-23,0,0,0,0,NaN,NaN
13,0.000,White Crowned Sparrow,23-5,0,5,0,5,0.000,0.000
13,0.000,Eared Grebe,16-23,0,0,0,0,NaN,NaN
13,0.000,Eared Grebe,23-5,0,4,0,4,0.000,0.000
13,0.000,cougar,16-23,0,0,0,0,NaN,NaN
13,0.000,cougar,23-5,0,0,0,0,NaN,NaN
13,0.000,Ocean Water,16-23,0,0,0,0,NaN,NaN
13,0.000,Ocean Water,23-5,0,0,0,0,NaN,NaN
13,0.000,Red Tailed Hawk,16-23,0,0,0,0,NaN,NaN
13,0.000,Red Tailed Hawk,23-5,0,2,0,2,0.000,0.000
13,0.000,Dog,16-23,53,67,0,120,44.167,44.167
13,0.000,Dog,23-5,82,139,0,221,37.104,37.104
13,0.000,Human,16-23,1722,837,0,2559,67.292,67.292
13,0.000,Human,23-5,2140,732,0,2872,74.513,74.513
13,0.000,Wild Turkey,16-23,1,2,0,3,33.333,33.333
13,0.000,Wild Turkey,23-5,0,6,0,6,0.000,0.000
13,0.000,Clark Grebe,16-23,0,0,0,0,NaN,NaN
13,0.000,Clark Grebe,23-5,0,0,0,0,NaN,NaN
13,0.000,Seagull,16-23,0,0,0,0,NaN,NaN
13,0.000,Seagull,23-5,4,8,0,12,33.333,33.333
13,0.000,Surf Scoter,16-23,0,0,0,0,NaN,NaN
13,0.000,Surf Scoter,23-5,0,0,0,0,NaN,NaN
13,0.000,Pigeon,16-23,27,134,0,161,16.770,16.770
13,0.000,Pigeon,23-5,69,134,0,203,33.990,33.990
13,0.000,Pacific Ocean Water,16-23,0,0,0,0,NaN,NaN
13,0.000,Pacific Ocean Water,23-5,0,0,0,0,NaN,NaN
13,0.000,Cat,16-23,17,19,0,36,47.222,47.222
13,0.000,Cat,23-5,17,19,0,36,47.222,47.222
13,0.000,Horse,16-23,6,14,0,20,30.000,30.000
13,0.000,Horse,23-5,22,86,0,108,20.370,20.370
13,0.000,orangutan,16-23,0,0,0,0,NaN,NaN
13,0.000,orangutan,23-5,0,0,0,0,NaN,NaN
13,0.000,Bat,16-23,36,35,0,71,50.704,50.704
13,0.000,Bat,23-5,37,36,0,73,50.685,50.685
13,0.000,Deer,16-23,11,38,0,49,22.449,22.449
13,0.000,Deer,23-5,17,125,0,142,11.972,11.972
13,0.000,Great Horned Owl,16-23,0,0,0,0,NaN,NaN
13,0.000,Great Horned Owl,23-5,0,1,0,1,0.000,0.000
13,0.000,Freshwater Lagoon,16-23,0,0,0,0,NaN,NaN
13,0.000,Freshwater Lagoon,23-5,0,0,0,0,NaN,NaN
13,0.000,Unknown Avian,16-23,0,0,0,0,NaN,NaN
13,0.000,Unknown Avian,23-5,0,0,0,0,NaN,NaN
13,0.000,Human UTI,16-23,74,73,0,147,50.340,50.340
13,0.000,Human UTI,23-5,98,113,0,211,46.445,46.445
13,0.000,unknown,16-23,0,0,0,0,NaN,NaN
13,0.000,unknown,23-5,0,2,0,2,0.000,0.000
13,0.000,SLO Creek Water,16-23,0,0,0,0,NaN,NaN
13,0.000,SLO Creek Water,23-5,0,0,0,0,NaN,NaN
13,0.000,Pig/Swine,16-23,4,5,0,9,44.444,44.444
13,0.000,Pig/Swine,23-5,8,11,0,19,42.105,42.105
13,0.000,Klebsiella,16-23,0,0,0,0,NaN,NaN
13,0.000,Klebsiella,23-5,0,0,0,0,NaN,NaN
13,0.000,Hu Cw and Dg,16-23,5,8,0,13,38.462,38.462
13,0.000,Hu Cw and Dg,23-5,6,10,0,16,37.500,37.500
13,0.000,Ground Squirrel,16-23,76,49,0,125,60.800,60.800
13,0.000,Ground Squirrel,23-5,81,70,0,151,53.642,53.642
13,0.000,Opossum,16-23,0,0,0,0,NaN,NaN
13,0.000,Opossum,23-5,0,0,0,0,NaN,NaN
13,0.000,Cow,16-23,1563,1260,0,2823,55.367,55.367
13,0.000,Cow,23-5,1543,1650,0,3193,48.324,48.324
13,0.000,Deer Mouse,16-23,0,0,0,0,NaN,NaN
13,0.000,Deer Mouse,23-5,0,0,0,0,NaN,NaN
13,0.000,OVERALL,16-23,3682,2666,0,6348,58.003,58.003
13,0.000,OVERALL,23-5,4286,3324,0,7610,56.321,56.321
13,0.500,Chicken,16-23,0,0,0,0,NaN,NaN
13,0.500,Chicken,23-5,4,6,0,10,40.000,40.000
13,0.500,Sea Lion,16-23,0,0,0,0,NaN,NaN
13,0.500,Sea Lion,23-5,0,11,0,11,0.000,0.000
13,0.500,Hu and Cw,16-23,1,5,0,6,16.667,16.667
13,0.500,Hu and Cw,23-5,8,8,0,16,50.000,50.000
13,0.500,Sheep,16-23,44,52,0,96,45.833,45.833
13,0.500,Sheep,23-5,55,37,0,92,59.783,59.783
13,0.500,Hu and Dg,16-23,6,9,0,15,40.000,40.000
13,0.500,Hu and Dg,23-5,20,27,0,47,42.553,42.553
13,0.500,Common Loon,16-23,0,0,0,0,NaN,NaN
13,0.500,Common Loon,23-5,0,0,0,0,NaN,NaN
13,0.500,Red-Winged Blackbird,16-23,0,0,0,0,NaN,NaN
13,0.500,Red-Winged Blackbird,23-5,0,0,0,0,NaN,NaN
13,0.500,Cw,16-23,6,10,0,16,37.500,37.500
13,0.500,Cw,23-5,9,18,0,27,33.333,33.333
13,0.500,Cliff Sparrow,16-23,1,8,0,9,11.111,11.111
13,0.500,Cliff Sparrow,23-5,0,0,0,0,NaN,NaN
13,0.500,Pig,16-23,4,7,0,11,36.364,36.364
13,0.500,Pig,23-5,0,1,0,1,0.000,0.000
13,0.500,Barn Owl,16-23,0,0,0,0,NaN,NaN
13,0.500,Barn Owl,23-5,0,0,0,0,NaN,NaN
13,0.500,Wild Pig,16-23,0,0,0,0,NaN,NaN
13,0.500,Wild Pig,23-5,0,0,0,0,NaN,NaN
13,0.500,Pennington Creek Water,16-23,0,0,0,0,NaN,NaN
13,0.500,Pennington Creek Water,23-5,0,0,0,0,NaN,NaN
13,0.500,Guinni,16-23,0,0,0,0,NaN,NaN
13,0.500,Guinni,23-5,0,0,0,0,NaN,NaN
13,0.500,Racoon,16-23,0,0,0,0,NaN,NaN
13,0.500,Racoon,23-5,0,0,0,0,NaN,NaN
13,0.500,Hu,16-23,11,10,0,21,52.381,52.381
13,0.500,Hu,23-5,23,17,0,40,57.500,57.500
13,0.500,Cw and Dg,16-23,8,15,0,23,34.783,34.783
13,0.500,Cw and Dg,23-5,12,14,0,26,46.154,46.154
13,0.500,Red Wind Blackbird,16-23,0,0,0,0,NaN,NaN
13,0.500,Red Wind Blackbird,23-5,0,0,0,0,NaN,NaN
13,0.500,Tree Swallow,16-23,0,0,0,0,NaN,NaN
13,0.500,Tree Swallow,23-5,0,0,0,0,NaN,NaN
13,0.500,Turkey Vulture,16-23,0,0,0,0,NaN,NaN
13,0.500,Turkey Vulture,23-5,0,0,0,0,NaN,NaN
13,0.500,Dg,16-23,6,9,0,15,40.000,40.000
13,0.500,Dg,23-5,31,32,0,63,49.206,49.206
13,0.500,Western Kingbird,16-23,0,0,0,0,NaN,NaN
13,0.500,Western Kingbird,23-5,0,0,0,0,NaN,NaN
13,0.500,White Crowned Sparrow,16-23,0,0,0,0,NaN,NaN
13,0.500,White Crowned Sparrow,23-5,0,5,0,5,0.000,0.000
13,0.500,Eared Grebe,16-23,0,0,0,0,NaN,NaN
13,0.500,Eared Grebe,23-5,0,4,0,4,0.000,0.000
13,0.500,cougar,16-23,0,0,0,0,NaN,NaN
13,0.500,cougar,23-5,0,0,0,0,NaN,NaN
13,0.500,Ocean Water,16-23,0,0,0,0,NaN,NaN
13,0.500,Ocean Water,23-5,0,0,0,0,NaN,NaN
13,0.500,Red Tailed Hawk,16-23,0,0,0,0,NaN,NaN
13,0.500,Red Tailed Hawk,23-5,0,2,0,2,0.000,0.000
13,0.500,Dog,16-23,53,67,0,120,44.167,44.167
13,0.500,Dog,23-5,82,139,0,221,37.104,37.104
13,0.500,Human,16-23,1722,837,0,2559,67.292,67.292
13,0.500,Human,23-5,2140,732,0,2872,74.513,74.513
13,0.500,Wild Turkey,16-23,1,2,0,3,33.333,33.333
13,0.500,Wild Turkey,23-5,0,6,0,6,0.000,0.000
13,0.500,Clark Grebe,16-23,0,0,0,0,NaN,NaN
13,0.500,Clark Grebe,23-5,0,0,0,0,NaN,NaN
13,0.500,Seagull,16-23,0,0,0,0,NaN,NaN
13,0.500,Seagull,23-5,4,8,0,12,33.333,33.333
13,0.500,Surf Scoter,16-23,0,0,0,0,NaN,NaN
13,0.500,Surf Scoter,23-5,0,0,0,0,NaN,NaN
13,0.500,Pigeon,16-23,27,134,0,161,16.770,16.770
13,0.500,Pigeon,23-5,69,134,0,203,33.990,33.990
13,0.500,Pacific Ocean Water,16-23,0,0,0,0,NaN,NaN
13,0.500,Pacific Ocean Water,23-5,0,0,0,0,NaN,NaN
13,0.500,Cat,16-23,17,19,0,36,47.222,47.222
13,0.500,Cat,23-5,17,19,0,36,47.222,47.222
13,0.500,Horse,16-23,6,14,0,20,30.000,30.000
13,0.500,Horse,23-5,22,86,0,108,20.370,20.370
13,0.500,orangutan,16-23,0,0,0,0,NaN,NaN
13,0.500,orangutan,23-5,0,0,0,0,NaN,NaN
13,0.500,Bat,16-23,36,35,0,71,50.704,50.704
13,0.500,Bat,23-5,37,36,0,73,50.685,50.685
13,0.500,Deer,16-23,11,38,0,49,22.449,22.449
13,0.500,Deer,23-5,17,125,0,142,11.972,11.972
13,0.500,Great Horned Owl,16-23,0,0,0,0,NaN,NaN
13,0.500,Great Horned Owl,23-5,0,1,0,1,0.000,0.000
13,0.500,Freshwater Lagoon,16-23,0,0,0,0,NaN,NaN
13,0.500,Freshwater Lagoon,23-5,0,0,0,0,NaN,NaN
13,0.500,Unknown Avian,16-23,0,0,0,0,NaN,NaN
13,0.500,Unknown Avian,23-5,0,0,0,0,NaN,NaN
13,0.500,Human UTI,16-23,74,73,0,147,50.340,50.340
13,0.500,Human UTI,23-5,98,113,0,211,46.445,46.445
13,0.500,unknown,16-23,0,0,0,0,NaN,NaN
13,0.500,unknown,23-5,0,2,0,2,0.000,0.000
13,0.500,SLO Creek Water,16-23,0,0,0,0,NaN,NaN
13,0.500,SLO Creek Water,23-5,0,0,0,0,NaN,NaN
13,0.500,Pig/Swine,16-23,4,5,0,9,44.444,44.444
13,0.500,Pig/Swine,23-5,8,11,0,19,42.105,42.105
13,0.500,Klebsiella,16-23,0,0,0,0,NaN,NaN
13,0.500,Klebsiella,23-5,0,0,0,0,NaN,NaN
13,0.500,Hu Cw and Dg,16-23,5,8,0,13,38.462,38.462
13,0.500,Hu Cw and Dg,23-5,6,10,0,16,37.500,37.500
13,0.500,Ground Squirrel,16-23,76,49,0,125,60.800,60.800
13,0.500,Ground Squirrel,23-5,81,70,0,151,53.642,53.642
13,0.500,Opossum,16-23,0,0,0,0,NaN,NaN
13,0.500,Opossum,23-5,0,0,0,0,NaN,NaN
13,0.500,Cow,16-23,1563,1260,0,2823,55.367,55.367
13,0.500,Cow,23-5,1543,1650,0,3193,48.324,48.324
13,0.500,Deer Mouse,16-23,0,0,0,0,NaN,NaN
13,0.500,Deer Mouse,23-5,0,0,0,0,NaN,NaN
13,0.500,OVERALL,16-23,3682,2666,0,6348,58.003,58.003
13,0.500,OVERALL,23-5,4286,3324,0,7610,56.321,56.321
13,0.900,Chicken,16-23,0,0,0,0,NaN,NaN
13,0.900,Chicken,23-5,4,6,0,10,40.000,40.000
13,0.900,Sea Lion,16-23,0,0,0,0,NaN,NaN
13,0.900,Sea Lion,23-5,0,11,0,11,0.000,0.000
13,0.900,Hu and Cw,16-23,1,5,0,6,16.667,16.667
13,0.900,Hu and Cw,23-5,8,8,0,16,50.000,50.000
13,0.900,Sheep,16-23,44,52,0,96,45.833,45.833
13,0.900,Sheep,23-5,55,37,0,92,59.783,59.783
13,0.900,Hu and Dg,16-23,6,9,0,15,40.000,40.000
13,0.900,Hu and Dg,23-5,20,27,0,47,42.553,42.553
13,0.900,Common Loon,16-23,0,0,0,0,NaN,NaN
13,0.900,Common Loon,23-5,0,0,0,0,NaN,NaN
13,0.900,Red-Winged Blackbird,16-23,0,0,0,0,NaN,NaN
13,0.900,Red-Winged Blackbird,23-5,0,0,0,0,NaN,NaN
13,0.900,Cw,16-23,6,10,0,16,37.500,37.500
13,0.900,Cw,23-5,9,18,0,27,33.333,33.333
13,0.900,Cliff Sparrow,16-23,1,8,0,9,11.111,11.111
13,0.900,Cliff Sparrow,23-5,0,0,0,0,NaN,NaN
13,0.900,Pig,16-23,4,7,0,11,36.364,36.364
13,0.900,Pig,23-5,0,1,0,1,0.000,0.000
13,0.900,Barn Owl,16-23,0,0,0,0,NaN,NaN
13,0.900,Barn Owl,23-5,0,0,0,0,NaN,NaN
13,0.900,Wild Pig,16-23,0,0,0,0,NaN,NaN
13,0.900,Wild Pig,23-5,0,0,0,0,NaN,NaN
13,0.900,Pennington Creek Water,16-23,0,0,0,0,NaN,NaN
13,0.900,Pennington Creek Water,23-5,0,0,0,0,NaN,NaN
13,0.900,Guinni,16-23,0,0,0,0,NaN,NaN
13,0.900,Guinni,23-5,0,0,0,0,NaN,NaN
13,0.900,Racoon,16-23,0,0,0,0,NaN,NaN
13,0.900,Racoon,23-5,0,0,0,0,NaN,NaN
13,0.900,Hu,16-23,11,10,0,21,52.381,52.381
13,0.900,Hu,23-5,23,17,0,40,57.500,57.500
13,0.900,Cw and Dg,16-23,8,15,0,23,34.783,34.783
13,0.900,Cw and Dg,23-5,12,14,0,26,46.154,46.154
13,0.900,Red Wind Blackbird,16-23,0,0,0,0,NaN,NaN
13,0.900,Red Wind Blackbird,23-5,0,0,0,0,NaN,NaN
13,0.900,Tree Swallow,16-23,0,0,0,0,NaN,NaN
13,0.900,Tree Swallow,23-5,0,0,0,0,NaN,NaN
13,0.900,Turkey Vulture,16-23,0,0,0,0,NaN,NaN
13,0.900,Turkey Vulture,23-5,0,0,0,0,NaN,NaN
13,0.900,Dg,16-23,6,9,0,15,40.000,40.000
13,0.900,Dg,23-5,31,32,0,63,49.206,49.206
13,0.900,Western Kingbird,16-23,0,0,0,0,NaN,NaN
13,0.900,Western Kingbird,23-5,0,0,0,0,NaN,NaN
13,0.900,White Crowned Sparrow,16-23,0,0,0,0,NaN,NaN
13,0.900,White Crowned Sparrow,23-5,0,5,0,5,0.000,0.000
13,0.900,Eared Grebe,16-23,0,0,0,0,NaN,NaN
13,0.900,Eared Grebe,23-5,0,4,0,4,0.000,0.000
13,0.900,cougar,16-23,0,0,0,0,NaN,NaN
13,0.900,cougar,23-5,0,0,0,0,NaN,NaN
13,0.900,Ocean Water,16-23,0,0,0,0,NaN,NaN
13,0.900,Ocean Water,23-5,0,0,0,0,NaN,NaN
13,0.900,Red Tailed Hawk,16-23,0,0,0,0,NaN,NaN
13,0.900,Red Tailed Hawk,23-5,0,2,0,2,0.000,0.000
13,0.900,Dog,16-23,53,67,0,120,44.167,44.167
13,0.900,Dog,23-5,82,135,0,217,37.788,37.788
13,0.900,Human,16-23,1722,836,0,2558,67.318,67.318
13,0.900,Human,23-5,2140,727,0,2867,74.642,74.642
13,0.900,Wild Turkey,16-23,1,2,0,3,33.333,33.333
13,0.900,Wild Turkey,23-5,0,6,0,6,0.000,0.000
13,0.900,Clark Grebe,16-23,0,0,0,0,NaN,NaN
13,0.900,Clark Grebe,23-5,0,0,0,0,NaN,NaN
13,0.900,Seagull,16-23,0,0,0,0,NaN,NaN
13,0.900,Seagull,23-5,4,9,0,13,30.769,30.769
13,0.900,Surf Scoter,16-23,0,0,0,0,NaN,NaN
13,0.900,Surf Scoter,23-5,0,0,0,0,NaN,NaN
13,0.900,Pigeon,16-23,27,135,0,162,16.667,16.667
13,0.900,Pigeon,23-5,69,134,0,203,33.990,33.990
13,0.900,Pacific Ocean Water,16-23,0,0,0,0,NaN,NaN
13,0.900,Pacific Ocean Water,23-5,0,0,0,0,NaN,NaN
13,0.900,Cat,16-23,17,19,0,36,47.222,47.222
13,0.900,Cat,23-5,17,19,0,36,47.222,47.222
13,0.900,Horse,16-23,6,14,0,20,30.000,30.000
13,0.900,Horse,23-5,22,86,0,108,20.370,20.370
13,0.900,orangutan,16-23,0,0,0,0,NaN,NaN
13,0.900,orangutan,23-5,0,0,0,0,NaN,NaN
13,0.900,Bat,16-23,36,35,0,71,50.704,50.704
13,0.900,Bat,23-5,37,36,0,73,50.685,50.685
13,0.900,Deer,16-23,11,38,0,49,22.449,22.449
13,0.900,Deer,23-5,17,125,0,142,11.972,11.972
13,0.900,Great Horned Owl,16-23,0,0,0,0,NaN,NaN
13,0.900,Great Horned Owl,23-5,0,1,0,1,0.000,0.000
13,0.900,Freshwater Lagoon,16-23,0,0,0,0,NaN,NaN
13,0.900,Freshwater Lagoon,23-5,0,0,0,0,NaN,NaN
13,0.900,Unknown Avian,16-23,0,0,0,0,NaN,NaN
13,0.900,Unknown Avian,23-5,0,0,0,0,NaN,NaN
13,0.900,Human UTI,16-23,74,73,0,147,50.340,50.340
13,0.900,Human UTI,23-5,101,113,0,214,47.196,47.196
13,0.900,unknown,16-23,0,0,0,0,NaN,NaN
13,0.900,unknown,23-5,0,2,0,2,0.000,0.000
13,0.900,SLO Creek Water,16-23,0,0,0,0,NaN,NaN
13,0.900,SLO Creek Water,23-5,0,0,0,0,NaN,NaN
13,0.900,Pig/Swine,16-23,4,5,0,9,44.444,44.444
13,0.900,Pig/Swine,23-5,8,11,0,19,42.105,42.105
13,0.900,Klebsiella,16-23,0,0,0,0,NaN,NaN
13,0.900,Klebsiella,23-5,0,0,0,0,NaN,NaN
13,0.900,Hu Cw and Dg,16-23,5,8,0,13,38.462,38.462
13,0.900,Hu Cw and Dg,23-5,6,10,0,16,37.500,37.500
13,0.900,Ground Squirrel,16-23,76,49,0,125,60.800,60.800
13,0.900,Ground Squirrel,23-5,81,70,0,151,53.642,53.642
13,0.900,Opossum,16-23,0,0,0,0,NaN,NaN
13,0.900,Opossum,23-5,0,0,0,0,NaN,NaN
13,0.900,Cow,16-23,1563,1256,0,2819,55.445,55.445
13,0.900,Cow,23-5,1543,1647,0,3190,48.370,48.370
13,0.900,Deer Mouse,16-23,0,0,0,0,NaN,NaN
13,0.900,Deer Mouse,23-5,0,0,0,0,NaN,NaN
13,0.900,OVERALL,16-23,3682,2662,0,6344,58.039,58.039
13,0.900,OVERALL,23-5,4289,3313,0,7602,56.419,56.419
13,0.950,Chicken,16-23,0,0,0,0,NaN,NaN
13,0.950,Chicken,23-5,4,6,0,10,40.000,40.000
13,0.950,Sea Lion,16-23,0,0,0,0,NaN,NaN
13,0.950,Sea Lion,23-5,0,11,0,11,0.000,0.000
13,0.950,Hu and Cw,16-23,1,5,0,6,16.667,16.667
13,0.950,Hu and Cw,23-5,8,8,0,16,50.000,50.000
13,0.950,Sheep,16-23,44,52,0,96,45.833,45.833
13,0.950,Sheep,23-5,55,37,0,92,59.783,59.783
13,0.950,Hu and Dg,16-23,6,9,0,15,40.000,40.000
13,0.950,Hu and Dg,23-5,20,27,0,47,42.553,42.553
13,0.950,Common Loon,16-23,0,0,0,0,NaN,NaN
13,0.950,Common Loon,23-5,0,0,0,0,NaN,NaN
13,0.950,Red-Winged Blackbird,16-23,0,0,0,0,NaN,NaN
13,0.950,Red-Winged Blackbird,23-5,0,0,0,0,NaN,NaN
13,0.950,Cw,16-23,6,10,0,16,37.500,37.500
13,0.950,Cw,23-5,9,18,0,27,33.333,33.333
13,0.950,Cliff Sparrow,16-23,1,8,0,9,11.111,11.111
13,0.950,Cliff Sparrow,23-5,0,0,0,0,NaN,NaN
13,0.950,Pig,16-23,4,7,0,11,36.364,36.364
13,0.950,Pig,23-5,0,1,0,1,0.000,0.000
13,0.950,Barn Owl,16-23,0,0,0,0,NaN,NaN
13,0.950,Barn Owl,23-5,0,0,0,0,NaN,NaN
13,0.950,Wild Pig,16-23,0,0,0,0,NaN,NaN
13,0.950,Wild Pig,23-5,0,0,0,0,NaN,NaN
13,0.950,Pennington Creek Water,16-23,0,0,0,0,NaN,NaN
13,0.950,Pennington Creek Water,23-5,0,0,0,0,NaN,NaN
13,0.950,Guinni,16-23,0,0,0,0,NaN,NaN
13,0.950,Guinni,23-5,0,0,0,0,NaN,NaN
13,0.950,Racoon,16-23,0,0,0,0,NaN,NaN
13,0.950,Racoon,23-5,0,0,0,0,NaN,NaN
13,0.950,Hu,16-23,11,10,0,21,52.381,52.381
13,0.950,Hu,23-5,23,17,0,40,57.500,57.500
13,0.950,Cw and Dg,16-23,8,15,0,23,34.783,34.783
13,0.950,Cw and Dg,23-5,12,14,0,26,46.154,46.154
13,0.950,Red Wind Blackbird,16-23,0,0,0,0,NaN,NaN
13,0.950,Red Wind Blackbird,23-5,0,0,0,0,NaN,NaN
13,0.950,Tree Swallow,16-23,0,0,0,0,NaN,NaN
13,0.950,Tree Swallow,23-5,0,0,0,0,NaN,NaN
13,0.950,Turkey Vulture,16-23,0,0,0,0,NaN,NaN
13,0.950,Turkey Vulture,23-5,0,0,0,0,NaN,NaN
13,0.950,Dg,16-23,6,9,0,15,40.000,40.000
13,0.950,Dg,23-5,31,32,0,63,49.206,49.206
13,0.950,Western Kingbird,16-23,0,0,0,0,NaN,NaN
13,0.950,Western Kingbird,23-5,0,0,0,0,NaN,NaN
13,0.950,White Crowned Sparrow,16-23,0,0,0,0,NaN,NaN
13,0.950,White Crowned Sparrow,23-5,0,5,0,5,0.000,0.000
13,0.950,Eared Grebe,16-23,0,0,0,0,NaN,NaN
13,0.950,Eared Grebe,23-5,0,4,0,4,0.000,0.000
13,0.950,cougar,16-23,0,0,0,0,NaN,NaN
13,0.950,cougar,23-5,0,0,0,0,NaN,NaN
13,0.950,Ocean Water,16-23,0,0,0,0,NaN,NaN
13,0.950,Ocean Water,23-5,0,0,0,0,NaN,NaN
13,0.950,Red Tailed Hawk,16-23,0,0,0,0,NaN,NaN
13,0.950,Red Tailed Hawk,23-5,0,2,0,2,0.000,0.000
13,0.950,Dog,16-23,53,67,0,120,44.167,44.167
13,0.950,Dog,23-5,82,133,0,215,38.140,38.140
13,0.950,Human,16-23,1722,834,0,2556,67.371,67.371
13,0.950,Human,23-5,2134,719,0,2853,74.798,74.798
13,0.950,Wild Turkey,16-23,1,2,0,3,33.333,33.333
13,0.950,Wild Turkey,23-5,0,5,0,5,0.000,0.000
13,0.950,Clark Grebe,16-23,0,0,0,0,NaN,NaN
13,0.950,Clark Grebe,23-5,0,0,0,0,NaN,NaN
13,0.950,Seagull,16-23,0,0,0,0,NaN,NaN
13,0.950,Seagull,23-5,4,8,0,12,33.333,33.333
13,0.950,Surf Scoter,16-23,0,0,0,0,NaN,NaN
13,0.950,Surf Scoter,23-5,0,0,0,0,NaN,NaN
13,0.950,Pigeon,16-23,28,134,0,162,17.284,17.284
13,0.950,Pigeon,23-5,69,135,0,204,33.824,33.824
13,0.950,Pacific Ocean Water,16-23,0,0,0,0,NaN,NaN
13,0.950,Pacific Ocean Water,23-5,0,0,0,0,NaN,NaN
13,0.950,Cat,16-23,17,19,0,36,47.222,47.222
13,0.950,Cat,23-5,17,25,0,42,40.476,40.476
13,0.950,Horse,16-23,6,14,0,20,30.000,30.000
13,0.950,Horse,23-5,22,86,0,108,20.370,20.370
13,0.950,orangutan,16-23,0,0,0,0,NaN,NaN
13,0.950,orangutan,23-5,0,0,0,0,NaN,NaN
13,0.950,Bat,16-23,36,35,0,71,50.704,50.704
13,0.950,Bat,23-5,37,35,0,72,51.389,51.389
13,0.950,Deer,16-23,11,38,0,49,22.449,22.449
13,0.950,Deer,23-5,17,125,0,142,11.972,11.972
13,0.950,Great Horned Owl,16-23,0,0,0,0,NaN,NaN
13,0.950,Great Horned Owl,23-5,0,1,0,1,0.000,0.000
13,0.950,Freshwater Lagoon,16-23,0,0,0,0,NaN,NaN
13,0.950,Freshwater Lagoon,23-5,0,0,0,0,NaN,NaN
13,0.950,Unknown Avian,16-23,0,0,0,0,NaN,NaN
13,0.950,Unknown Avian,23-5,0,0,0,0,NaN,NaN
13,0.950,Human UTI,16-23,77,74,0,151,50.993,50.993
13,0.950,Human UTI,23-5,100,116,0,216,46.296,46.296
13,0.950,unknown,16-23,0,0,0,0,NaN,NaN
13,0.950,unknown,23-5,0,2,0,2,0.000,0.000
13,0.950,SLO Creek Water,16-23,0,0,0,0,NaN,NaN
13,0.950,SLO Creek Water,23-5,0,0,0,0,NaN,NaN
13,0.950,Pig/Swine,16-23,4,5,0,9,44.444,44.444
13,0.950,Pig/Swine,23-5,8,11,0,19,42.105,42.105
13,0.950,Klebsiella,16-23,0,0,0,0,NaN,NaN
13,0.950,Klebsiella,23-5,0,0,0,0,NaN,NaN
13,0.950,Hu Cw and Dg,16-23,5,8,0,13,38.462,38.462
13,0.950,Hu Cw and Dg,23-5,6,10,0,16,37.500,37.500
13,0.950,Ground Squirrel,16-23,76,49,0,125,60.800,60.800
13,0.950,Ground Squirrel,23-5,81,69,0,150,54.000,54.000
13,0.950,Opossum,16-23,0,0,0,0,NaN,NaN
13,0.950,Opossum,23-5,0,0,0,0,NaN,NaN
13,0.950,Cow,16-23,1564,1236,0,2800,55.857,55.857
13,0.950,Cow,23-5,1542,1645,0,3187,48.384,48.384
13,0.950,Deer Mouse,16-23,0,0,0,0,NaN,NaN
13,0.950,Deer Mouse,23-5,0,0,0,0,NaN,NaN
13,0.950,OVERALL,16-23,3687,2640,0,6327,58.274,58.274
13,0.950,OVERALL,23-5,4281,3307,0,7588,56.418,56.418
13,0.960,Chicken,16-23,0,0,0,0,NaN,NaN
13,0.960,Chicken,23-5,4,6,0,10,40.000,40.000
13,0.960,Sea Lion,16-23,0,0,0,0,NaN,NaN
13,0.960,Sea Lion,23-5,0,11,0,11,0.000,0.000
13,0.960,Hu and Cw,16-23,1,5,0,6,16.667,16.667
13,0.960,Hu and Cw,23-5,8,8,0,16,50.000,50.000
13,0.960,Sheep,16-23,44,52,0,96,45.833,45.833
13,0.960,Sheep,23-5,55,38,0,93,59.140,59.140
13,0.960,Hu and Dg,16-23,6,9,0,15,40.000,40.000
13,0.960,Hu and Dg,23-5,20,27,0,47,42.553,42.553
13,0.960,Common Loon,16-23,0,0,0,0,NaN,NaN
13,0.960,Common Loon,23-5,0,0,0,0,NaN,NaN
13,0.960,Red-Winged Blackbird,16-23,0,0,0,0,NaN,NaN
13,0.960,Red-Winged Blackbird,23-5,0,0,0,0,NaN,NaN
13,0.960,Cw,16-23,6,10,0,16,37.500,37.500
13,0.960,Cw,23-5,9,18,0,27,33.333,33.333
13,0.960,Cliff Sparrow,16-23,1,8,0,9,11.111,11.111
13,0.960,Cliff Sparrow,23-5,0,0,0,0,NaN,NaN
13,0.960,Pig,16-23,4,7,0,11,36.364,36.364
13,0.960,Pig,23-5,0,1,0,1,0.000,0.000
13,0.960,Barn Owl,16-23,0,0,0,0,NaN,NaN
13,0.960,Barn Owl,23-5,0,0,0,0,NaN,NaN
13,0.960,Wild Pig,16-23,0,0,0,0,NaN,NaN
13,0.960,Wild Pig,23-5,1,0,0,1,100.000,100.000
13,0.960,Pennington Creek Water,16-23,0,0,0,0,NaN,NaN
13,0.960,Pennington Creek Water,23-5,0,0,0,0,NaN,NaN
13,0.960,Guinni,16-23,0,0,0,0,NaN,NaN
13,0.960,Guinni,23-5,0,0,0,0,NaN,NaN
13,0.960,Racoon,16-23,0,0,0,0,NaN,NaN
13,0.960,Racoon,23-5,0,0,0,0,NaN,NaN
13,0.960,Hu,16-23,11,10,0,21,52.381,52.381
13,0.960,Hu,23-5,23,17,0,40,57.500,57.500
13,0.960,Cw and Dg,16-23,8,15,0,23,34.783,34.783
13,0.960,Cw and Dg,23-5,12,14,0,26,46.154,46.154
13,0.960,Red Wind Blackbird,16-23,0,0,0,0,NaN,NaN
13,0.960,Red Wind Blackbird,23-5,0,0,0,0,NaN,NaN
13,0.960,Tree Swallow,16-23,0,0,0,0,NaN,NaN
13,0.960,Tree Swallow,23-5,0,0,0,0,NaN,NaN
13,0.960,Turkey Vulture,16-23,0,0,0,0,NaN,NaN
13,0.960,Turkey Vulture,23-5,0,0,0,0,NaN,NaN
13,0.960,Dg,16-23,6,9,0,15,40.000,40.000
13,0.960,Dg,23-5,31,32,0,63,49.206,49.206
13,0.960,Western Kingbird,16-23,0,0,0,0,NaN,NaN
13,0.960,Western Kingbird,23-5,0,0,0,0,NaN,NaN
13,0.960,White Crowned Sparrow,16-23,0,0,0,0,NaN,NaN
13,0.960,White Crowned Sparrow,23-5,0,5,0,5,0.000,0.000
13,0.960,Eared Grebe,16-23,0,0,0,0,NaN,NaN
13,0.960,Eared Grebe,23-5,0,4,0,4,0.000,0.000
13,0.960,cougar,16-23,0,0,0,0,NaN,NaN
13,0.960,cougar,23-5,0,0,0,0,NaN,NaN
13,0.960,Ocean Water,16-23,0,0,0,0,NaN,NaN
13,0.960,Ocean Water,23-5,0,0,0,0,NaN,NaN
13,0.960,Red Tailed Hawk,16-23,0,0,0,0,NaN,NaN
13,0.960,Red Tailed Hawk,23-5,0,2,0,2,0.000,0.000
13,0.960,Dog,16-23,53,67,0,120,44.167,44.167
13,0.960,Dog,23-5,82,129,0,211,38.863,38.863
13,0.960,Human,16-23,1723,833,0,2556,67.410,67.410
13,0.960,Human,23-5,2139,704,0,2843,75.237,75.237
13,0.960,Wild Turkey,16-23,1,2,0,3,33.333,33.333
13,0.960,Wild Turkey,23-5,0,10,0,10,0.000,0.000
13,0.960,Clark Grebe,16-23,0,0,0,0,NaN,NaN
13,0.960,Clark Grebe,23-5,0,0,0,0,NaN,NaN
13,0.960,Seagull,16-23,0,0,0,0,NaN,NaN
13,0.960,Seagull,23-5,4,9,0,13,30.769,30.769
13,0.960,Surf Scoter,16-23,0,0,0,0,NaN,NaN
13,0.960,Surf Scoter,23-5,0,2,0,2,0.000,0.000
13,0.960,Pigeon,16-23,28,134,0,162,17.284,17.284
13,0.960,Pigeon,23-5,70,151,0,221,31.674,31.674
13,0.960,Pacific Ocean Water,16-23,0,0,0,0,NaN,NaN
13,0.960,Pacific Ocean Water,23-5,0,0,0,0,NaN,NaN
13,0.960,Cat,16-23,17,19,0,36,47.222,47.222
13,0.960,Cat,23-5,17,26,0,43,39.535,39.535
13,0.960,Horse,16-23,6,14,0,20,30.000,30.000
13,0.960,Horse,23-5,22,86,0,108,20.370,20.370
13,0.960,orangutan,16-23,0,0,0,0,NaN,NaN
13,0.960,orangutan,23-5,0,0,0,0,NaN,NaN
13,0.960,Bat,16-23,36,35,0,71,50.704,50.704
13,0.960,Bat,23-5,37,35,0,72,51.389,51.389
13,0.960,Deer,16-23,11,38,0,49,22.449,22.449
13,0.960,Deer,23-5,17,125,0,142,11.972,11.972
13,0.960,Great Horned Owl,16-23,0,0,0,0,NaN,NaN
13,0.960,Great Horned Owl,23-5,0,1,0,1,0.000,0.000
13,0.960,Freshwater Lagoon,16-23,0,0,0,0,NaN,NaN
13,0.960,Freshwater Lagoon,23-5,0,0,0,0,NaN,NaN
13,0.960,Unknown Avian,16-23,0,0,0,0,NaN,NaN
13,0.960,Unknown Avian,23-5,0,0,0,0,NaN,NaN
13,0.960,Human UTI,16-23,77,75,0,152,50.658,50.658
13,0.960,Human UTI,23-5,100,115,0,215,46.512,46.512
13,0.960,unknown,16-23,0,0,0,0,NaN,NaN
13,0.960,unknown,23-5,0,2,0,2,0.000,0.000
13,0.960,SLO Creek Water,16-23,0,0,0,0,NaN,NaN
13,0.960,SLO Creek Water,23-5,0,0,0,0,NaN,NaN
13,0.960,Pig/Swine,16-23,4,5,0,9,44.444,44.444
13,0.960,Pig/Swine,23-5,8,11,0,19,42.105,42.105
13,0.960,Klebsiella,16-23,0,0,0,0,NaN,NaN
13,0.960,Klebsiella,23-5,0,0,0,0,NaN,NaN
13,0.960,Hu Cw and Dg,16-23,5,8,0,13,38.462,38.462
13,0.960,Hu Cw and Dg,23-5,6,10,0,16,37.500,37.500
13,0.960,Ground Squirrel,16-23,76,49,0,125,60.800,60.800
13,0.960,Ground Squirrel,23-5,81,71,0,152,53.289,53.289
13,0.960,Opossum,16-23,0,0,0,0,NaN,NaN
13,0.960,Opossum,23-5,0,0,0,0,NaN,NaN
13,0.960,Cow,16-23,1562,1226,0,2788,56.026,56.026
13,0.960,Cow,23-5,1542,1619,0,3161,48.782,48.782
13,0.960,Deer Mouse,16-23,0,0,0,0,NaN,NaN
13,0.960,Deer Mouse,23-5,0,0,0,0,NaN,NaN
13,0.960,OVERALL,16-23,3686,2630,0,6316,58.360,58.360
13,0.960,OVERALL,23-5,4288,3289,0,7577,56.592,56.592
13,0.970,Chicken,16-23,0,0,0,0,NaN,NaN
13,0.970,Chicken,23-5,4,6,0,10,40.000,40.000
13,0.970,Sea Lion,16-23,0,0,0,0,NaN,NaN
13,0.970,Sea Lion,23-5,0,11,0,11,0.000,0.000
13,0.970,Hu and Cw,16-23,1,5,0,6,16.667,16.667
13,0.970,Hu and Cw,23-5,8,8,0,16,50.000,50.000
13,0.970,Sheep,16-23,45,53,0,98,45.918,45.918
13,0.970,Sheep,23-5,55,37,0,92,59.783,59.783
13,0.970,Hu and Dg,16-23,6,9,0,15,40.000,40.000
13,0.970,Hu and Dg,23-5,20,27,0,47,42.553,42.553
13,0.970,Common Loon,16-23,0,0,0,0,NaN,NaN
13,0.970,Common Loon,23-5,0,0,0,0,NaN,NaN
13,0.970,Red-Winged Blackbird,16-23,0,0,0,0,NaN,NaN
13,0.970,Red-Winged Blackbird,23-5,0,0,0,0,NaN,NaN
13,0.970,Cw,16-23,6,11,0,17,35.294,35.294
13,0.970,Cw,23-5,9,18,0,27,33.333,33.333
13,0.970,Cliff Sparrow,16-23,1,8,0,9,11.111,11.111
13,0.970,Cliff Sparrow,23-5,0,0,0,0,NaN,NaN
13,0.970,Pig,16-23,4,7,0,11,36.364,36.364
13,0.970,Pig,23-5,0,1,0,1,0.000,0.000
13,0.970,Barn Owl,16-23,0,0,0,0,NaN,NaN
13,0.970,Barn Owl,23-5,0,0,0,0,NaN,NaN
13,0.970,Wild Pig,16-23,0,0,0,0,NaN,NaN
13,0.970,Wild Pig,23-5,0,0,0,0,NaN,NaN
13,0.970,Pennington Creek Water,16-23,0,0,0,0,NaN,NaN
13,0.970,Pennington Creek Water,23-5,0,0,0,0,NaN,NaN
13,0.970,Guinni,16-23,0,0,0,0,NaN,NaN
13,0.970,Guinni,23-5,0,0,0,0,NaN,NaN
13,0.970,Racoon,16-23,0,0,0,0,NaN,NaN
13,0.970,Racoon,23-5,0,0,0,0,NaN,NaN
13,0.970,Hu,16-23,11,10,0,21,52.381,52.381
13,0.970,Hu,23-5,23,17,0,40,57.500,57.500
13,0.970,Cw and Dg,16-23,8,15,0,23,34.783,34.783
13,0.970,Cw and Dg,23-5,12,14,0,26,46.154,46.154
13,0.970,Red Wind Blackbird,16-23,0,0,0,0,NaN,NaN
13,0.970,Red Wind Blackbird,23-5,0,0,0,0,NaN,NaN
13,0.970,Tree Swallow,16-23,0,0,0,0,NaN,NaN
13,0.970,Tree Swallow,23-5,0,0,0,0,NaN,NaN
13,0.970,Turkey Vulture,16-23,0,0,0,0,NaN,NaN
13,0.970,Turkey Vulture,23-5,0,0,0,0,NaN,NaN
13,0.970,Dg,16-23,6,9,0,15,40.000,40.000
13,0.970,Dg,23-5,31,31,0,62,50.000,50.000
13,0.970,Western Kingbird,16-23,0,0,0,0,NaN,NaN
13,0.970,Western Kingbird,23-5,0,0,0,0,NaN,NaN
13,0.970,White Crowned Sparrow,16-23,0,0,0,0,NaN,NaN
13,0.970,White Crowned Sparrow,23-5,0,5,0,5,0.000,0.000
13,0.970,Eared Grebe,16-23,0,0,0,0,NaN,NaN
13,0.970,Eared Grebe,23-5,0,4,0,4,0.000,0.000
13,0.970,cougar,16-23,0,0,0,0,NaN,NaN
13,0.970,cougar,23-5,0,0,0,0,NaN,NaN
13,0.970,Ocean Water,16-23,0,0,0,0,NaN,NaN
13,0.970,Ocean Water,23-5,0,0,0,0,NaN,NaN
13,0.970,Red Tailed Hawk,16-23,0,0,0,0,NaN,NaN
13,0.970,Red Tailed Hawk,23-5,0,2,0,2,0.000,0.000
13,0.970,Dog,16-23,53,67,0,120,44.167,44.167
13,0.970,Dog,23-5,84,128,0,212,39.623,39.623
13,0.970,Human,16-23,1722,830,0,2552,67.476,67.476
13,0.970,Human,23-5,2138,701,0,2839,75.308,75.308
13,0.970,Wild Turkey,16-23,1,4,0,5,20.000,20.000
13,0.970,Wild Turkey,23-5,2,9,0,11,18.182,18.182
13,0.970,Clark Grebe,16-23,0,0,0,0,NaN,NaN
13,0.970,Clark Grebe,23-5,0,0,0,0,NaN,NaN
13,0.970,Seagull,16-23,0,0,0,0,NaN,NaN
13,0.970,Seagull,23-5,4,10,0,14,28.571,28.571
13,0.970,Surf Scoter,16-23,0,0,0,0,NaN,NaN
13,0.970,Surf Scoter,23-5,0,2,0,2,0.000,0.000
13,0.970,Pigeon,16-23,27,133,0,160,16.875,16.875
13,0.970,Pigeon,23-5,70,168,0,238,29.412,29.412
13,0.970,Pacific Ocean Water,16-23,0,0,0,0,NaN,NaN
13,0.970,Pacific Ocean Water,23-5,0,0,0,0,NaN,NaN
13,0.970,Cat,16-23,17,19,0,36,47.222,47.222
13,0.970,Cat,23-5,17,23,0,40,42.500,42.500
13,0.970,Horse,16-23,6,14,0,20,30.000,30.000
13,0.970,Horse,23-5,22,87,0,109,20.183,20.183
13,0.970,orangutan,16-23,0,0,0,0,NaN,NaN
13,0.970,orangutan,23-5,0,0,0,0,NaN,NaN
13,0.970,Bat,16-23,36,35,0,71,50.704,50.704
13,0.970,Bat,23-5,37,35,0,72,51.389,51.389
13,0.970,Deer,16-23,11,38,0,49,22.449,22.449
13,0.970,Deer,23-5,17,125,0,142,11.972,11.972
13,0.970,Great Horned Owl,16-23,0,0,0,0,NaN,NaN
13,0.970,Great Horned Owl,23-5,0,1,0,1,0.000,0.000
13,0.970,Freshwater Lagoon,16-23,0,0,0,0,NaN,NaN
13,0.970,Freshwater Lagoon,23-5,0,0,0,0,NaN,NaN
13,0.970,Unknown Avian,16-23,0,0,0,0,NaN,NaN
13,0.970,Unknown Avian,23-5,0,0,0,0,NaN,NaN
13,0.970,Human UTI,16-23,77,76,0,153,50.327,50.327
13,0.970,Human UTI,23-5,99,115,0,214,46.262,46.262
13,0.970,unknown,16-23,0,0,0,0,NaN,NaN
13,0.970,unknown,23-5,0,2,0,2,0.000,0.000
13,0.970,SLO Creek Water,16-23,0,0,0,0,NaN,NaN
13,0.970,SLO Creek Water,23-5,0,0,0,0,NaN,NaN
13,0.970,Pig/Swine,16-23,4,5,0,9,44.444,44.444
13,0.970,Pig/Swine,23-5,8,11,0,19,42.105,42.105
13,0.970,Klebsiella,16-23,0,0,0,0,NaN,NaN
13,0.970,Klebsiella,23-5,0,0,0,0,NaN,NaN
13,0.970,Hu Cw and Dg,16-23,5,8,0,13,38.462,38.462
13,0.970,Hu Cw and Dg,23-5,6,10,0,16,37.500,37.500
13,0.970,Ground Squirrel,16-23,76,48,0,124,61.290,61.290
13,0.970,Ground Squirrel,23-5,81,69,0,150,54.000,54.000
13,0.970,Opossum,16-23,0,0,0,0,NaN,NaN
13,0.970,Opossum,23-5,0,0,0,0,NaN,NaN
13,0.970,Cow,16-23,1556,1223,0,2779,55.991,55.991
13,0.970,Cow,23-5,1539,1593,0,3132,49.138,49.138
13,0.970,Deer Mouse,16-23,0,0,0,0,NaN,NaN
13,0.970,Deer Mouse,23-5,0,0,0,0,NaN,NaN
13,0.970,OVERALL,16-23,3679,2627,0,6306,58.341,58.341
13,0.970,OVERALL,23-5,4286,3270,0,7556,56.723,56.723
13,0.980,Chicken,16-23,0,0,0,0,NaN,NaN
13,0.980,Chicken,23-5,5,6,0,11,45.455,45.455
13,0.980,Sea Lion,16-23,0,0,0,0,NaN,NaN
13,0.980,Sea Lion,23-5,0,10,0,10,0.000,0.000
13,0.980,Hu and Cw,16-23,1,5,0,6,16.667,16.667
13,0.980,Hu and Cw,23-5,8,18,0,26,30.769,30.769
13,0.980,Sheep,16-23,48,51,0,99,48.485,48.485
13,0.980,Sheep,23-5,54,36,0,90,60.000,60.000
13,0.980,Hu and Dg,16-23,6,9,0,15,40.000,40.000
13,0.980,Hu and Dg,23-5,20,24,0,44,45.455,45.455
13,0.980,Common Loon,16-23,0,0,0,0,NaN,NaN
13,0.980,Common Loon,23-5,0,0,0,0,NaN,NaN
13,0.980,Red-Winged Blackbird,16-23,0,0,0,0,NaN,NaN
13,0.980,Red-Winged Blackbird,23-5,0,0,0,0,NaN,NaN
13,0.980,Cw,16-23,6,10,0,16,37.500,37.500
13,0.980,Cw,23-5,9,20,0,29,31.034,31.034
13,0.980,Cliff Sparrow,16-23,1,8,0,9,11.111,11.111
13,0.980,Cliff Sparrow,23-5,0,0,0,0,NaN,NaN
13,0.980,Pig,16-23,4,7,0,11,36.364,36.364
13,0.980,Pig,23-5,0,1,0,1,0.000,0.000
13,0.980,Barn Owl,16-23,0,0,0,0,NaN,NaN
13,0.980,Barn Owl,23-5,0,0,0,0,NaN,NaN
13,0.980,Wild Pig,16-23,0,0,0,0,NaN,NaN
13,0.980,Wild Pig,23-5,0,0,0,0,NaN,NaN
13,0.980,Pennington Creek Water,16-23,0,0,0,0,NaN,NaN
13,0.980,Pennington Creek Water,23-5,0,0,0,0,NaN,NaN
13,0.980,Guinni,16-23,0,0,0,0,NaN,NaN
13,0.980,Guinni,23-5,0,0,0,0,NaN,NaN
13,0.980,Racoon,16-23,0,0,0,0,NaN,NaN
13,0.980,Racoon,23-5,0,0,0,0,NaN,NaN
13,0.980,Hu,16-23,11,10,0,21,52.381,52.381
13,0.980,Hu,23-5,23,18,0,41,56.098,56.098
13,0.980,Cw and Dg,16-23,8,15,0,23,34.783,34.783
13,0.980,Cw and Dg,23-5,12,16,0,28,42.857,42.857
13,0.980,Red Wind Blackbird,16-23,0,0,0,0,NaN,NaN
13,0.980,Red Wind Blackbird,23-5,0,0,0,0,NaN,NaN
13,0.980,Tree Swallow,16-23,0,0,0,0,NaN,NaN
13,0.980,Tree Swallow,23-5,0,0,0,0,NaN,NaN
13,0.980,Turkey Vulture,16-23,0,0,0,0,NaN,NaN
13,0.980,Turkey Vulture,23-5,0,0,0,0,NaN,NaN
13,0.980,Dg,16-23,6,9,0,15,40.000,40.000
13,0.980,Dg,23-5,31,24,0,55,56.364,56.364
13,0.980,Western Kingbird,16-23,0,0,0,0,NaN,NaN
13,0.980,Western Kingbird,23-5,0,0,0,0,NaN,NaN
13,0.980,White Crowned Sparrow,16-23,0,0,0,0,NaN,NaN
13,0.980,White Crowned Sparrow,23-5,0,7,0,7,0.000,0.000
13,0.980,Eared Grebe,16-23,0,0,0,0,NaN,NaN
13,0.980,Eared Grebe,23-5,0,4,0,4,0.000,0.000
13,0.980,cougar,16-23,0,0,0,0,NaN,NaN
13,0.980,cougar,23-5,0,0,0,0,NaN,NaN
13,0.980,Ocean Water,16-23,0,0,0,0,NaN,NaN
13,0.980,Ocean Water,23-5,0,0,0,0,NaN,NaN
13,0.980,Red Tailed Hawk,16-23,0,0,0,0,NaN,NaN
13,0.980,Red Tailed Hawk,23-5,0,1,0,1,0.000,0.000
13,0.980,Dog,16-23,52,71,0,123,42.276,42.276
13,0.980,Dog,23-5,84,123,0,207,40.580,40.580
13,0.980,Human,16-23,1722,819,0,2541,67.769,67.769
13,0.980,Human,23-5,2137,687,0,2824,75.673,75.673
13,0.980,Wild Turkey,16-23,1,4,0,5,20.000,20.000
13,0.980,Wild Turkey,23-5,4,19,0,23,17.391,17.391
13,0.980,Clark Grebe,16-23,0,0,0,0,NaN,NaN
13,0.980,Clark Grebe,23-5,0,0,0,0,NaN,NaN
13,0.980,Seagull,16-23,0,0,0,0,NaN,NaN
13,0.980,Seagull,23-5,6,8,0,14,42.857,42.857
13,0.980,Surf Scoter,16-23,0,0,0,0,NaN,NaN
13,0.980,Surf Scoter,23-5,2,0,0,2,100.000,100.000
13,0.980,Pigeon,16-23,27,130,0,157,17.197,17.197
13,0.980,Pigeon,23-5,69,178,0,247,27.935,27.935
13,0.980,Pacific Ocean Water,16-23,0,0,0,0,NaN,NaN
13,0.980,Pacific Ocean Water,23-5,0,0,0,0,NaN,NaN
13,0.980,Cat,16-23,17,19,0,36,47.222,47.222
13,0.980,Cat,23-5,18,19,0,37,48.649,48.649
13,0.980,Horse,16-23,6,14,0,20,30.000,30.000
13,0.980,Horse,23-5,22,85,0,107,20.561,20.561
13,0.980,orangutan,16-23,0,0,0,0,NaN,NaN
13,0.980,orangutan,23-5,0,0,0,0,NaN,NaN
13,0.980,Bat,16-23,36,34,0,70,51.429,51.429
13,0.980,Bat,23-5,37,35,0,72,51.389,51.389
13,0.980,Deer,16-23,11,38,0,49,22.449,22.449
13,0.980,Deer,23-5,17,125,0,142,11.972,11.972
13,0.980,Great Horned Owl,16-23,0,0,0,0,NaN,NaN
13,0.980,Great Horned Owl,23-5,0,1,0,1,0.000,0.000
13,0.980,Freshwater Lagoon,16-23,0,0,0,0,NaN,NaN
13,0.980,Freshwater Lagoon,23-5,0,0,0,0,NaN,NaN
13,0.980,Unknown Avian,16-23,0,0,0,0,NaN,NaN
13,0.980,Unknown Avian,23-5,0,0,0,0,NaN,NaN
13,0.980,Human UTI,16-23,77,78,0,155,49.677,49.677
13,0.980,Human UTI,23-5,100,114,0,214,46.729,46.729
13,0.980,unknown,16-23,0,0,0,0,NaN,NaN
13,0.980,unknown,23-5,0,3,0,3,0.000,0.000
13,0.980,SLO Creek Water,16-23,0,0,0,0,NaN,NaN
13,0.980,SLO Creek Water,23-5,0,0,0,0,NaN,NaN
13,0.980,Pig/Swine,16-23,4,5,0,9,44.444,44.444
13,0.980,Pig/Swine,23-5,8,11,0,19,42.105,42.105
13,0.980,Klebsiella,16-23,0,0,0,0,NaN,NaN
13,0.980,Klebsiella,23-5,0,0,0,0,NaN,NaN
13,0.980,Hu Cw and Dg,16-23,5,8,0,13,38.462,38.462
13,0.980,Hu Cw and Dg,23-5,6,9,0,15,40.000,40.000
13,0.980,Ground Squirrel,16-23,78,49,0,127,61.417,61.417
13,0.980,Ground Squirrel,23-5,82,67,0,149,55.034,55.034
13,0.980,Opossum,16-23,0,0,0,0,NaN,NaN
13,0.980,Opossum,23-5,0,0,0,0,NaN,NaN
13,0.980,Cow,16-23,1550,1206,0,2756,56.241,56.241
13,0.980,Cow,23-5,1533,1555,0,3088,49.644,49.644
13,0.980,Deer Mouse,16-23,0,0,0,0,NaN,NaN
13,0.980,Deer Mouse,23-5,0,0,0,0,NaN,NaN
13,0.980,OVERALL,16-23,3677,2599,0,6276,58.588,58.588
13,0.980,OVERALL,23-5,4287,3224,0,7511,57.076,57.076
13,0.990,Chicken,16-23,2,6,0,8,25.000,25.000
13,0.990,Chicken,23-5,6,6,0,12,50.000,50.000
13,0.990,Sea Lion,16-23,0,0,0,0,NaN,NaN
13,0.990,Sea Lion,23-5,2,7,0,9,22.222,22.222
13,0.990,Hu and Cw,16-23,2,5,0,7,28.571,28.571
13,0.990,Hu and Cw,23-5,10,25,0,35,28.571,28.571
13,0.990,Sheep,16-23,47,51,0,98,47.959,47.959
13,0.990,Sheep,23-5,55,35,0,90,61.111,61.111
13,0.990,Hu and Dg,16-23,6,11,0,17,35.294,35.294
13,0.990,Hu and Dg,23-5,20,20,0,40,50.000,50.000
13,0.990,Common Loon,16-23,0,0,0,0,NaN,NaN
13,0.990,Common Loon,23-5,0,2,0,2,0.000,0.000
13,0.990,Red-Winged Blackbird,16-23,0,2,0,2,0.000,0.000
13,0.990,Red-Winged Blackbird,23-5,0,0,0,0,NaN,NaN
13,0.990,Cw,16-23,7,10,0,17,41.176,41.176
13,0.990,Cw,23-5,15,23,0,38,39.474,39.474
13,0.990,Cliff Sparrow,16-23,1,9,0,10,10.000,10.000
13,0.990,Cliff Sparrow,23-5,0,4,0,4,0.000,0.000
13,0.990,Pig,16-23,4,7,0,11,36.364,36.364
13,0.990,Pig,23-5,7,8,0,15,46.667,46.667
13,0.990,Barn Owl,16-23,0,0,0,0,NaN,NaN
13,0.990,Barn Owl,23-5,0,0,0,0,NaN,NaN
13,0.990,Wild Pig,16-23,0,2,0,2,0.000,0.000
13,0.990,Wild Pig,23-5,0,1,0,1,0.000,0.000
13,0.990,Pennington Creek Water,16-23,0,0,0,0,NaN,NaN
13,0.990,Pennington Creek Water,23-5,0,0,0,0,NaN,NaN
13,0.990,Guinni,16-23,0,0,0,0,NaN,NaN
13,0.990,Guinni,23-5,0,0,0,0,NaN,NaN
13,0.990,Racoon,16-23,0,0,0,0,NaN,NaN
13,0.990,Racoon,23-5,0,1,0,1,0.000,0.000
13,0.990,Hu,16-23,11,10,0,21,52.381,52.381
13,0.990,Hu,23-5,23,14,0,37,62.162,62.162
13,0.990,Cw and Dg,16-23,8,15,0,23,34.783,34.783
13,0.990,Cw and Dg,23-5,13,10,0,23,56.522,56.522
13,0.990,Red Wind Blackbird,16-23,0,0,0,0,NaN,NaN
13,0.990,Red Wind Blackbird,23-5,0,0,0,0,NaN,NaN
13,0.990,Tree Swallow,16-23,0,0,0,0,NaN,NaN
13,0.990,Tree Swallow,23-5,0,0,0,0,NaN,NaN
13,0.990,Turkey Vulture,16-23,0,0,0,0,NaN,NaN
13,0.990,Turkey Vulture,23-5,0,0,0,0,NaN,NaN
13,0.990,Dg,16-23,6,10,0,16,37.500,37.500
13,0.990,Dg,23-5,31,19,0,50,62.000,62.000
13,0.990,Western Kingbird,16-23,0,0,0,0,NaN,NaN
13,0.990,Western Kingbird,23-5,0,0,0,0,NaN,NaN
13,0.990,White Crowned Sparrow,16-23,0,0,0,0,NaN,NaN
13,0.990,White Crowned Sparrow,23-5,0,8,0,8,0.000,0.000
13,0.990,Eared Grebe,16-23,0,0,0,0,NaN,NaN
13,0.990,Eared Grebe,23-5,0,6,0,6,0.000,0.000
13,0.990,cougar,16-23,0,1,0,1,0.000,0.000
13,0.990,cougar,23-5,0,0,0,0,NaN,NaN
13,0.990,Ocean Water,16-23,0,0,0,0,NaN,NaN
13,0.990,Ocean Water,23-5,0,0,0,0,NaN,NaN
13,0.990,Red Tailed Hawk,16-23,0,0,0,0,NaN,NaN
13,0.990,Red Tailed Hawk,23-5,0,2,0,2,0.000,0.000
13,0.990,Dog,16-23,55,71,0,126,43.651,43.651
13,0.990,Dog,23-5,87,119,0,206,42.233,42.233
13,0.990,Human,16-23,1701,775,0,2476,68.700,68.700
13,0.990,Human,23-5,2122,630,0,2752,77.108,77.108
13,0.990,Wild Turkey,16-23,3,9,0,12,25.000,25.000
13,0.990,Wild Turkey,23-5,4,20,0,24,16.667,16.667
13,0.990,Clark Grebe,16-23,0,0,0,0,NaN,NaN
13,0.990,Clark Grebe,23-5,2,3,0,5,40.000,40.000
13,0.990,Seagull,16-23,0,0,0,0,NaN,NaN
13,0.990,Seagull,23-5,12,7,0,19,63.158,63.158
13,0.990,Surf Scoter,16-23,0,0,0,0,NaN,NaN
13,0.990,Surf Scoter,23-5,2,0,0,2,100.000,100.000
13,0.990,Pigeon,16-23,36,124,0,160,22.500,22.500
13,0.990,Pigeon,23-5,75,198,0,273,27.473,27.473
13,0.990,Pacific Ocean Water,16-23,0,0,0,0,NaN,NaN
13,0.990,Pacific Ocean Water,23-5,0,0,0,0,NaN,NaN
13,0.990,Cat,16-23,18,22,0,40,45.000,45.000
13,0.990,Cat,23-5,18,23,0,41,43.902,43.902
13,0.990,Horse,16-23,9,15,0,24,37.500,37.500
13,0.990,Horse,23-5,22,101,0,123,17.886,17.886
13,0.990,orangutan,16-23,0,0,0,0,NaN,NaN
13,0.990,orangutan,23-5,0,0,0,0,NaN,NaN
13,0.990,Bat,16-23,36,31,0,67,53.731,53.731
13,0.990,Bat,23-5,37,34,0,71,52.113,52.113
13,0.990,Deer,16-23,11,40,0,51,21.569,21.569
13,0.990,Deer,23-5,17,113,0,130,13.077,13.077
13,0.990,Great Horned Owl,16-23,0,0,0,0,NaN,NaN
13,0.990,Great Horned Owl,23-5,0,1,0,1,0.000,0.000
13,0.990,Freshwater Lagoon,16-23,0,0,0,0,NaN,NaN
13,0.990,Freshwater Lagoon,23-5,0,0,0,0,NaN,NaN
13,0.990,Unknown Avian,16-23,0,0,0,0,NaN,NaN
13,0.990,Unknown Avian,23-5,0,0,0,0,NaN,NaN
13,0.990,Human UTI,16-23,81,72,0,153,52.941,52.941
13,0.990,Human UTI,23-5,99,89,0,188,52.660,52.660
13,0.990,unknown,16-23,0,0,0,0,NaN,NaN
13,0.990,unknown,23-5,0,5,0,5,0.000,0.000
13,0.990,SLO Creek Water,16-23,0,0,0,0,NaN,NaN
13,0.990,SLO Creek Water,23-5,0,0,0,0,NaN,NaN
13,0.990,Pig/Swine,16-23,4,6,0,10,40.000,40.000
13,0.990,Pig/Swine,23-5,8,10,0,18,44.444,44.444
13,0.990,Klebsiella,16-23,0,0,0,0,NaN,NaN
13,0.990,Klebsiella,23-5,0,0,0,0,NaN,NaN
13,0.990,Hu Cw and Dg,16-23,5,8,0,13,38.462,38.462
13,0.990,Hu Cw and Dg,23-5,6,10,0,16,37.500,37.500
13,0.990,Ground Squirrel,16-23,81,50,0,131,61.832,61.832
13,0.990,Ground Squirrel,23-5,84,71,0,155,54.194,54.194
13,0.990,Opossum,16-23,1,0,0,1,100.000,100.000
13,0.990,Opossum,23-5,2,0,0,2,100.000,100.000
13,0.990,Cow,16-23,1520,1097,0,2617,58.082,58.082
13,0.990,Cow,23-5,1493,1408,0,2901,51.465,51.465
13,0.990,Deer Mouse,16-23,0,0,0,0,NaN,NaN
13,0.990,Deer Mouse,23-5,0,0,0,0,NaN,NaN
13,0.990,OVERALL,16-23,3655,2459,0,6114,59.781,59.781
13,0.990,OVERALL,23-5,4272,3033,0,7305,58.480,58.480
13,1.000,Chicken,16-23,0,0,0,0,NaN,NaN
13,1.000,Chicken,23-5,0,0,0,0,NaN,NaN
13,1.000,Sea Lion,16-23,0,0,0,0,NaN,NaN
13,1.000,Sea Lion,23-5,0,0,0,0,NaN,NaN
13,1.000,Hu and Cw,16-23,0,0,0,0,NaN,NaN
13,1.000,Hu and Cw,23-5,0,0,0,0,NaN,NaN
13,1.000,Sheep,16-23,0,0,0,0,NaN,NaN
13,1.000,Sheep,23-5,0,0,0,0,NaN,NaN
13,1.000,Hu and Dg,16-23,0,0,0,0,NaN,NaN
13,1.000,Hu and Dg,23-5,0,0,0,0,NaN,NaN
13,1.000,Common Loon,16-23,0,0,0,0,NaN,NaN
13,1.000,Common Loon,23-5,0,0,0,0,NaN,NaN
13,1.000,Red-Winged Blackbird,16-23,0,0,0,0,NaN,NaN
13,1.000,Red-Winged Blackbird,23-5,0,0,0,0,NaN,NaN
13,1.000,Cw,16-23,0,0,0,0,NaN,NaN
13,1.000,Cw,23-5,0,0,0,0,NaN,NaN
13,1.000,Cliff Sparrow,16-23,0,0,0,0,NaN,NaN
13,1.000,Cliff Sparrow,23-5,0,0,0,0,NaN,NaN
13,1.000,Pig,16-23,0,0,0,0,NaN,NaN
13,1.000,Pig,23-5,0,0,0,0,NaN,NaN
13,1.000,Barn Owl,16-23,0,0,0,0,NaN,NaN
13,1.000,Barn Owl,23-5,0,0,0,0,NaN,NaN
13,1.000,Wild Pig,16-23,0,0,0,0,NaN,NaN
13,1.000,Wild Pig,23-5,0,0,0,0,NaN,NaN
13,1.000,Pennington Creek Water,16-23,0,0,0,0,NaN,NaN
13,1.000,Pennington Creek Water,23-5,0,0,0,0,NaN,NaN
13,1.000,Guinni,16-23,0,0,0,0,NaN,NaN
13,1.000,Guinni,23-5,0,0,0,0,NaN,NaN
13,1.000,Racoon,16-23,0,0,0,0,NaN,NaN
13,1.000,Racoon,23-5,0,0,0,0,NaN,NaN
13,1.000,Hu,16-23,0,0,0,0,NaN,NaN
13,1.000,Hu,23-5,0,0,0,0,NaN,NaN
13,1.000,Cw and Dg,16-23,0,0,0,0,NaN,NaN
13,1.000,Cw and Dg,23-5,0,0,0,0,NaN,NaN
13,1.000,Red Wind Blackbird,16-23,0,0,0,0,NaN,NaN
13,1.000,Red Wind Blackbird,23-5,0,0,0,0,NaN,NaN
13,1.000,Tree Swallow,16-23,0,0,0,0,NaN,NaN
13,1.000,Tree Swallow,23-5,0,0,0,0,NaN,NaN
13,1.000,Turkey Vulture,16-23,0,0,0,0,NaN,NaN
13,1.000,Turkey Vulture,23-5,0,0,0,0,NaN,NaN
13,1.000,Dg,16-23,0,0,0,0,NaN,NaN
13,1.000,Dg,23-5,0,0,0,0,NaN,NaN
13,1.000,Western Kingbird,16-23,0,0,0,0,NaN,NaN
13,1.000,Western Kingbird,23-5,0,0,0,0,NaN,NaN
13,1.000,White Crowned Sparrow,16-23,0,0,0,0,NaN,NaN
13,1.000,White Crowned Sparrow,23-5,0,0,0,0,NaN,NaN
13,1.000,Eared Grebe,16-23,0,0,0,0,NaN,NaN
13,1.000,Eared Grebe,23-5,0,0,0,0,NaN,NaN
13,1.000,cougar,16-23,0,0,0,0,NaN,NaN
13,1.000,cougar,23-5,0,0,0,0,NaN,NaN
13,1.000,Ocean Water,16-23,0,0,0,0,NaN,NaN
13,1.000,Ocean Water,23-5,0,0,0,0,NaN,NaN
13,1.000,Red Tailed Hawk,16-23,0,0,0,0,NaN,NaN
13,1.000,Red Tailed Hawk,23-5,0,0,0,0,NaN,NaN
13,1.000,Dog,16-23,0,0,0,0,NaN,NaN
13,1.000,Dog,23-5,0,0,0,0,NaN,NaN
13,1.000,Human,16-23,0,0,0,0,NaN,NaN
13,1.000,Human,23-5,0,0,0,0,NaN,NaN
13,1.000,Wild Turkey,16-23,0,0,0,0,NaN,NaN
13,1.000,Wild Turkey,23-5,0,0,0,0,NaN,NaN
13,1.000,Clark Grebe,16-23,0,0,0,0,NaN,NaN
13,1.000,Clark Grebe,23-5,0,0,0,0,NaN,NaN
13,1.000,Seagull,16-23,0,0,0,0,NaN,NaN
13,1.000,Seagull,23-5,0,0,0,0,NaN,NaN
13,1.000,Surf Scoter,16-23,0,0,0,0,NaN,NaN
13,1.000,Surf Scoter,23-5,0,0,0,0,NaN,NaN
13,1.000,Pigeon,16-23,0,0,0,0,NaN,NaN
13,1.000,Pigeon,23-5,0,0,0,0,NaN,NaN
13,1.000,Pacific Ocean Water,16-23,0,0,0,0,NaN,NaN
13,1.000,Pacific Ocean Water,23-5,0,0,0,0,NaN,NaN
13,1.000,Cat,16-23,0,0,0,0,NaN,NaN
13,1.000,Cat,23-5,0,0,0,0,NaN,NaN
13,1.000,Horse,16-23,0,0,0,0,NaN,NaN
13,1.000,Horse,23-5,0,0,0,0,NaN,NaN
13,1.000,orangutan,16-23,0,0,0,0,NaN,NaN
13,1.000,orangutan,23-5,0,0,0,0,NaN,NaN
13,1.000,Bat,16-23,0,0,0,0,NaN,NaN
13,1.000,Bat,23-5,0,0,0,0,NaN,NaN
13,1.000,Deer,16-23,0,0,0,0,NaN,NaN
13,1.000,Deer,23-5,0,0,0,0,NaN,NaN
13,1.000,Great Horned Owl,16-23,0,0,0,0,NaN,NaN
13,1.000,Great Horned Owl,23-5,0,0,0,0,NaN,NaN
13,1.000,Freshwater Lagoon,16-23,0,0,0,0,NaN,NaN
13,1.000,Freshwater Lagoon,23-5,0,0,0,0,NaN,NaN
13,1.000,Unknown Avian,16-23,0,0,0,0,NaN,NaN
13,1.000,Unknown Avian,23-5,0,0,0,0,NaN,NaN
13,1.000,Human UTI,16-23,0,0,0,0,NaN,NaN
13,1.000,Human UTI,23-5,0,0,0,0,NaN,NaN
13,1.000,unknown,16-23,0,0,0,0,NaN,NaN
13,1.000,unknown,23-5,0,0,0,0,NaN,NaN
13,1.000,SLO Creek Water,16-23,0,0,0,0,NaN,NaN
13,1.000,SLO Creek Water,23-5,0,0,0,0,NaN,NaN
13,1.000,Pig/Swine,16-23,0,0,0,0,NaN,NaN
13,1.000,Pig/Swine,23-5,0,0,0,0,NaN,NaN
13,1.000,Klebsiella,16-23,0,0,0,0,NaN,NaN
13,1.000,Klebsiella,23-5,0,0,0,0,NaN,NaN
13,1.000,Hu Cw and Dg,16-23,0,0,0,0,NaN,NaN
13,1.000,Hu Cw and Dg,23-5,0,0,0,0,NaN,NaN
13,1.000,Ground Squirrel,16-23,0,0,0,0,NaN,NaN
13,1.000,Ground Squirrel,23-5,0,0,0,0,NaN,NaN
13,1.000,Opossum,16-23,0,0,0,0,NaN,NaN
13,1.000,Opossum,23-5,0,0,0,0,NaN,NaN
13,1.000,Cow,16-23,0,0,0,0,NaN,NaN
13,1.000,Cow,23-5,0,0,0,0,NaN,NaN
13,1.000,Deer Mouse,16-23,0,0,0,0,NaN,NaN
13,1.000,Deer Mouse,23-5,0,0,0,0,NaN,NaN
13,1.000,OVERALL,16-23,0,0,0,0,NaN,NaN
13,1.000,OVERALL,23-5,0,0,0,0,NaN,NaN
14,0.000,Chicken,16-23,0,0,0,0,NaN,NaN
14,0.000,Chicken,23-5,5,2,0,7,71.429,71.429
14,0.000,Sea Lion,16-23,0,0,0,0,NaN,NaN
14,0.000,Sea Lion,23-5,0,10,0,10,0.000,0.000
14,0.000,Hu and Cw,16-23,1,5,0,6,16.667,16.667
14,0.000,Hu and Cw,23-5,9,7,0,16,56.250,56.250
14,0.000,Sheep,16-23,44,51,0,95,46.316,46.316
14,0.000,Sheep,23-5,54,36,0,90,60.000,60.000
14,0.000,Hu and Dg,16-23,7,8,0,15,46.667,46.667
14,0.000,Hu and Dg,23-5,20,25,0,45,44.444,44.444
14,0.000,Common Loon,16-23,0,0,0,0,NaN,NaN
14,0.000,Common Loon,23-5,0,0,0,0,NaN,NaN
14,0.000,Red-Winged Blackbird,16-23,0,0,0,0,NaN,NaN
14,0.000,Red-Winged Blackbird,23-5,0,0,0,0,NaN,NaN
14,0.000,Cw,16-23,6,7,0,13,46.154,46.154
14,0.000,Cw,23-5,9,21,0,30,30.000,30.000
14,0.000,Cliff Sparrow,16-23,0,4,0,4,0.000,0.000
14,0.000,Cliff Sparrow,23-5,0,0,0,0,NaN,NaN
14,0.000,Pig,16-23,6,6,0,12,50.000,50.000
14,0.000,Pig,23-5,0,1,0,1,0.000,0.000
14,0.000,Barn Owl,16-23,0,0,0,0,NaN,NaN
14,0.000,Barn Owl,23-5,0,0,0,0,NaN,NaN
14,0.000,Wild Pig,16-23,0,0,0,0,NaN,NaN
14,0.000,Wild Pig,23-5,0,0,0,0,NaN,NaN
14,0.000,Pennington Creek Water,16-23,0,0,0,0,NaN,NaN
14,0.000,Pennington Creek Water,23-5,0,0,0,0,NaN,NaN
14,0.000,Guinni,16-23,0,0,0,0,NaN,NaN
14,0.000,Guinni,23-5,0,0,0,0,NaN,NaN
14,0.000,Racoon,16-23,0,0,0,0,NaN,NaN
14,0.000,Racoon,23-5,0,0,0,0,NaN,NaN
14,0.000,Hu,16-23,12,8,0,20,60.000,60.000
14,0.000,Hu,23-5,22,18,0,40,55.000,55.000
14,0.000,Cw and Dg,16-23,7,12,0,19,36.842,36.842
14,0.000,Cw and Dg,23-5,13,16,0,29,44.828,44.828
14,0.000,Red Wind Blackbird,16-23,0,0,0,0,NaN,NaN
14,0.000,Red Wind Blackbird,23-5,0,0,0,0,NaN,NaN
14,0.000,Tree Swallow,16-23,0,0,0,0,NaN,NaN
14,0.000,Tree Swallow,23-5,0,0,0,0,NaN,NaN
14,0.000,Turkey Vulture,16-23,0,0,0,0,NaN,NaN
14,0.000,Turkey Vulture,23-5,0,0,0,0,NaN,NaN
14,0.000,Dg,16-23,7,9,0,16,43.750,43.750
14,0.000,Dg,23-5,31,35,0,66,46.970,46.970
14,0.000,Western Kingbird,16-23,0,0,0,0,NaN,NaN
14,0.000,Western Kingbird,23-5,0,0,0,0,NaN,NaN
14,0.000,White Crowned Sparrow,16-23,0,0,0,0,NaN,NaN
14,0.000,White Crowned Sparrow,23-5,0,5,0,5,0.000,0.000
14,0.000,Eared Grebe,16-23,0,0,0,0,NaN,NaN
14,0.000,Eared Grebe,23-5,0,5,0,5,0.000,0.000
14,0.000,cougar,16-23,0,0,0,0,NaN,NaN
14,0.000,cougar,23-5,0,0,0,0,NaN,NaN
14,0.000,Ocean Water,16-23,0,0,0,0,NaN,NaN
14,0.000,Ocean Water,23-5,0,0,0,0,NaN,NaN
14,0.000,Red Tailed Hawk,16-23,0,0,0,0,NaN,NaN
14,0.000,Red Tailed Hawk,23-5,0,1,0,1,0.000,0.000
14,0.000,Dog,16-23,51,72,0,123,41.463,41.463
14,0.000,Dog,23-5,81,146,0,227,35.683,35.683
14,0.000,Human,16-23,1727,845,0,2572,67.146,67.146
14,0.000,Human,23-5,2138,766,0,2904,73.623,73.623
14,0.000,Wild Turkey,16-23,1,2,0,3,33.333,33.333
14,0.000,Wild Turkey,23-5,0,6,0,6,0.000,0.000
14,0.000,Clark Grebe,16-23,0,0,0,0,NaN,NaN
14,0.000,Clark Grebe,23-5,0,0,0,0,NaN,NaN
14,0.000,Seagull,16-23,0,0,0,0,NaN,NaN
14,0.000,Seagull,23-5,3,8,0,11,27.273,27.273
14,0.000,Surf Scoter,16-23,0,0,0,0,NaN,NaN
14,0.000,Surf Scoter,23-5,0,0,0,0,NaN,NaN
14,0.000,Pigeon,16-23,21,124,0,145,14.483,14.483
14,0.000,Pigeon,23-5,65,134,0,199,32.663,32.663
14,0.000,Pacific Ocean Water,16-23,0,0,0,0,NaN,NaN
14,0.000,Pacific Ocean Water,23-5,0,0,0,0,NaN,NaN
14,0.000,Cat,16-23,16,20,0,36,44.444,44.444
14,0.000,Cat,23-5,16,20,0,36,44.444,44.444
14,0.000,Horse,16-23,5,9,0,14,35.714,35.714
14,0.000,Horse,23-5,20,67,0,87,22.989,22.989
14,0.000,orangutan,16-23,0,0,0,0,NaN,NaN
14,0.000,orangutan,23-5,0,0,0,0,NaN,NaN
14,0.000,Bat,16-23,36,36,0,72,50.000,50.000
14,0.000,Bat,23-5,37,36,0,73,50.685,50.685
14,0.000,Deer,16-23,11,40,0,51,21.569,21.569
14,0.000,Deer,23-5,16,123,0,139,11.511,11.511
14,0.000,Great Horned Owl,16-23,0,0,0,0,NaN,NaN
14,0.000,Great Horned Owl,23-5,0,0,0,0,NaN,NaN
14,0.000,Freshwater Lagoon,16-23,0,0,0,0,NaN,NaN
14,0.000,Freshwater Lagoon,23-5,0,0,0,0,NaN,NaN
14,0.000,Unknown Avian,16-23,0,0,0,0,NaN,NaN
14,0.000,Unknown Avian,23-5,0,0,0,0,NaN,NaN
14,0.000,Human UTI,16-23,73,80,0,153,47.712,47.712
14,0.000,Human UTI,23-5,95,115,0,210,45.238,45.238
14,0.000,unknown,16-23,0,0,0,0,NaN,NaN
14,0.000,unknown,23-5,0,2,0,2,0.000,0.000
14,0.000,SLO Creek Water,16-23,0,0,0,0,NaN,NaN
14,0.000,SLO Creek Water,23-5,0,0,0,0,NaN,NaN
14,0.000,Pig/Swine,16-23,3,5,0,8,37.500,37.500
14,0.000,Pig/Swine,23-5,8,10,0,18,44.444,44.444
14,0.000,Klebsiella,16-23,0,0,0,0,NaN,NaN
14,0.000,Klebsiella,23-5,0,0,0,0,NaN,NaN
14,0.000,Hu Cw and Dg,16-23,5,10,0,15,33.333,33.333
14,0.000,Hu Cw and Dg,23-5,5,5,0,10,50.000,50.000
14,0.000,Ground Squirrel,16-23,75,49,0,124,60.484,60.484
14,0.000,Ground Squirrel,23-5,79,66,0,145,54.483,54.483
14,0.000,Opossum,16-23,0,0,0,0,NaN,NaN
14,0.000,Opossum,23-5,0,0,0,0,NaN,NaN
14,0.000,Cow,16-23,1564,1268,0,2832,55.226,55.226
14,0.000,Cow,23-5,1534,1664,0,3198,47.967,47.967
14,0.000,Deer Mouse,16-23,0,0,0,0,NaN,NaN
14,0.000,Deer Mouse,23-5,0,0,0,0,NaN,NaN
14,0.000,OVERALL,16-23,3678,2670,0,6348,57.940,57.940
14,0.000,OVERALL,23-5,4260,3350,0,7610,55.979,55.979
14,0.500,Chicken,16-23,0,0,0,0,NaN,NaN
14,0.500,Chicken,23-5,5,2,0,7,71.429,71.429
14,0.500,Sea Lion,16-23,0,0,0,0,NaN,NaN
14,0.500,Sea Lion,23-5,0,10,0,10,0.000,0.000
14,0.500,Hu and Cw,16-23,1,5,0,6,16.667,16.667
14,0.500,Hu and Cw,23-5,9,7,0,16,56.250,56.250
14,0.500,Sheep,16-23,44,51,0,95,46.316,46.316
14,0.500,Sheep,23-5,54,36,0,90,60.000,60.000
14,0.500,Hu and Dg,16-23,7,8,0,15,46.667,46.667
14,0.500,Hu and Dg,23-5,20,25,0,45,44.444,44.444
14,0.500,Common Loon,16-23,0,0,0,0,NaN,NaN
14,0.500,Common Loon,23-5,0,0,0,0,NaN,NaN
14,0.500,Red-Winged Blackbird,16-23,0,0,0,0,NaN,NaN
14,0.500,Red-Winged Blackbird,23-5,0,0,0,0,NaN,NaN
14,0.500,Cw,16-23,6,7,0,13,46.154,46.154
14,0.500,Cw,23-5,9,21,0,30,30.000,30.000
14,0.500,Cliff Sparrow,16-23,0,4,0,4,0.000,0.000
14,0.500,Cliff Sparrow,23-5,0,0,0,0,NaN,NaN
14,0.500,Pig,16-23,6,6,0,12,50.000,50.000
14,0.500,Pig,23-5,0,1,0,1,0.000,0.000
14,0.500,Barn Owl,16-23,0,0,0,0,NaN,NaN
14,0.500,Barn Owl,23-5,0,0,0,0,NaN,NaN
14,0.500,Wild Pig,16-23,0,0,0,0,NaN,NaN
14,0.500,Wild Pig,23-5,0,0,0,0,NaN,NaN
14,0.500,Pennington Creek Water,16-23,0,0,0,0,NaN,NaN
14,0.500,Pennington Creek Water,23-5,0,0,0,0,NaN,NaN
14,0.500,Guinni,16-23,0,0,0,0,NaN,NaN
14,0.500,Guinni,23-5,0,0,0,0,NaN,NaN
14,0.500,Racoon,16-23,0,0,0,0,NaN,NaN
14,0.500,Racoon,23-5,0,0,0,0,NaN,NaN
14,0.500,Hu,16-23,12,8,0,20,60.000,60.000
14,0.500,Hu,23-5,22,18,0,40,55.000,55.000
14,0.500,Cw and Dg,16-23,7,12,0,19,36.842,36.842
14,0.500,Cw and Dg,23-5,13,16,0,29,44.828,44.828
14,0.500,Red Wind Blackbird,16-23,0,0,0,0,NaN,NaN
14,0.500,Red Wind Blackbird,23-5,0,0,0,0,NaN,NaN
14,0.500,Tree Swallow,16-23,0,0,0,0,NaN,NaN
14,0.500,Tree Swallow,23-5,0,0,0,0,NaN,NaN
14,0.500,Turkey Vulture,16-23,0,0,0,0,NaN,NaN
14,0.500,Turkey Vulture,23-5,0,0,0,0,NaN,NaN
14,0.500,Dg,16-23,7,9,0,16,43.750,43.750
14,0.500,Dg,23-5,31,35,0,66,46.970,46.970
14,0.500,Western Kingbird,16-23,0,0,0,0,NaN,NaN
14,0.500,Western Kingbird,23-5,0,0,0,0,NaN,NaN
14,0.500,White Crowned Sparrow,16-23,0,0,0,0,NaN,NaN
14,0.500,White Crowned Sparrow,23-5,0,5,0,5,0.000,0.000
14,0.500,Eared Grebe,16-23,0,0,0,0,NaN,NaN
14,0.500,Eared Grebe,23-5,0,5,0,5,0.000,0.000
14,0.500,cougar,16-23,0,0,0,0,NaN,NaN
14,0.500,cougar,23-5,0,0,0,0,NaN,NaN
14,0.500,Ocean Water,16-23,0,0,0,0,NaN,NaN
14,0.500,Ocean Water,23-5,0,0,0,0,NaN,NaN
14,0.500,Red Tailed Hawk,16-23,0,0,0,0,NaN,NaN
14,0.500,Red Tailed Hawk,23-5,0,1,0,1,0.000,0.000
14,0.500,Dog,16-23,51,72,0,123,41.463,41.463
14,0.500,Dog,23-5,81,146,0,227,35.683,35.683
14,0.500,Human,16-23,1727,845,0,2572,67.146,67.146
14,0.500,Human,23-5,2138,766,0,2904,73.623,73.623
14,0.500,Wild Turkey,16-23,1,2,0,3,33.333,33.333
14,0.500,Wild Turkey,23-5,0,6,0,6,0.000,0.000
14,0.500,Clark Grebe,16-23,0,0,0,0,NaN,NaN
14,0.500,Clark Grebe,23-5,0,0,0,0,NaN,NaN
14,0.500,Seagull,16-23,0,0,0,0,NaN,NaN
14,0.500,Seagull,23-5,3,8,0,11,27.273,27.273
14,0.500,Surf Scoter,16-23,0,0,0,0,NaN,NaN
14,0.500,Surf Scoter,23-5,0,0,0,0,NaN,NaN
14,0.500,Pigeon,16-23,21,124,0,145,14.483,14.483
14,0.500,Pigeon,23-5,65,134,0,199,32.663,32.663
14,0.500,Pacific Ocean Water,16-23,0,0,0,0,NaN,NaN
14,0.500,Pacific Ocean Water,23-5,0,0,0,0,NaN,NaN
14,0.500,Cat,16-23,16,20,0,36,44.444,44.444
14,0.500,Cat,23-5,16,20,0,36,44.444,44.444
14,0.500,Horse,16-23,5,9,0,14,35.714,35.714
14,0.500,Horse,23-5,20,67,0,87,22.989,22.989
14,0.500,orangutan,16-23,0,0,0,0,NaN,NaN
14,0.500,orangutan,23-5,0,0,0,0,NaN,NaN
14,0.500,Bat,16-23,36,36,0,72,50.000,50.000
14,0.500,Bat,23-5,37,36,0,73,50.685,50.685
14,0.500,Deer,16-23,11,40,0,51,21.569,21.569
14,0.500,Deer,23-5,16,123,0,139,11.511,11.511
14,0.500,Great Horned Owl,16-23,0,0,0,0,NaN,NaN
14,0.500,Great Horned Owl,23-5,0,0,0,0,NaN,NaN
14,0.500,Freshwater Lagoon,16-23,0,0,0,0,NaN,NaN
14,0.500,Freshwater Lagoon,23-5,0,0,0,0,NaN,NaN
14,0.500,Unknown Avian,16-23,0,0,0,0,NaN,NaN
14,0.500,Unknown Avian,23-5,0,0,0,0,NaN,NaN
14,0.500,Human UTI,16-23,73,80,0,153,47.712,47.712
14,0.500,Human UTI,23-5,95,115,0,210,45.238,45.238
14,0.500,unknown,16-23,0,0,0,0,NaN,NaN
14,0.500,unknown,23-5,0,2,0,2,0.000,0.000
14,0.500,SLO Creek Water,16-23,0,0,0,0,NaN,NaN
14,0.500,SLO Creek Water,23-5,0,0,0,0,NaN,NaN
14,0.500,Pig/Swine,16-23,3,5,0,8,37.500,37.500
14,0.500,Pig/Swine,23-5,8,10,0,18,44.444,44.444
14,0.500,Klebsiella,16-23,0,0,0,0,NaN,NaN
14,0.500,Klebsiella,23-5,0,0,0,0,NaN,NaN
14,0.500,Hu Cw and Dg,16-23,5,10,0,15,33.333,33.333
14,0.500,Hu Cw and Dg,23-5,5,5,0,10,50.000,50.000
14,0.500,Ground Squirrel,16-23,75,49,0,124,60.484,60.484
14,0.500,Ground Squirrel,23-5,79,66,0,145,54.483,54.483
14,0.500,Opossum,16-23,0,0,0,0,NaN,NaN
14,0.500,Opossum,23-5,0,0,0,0,NaN,NaN
14,0.500,Cow,16-23,1564,1268,0,2832,55.226,55.226
14,0.500,Cow,23-5,1534,1664,0,3198,47.967,47.967
14,0.500,Deer Mouse,16-23,0,0,0,0,NaN,NaN
14,0.500,Deer Mouse,23-5,0,0,0,0,NaN,NaN
14,0.500,OVERALL,16-23,3678,2670,0,6348,57.940,57.940
14,0.500,OVERALL,23-5,4260,3350,0,7610,55.979,55.979
14,0.900,Chicken,16-23,0,0,0,0,NaN,NaN
14,0.900,Chicken,23-5,5,2,0,7,71.429,71.429
14,0.900,Sea Lion,16-23,0,0,0,0,NaN,NaN
14,0.900,Sea Lion,23-5,0,10,0,10,0.000,0.000
14,0.900,Hu and Cw,16-23,1,5,0,6,16.667,16.667
14,0.900,Hu and Cw,23-5,9,7,0,16,56.250,56.250
14,0.900,Sheep,16-23,44,51,0,95,46.316,46.316
14,0.900,Sheep,23-5,54,36,0,90,60.000,60.000
14,0.900,Hu and Dg,16-23,7,8,0,15,46.667,46.667
14,0.900,Hu and Dg,23-5,20,25,0,45,44.444,44.444
14,0.900,Common Loon,16-23,0,0,0,0,NaN,NaN
14,0.900,Common Loon,23-5,0,0,0,0,NaN,NaN
14,0.900,Red-Winged Blackbird,16-23,0,0,0,0,NaN,NaN
14,0.900,Red-Winged Blackbird,23-5,0,0,0,0,NaN,NaN
14,0.900,Cw,16-23,6,7,0,13,46.154,46.154
14,0.900,Cw,23-5,9,21,0,30,30.000,30.000
14,0.900,Cliff Sparrow,16-23,0,4,0,4,0.000,0.000
14,0.900,Cliff Sparrow,23-5,0,0,0,0,NaN,NaN
14,0.900,Pig,16-23,6,6,0,12,50.000,50.000
14,0.900,Pig,23-5,0,1,0,1,0.000,0.000
14,0.900,Barn Owl,16-23,0,0,0,0,NaN,NaN
14,0.900,Barn Owl,23-5,0,0,0,0,NaN,NaN
14,0.900,Wild Pig,16-23,0,0,0,0,NaN,NaN
14,0.900,Wild Pig,23-5,0,0,0,0,NaN,NaN
14,0.900,Pennington Creek Water,16-23,0,0,0,0,NaN,NaN
14,0.900,Pennington Creek Water,23-5,0,0,0,0,NaN,NaN
14,0.900,Guinni,16-23,0,0,0,0,NaN,NaN
14,0.900,Guinni,23-5,0,0,0,0,NaN,NaN
14,0.900,Racoon,16-23,0,0,0,0,NaN,NaN
14,0.900,Racoon,23-5,0,0,0,0,NaN,NaN
14,0.900,Hu,16-23,12,8,0,20,60.000,60.000
14,0.900,Hu,23-5,22,18,0,40,55.000,55.000
14,0.900,Cw and Dg,16-23,7,12,0,19,36.842,36.842
14,0.900,Cw and Dg,23-5,13,16,0,29,44.828,44.828
14,0.900,Red Wind Blackbird,16-23,0,0,0,0,NaN,NaN
14,0.900,Red Wind Blackbird,23-5,0,0,0,0,NaN,NaN
14,0.900,Tree Swallow,16-23,0,0,0,0,NaN,NaN
14,0.900,Tree Swallow,23-5,0,0,0,0,NaN,NaN
14,0.900,Turkey Vulture,16-23,0,0,0,0,NaN,NaN
14,0.900,Turkey Vulture,23-5,0,0,0,0,NaN,NaN
14,0.900,Dg,16-23,7,9,0,16,43.750,43.750
14,0.900,Dg,23-5,31,35,0,66,46.970,46.970
14,0.900,Western Kingbird,16-23,0,0,0,0,NaN,NaN
14,0.900,Western Kingbird,23-5,0,0,0,0,NaN,NaN
14,0.900,White Crowned Sparrow,16-23,0,0,0,0,NaN,NaN
14,0.900,White Crowned Sparrow,23-5,0,5,0,5,0.000,0.000
14,0.900,Eared Grebe,16-23,0,0,0,0,NaN,NaN
14,0.900,Eared Grebe,23-5,0,5,0,5,0.000,0.000
14,0.900,cougar,16-23,0,0,0,0,NaN,NaN
14,0.900,cougar,23-5,0,0,0,0,NaN,NaN
14,0.900,Ocean Water,16-23,0,0,0,0,NaN,NaN
14,0.900,Ocean Water,23-5,0,0,0,0,NaN,NaN
14,0.900,Red Tailed Hawk,16-23,0,0,0,0,NaN,NaN
14,0.900,Red Tailed Hawk,23-5,0,1,0,1,0.000,0.000
14,0.900,Dog,16-23,51,72,0,123,41.463,41.463
14,0.900,Dog,23-5,81,141,0,222,36.486,36.486
14,0.900,Human,16-23,1727,842,0,2569,67.225,67.225
14,0.900,Human,23-5,2138,762,0,2900,73.724,73.724
14,0.900,Wild Turkey,16-23,1,2,0,3,33.333,33.333
14,0.900,Wild Turkey,23-5,0,6,0,6,0.000,0.000
14,0.900,Clark Grebe,16-23,0,0,0,0,NaN,NaN
14,0.900,Clark Grebe,23-5,0,0,0,0,NaN,NaN
14,0.900,Seagull,16-23,0,0,0,0,NaN,NaN
14,0.900,Seagull,23-5,3,9,0,12,25.000,25.000
14,0.900,Surf Scoter,16-23,0,0,0,0,NaN,NaN
14,0.900,Surf Scoter,23-5,0,0,0,0,NaN,NaN
14,0.900,Pigeon,16-23,21,125,0,146,14.384,14.384
14,0.900,Pigeon,23-5,65,134,0,199,32.663,32.663
14,0.900,Pacific Ocean Water,16-23,0,0,0,0,NaN,NaN
14,0.900,Pacific Ocean Water,23-5,0,0,0,0,NaN,NaN
14,0.900,Cat,16-23,16,20,0,36,44.444,44.444
14,0.900,Cat,23-5,16,20,0,36,44.444,44.444
14,0.900,Horse,16-23,5,9,0,14,35.714,35.714
14,0.900,Horse,23-5,20,67,0,87,22.989,22.989
14,0.900,orangutan,16-23,0,0,0,0,NaN,NaN
14,0.900,orangutan,23-5,0,0,0,0,NaN,NaN
14,0.900,Bat,16-23,36,36,0,72,50.000,50.000
14,0.900,Bat,23-5,37,36,0,73,50.685,50.685
14,0.900,Deer,16-23,11,40,0,51,21.569,21.569
14,0.900,Deer,23-5,16,123,0,139,11.511,11.511
14,0.900,Great Horned Owl,16-23,0,0,0,0,NaN,NaN
14,0.900,Great Horned Owl,23-5,0,0,0,0,NaN,NaN
14,0.900,Freshwater Lagoon,16-23,0,0,0,0,NaN,NaN
14,0.900,Freshwater Lagoon,23-5,0,0,0,0,NaN,NaN
14,0.900,Unknown Avian,16-23,0,0,0,0,NaN,NaN
14,0.900,Unknown Avian,23-5,0,0,0,0,NaN,NaN
14,0.900,Human UTI,16-23,73,80,0,153,47.712,47.712
14,0.900,Human UTI,23-5,98,115,0,213,46.009,46.009
14,0.900,unknown,16-23,0,0,0,0,NaN,NaN
14,0.900,unknown,23-5,0,2,0,2,0.000,0.000
14,0.900,SLO Creek Water,16-23,0,0,0,0,NaN,NaN
14,0.900,SLO Creek Water,23-5,0,0,0,0,NaN,NaN
14,0.900,Pig/Swine,16-23,3,5,0,8,37.500,37.500
14,0.900,Pig/Swine,23-5,8,10,0,18,44.444,44.444
14,0.900,Klebsiella,16-23,0,0,0,0,NaN,NaN
14,0.900,Klebsiella,23-5,0,0,0,0,NaN,NaN
14,0.900,Hu Cw and Dg,16-23,5,10,0,15,33.333,33.333
14,0.900,Hu Cw and Dg,23-5,5,5,0,10,50.000,50.000
14,0.900,Ground Squirrel,16-23,75,49,0,124,60.484,60.484
14,0.900,Ground Squirrel,23-5,79,66,0,145,54.483,54.483
14,0.900,Opossum,16-23,0,0,0,0,NaN,NaN
14,0.900,Opossum,23-5,0,0,0,0,NaN,NaN
14,0.900,Cow,16-23,1566,1264,0,2830,55.336,55.336
14,0.900,Cow,23-5,1534,1661,0,3195,48.013,48.013
14,0.900,Deer Mouse,16-23,0,0,0,0,NaN,NaN
14,0.900,Deer Mouse,23-5,0,0,0,0,NaN,NaN
14,0.900,OVERALL,16-23,3680,2664,0,6344,58.008,58.008
14,0.900,OVERALL,23-5,4263,3339,0,7602,56.077,56.077
14,0.950,Chicken,16-23,0,0,0,0,NaN,NaN
14,0.950,Chicken,23-5,5,2,0,7,71.429,71.429
14,0.950,Sea Lion,16-23,0,0,0,0,NaN,NaN
14,0.950,Sea Lion,23-5,0,10,0,10,0.000,0.000
14,0.950,Hu and Cw,16-23,1,5,0,6,16.667,16.667
14,0.950,Hu and Cw,23-5,9,7,0,16,56.250,56.250
14,0.950,Sheep,16-23,44,51,0,95,46.316,46.316
14,0.950,Sheep,23-5,54,36,0,90,60.000,60.000
14,0.950,Hu and Dg,16-23,7,8,0,15,46.667,46.667
14,0.950,Hu and Dg,23-5,20,25,0,45,44.444,44.444
14,0.950,Common Loon,16-23,0,0,0,0,NaN,NaN
14,0.950,Common Loon,23-5,0,0,0,0,NaN,NaN
14,0.950,Red-Winged Blackbird,16-23,0,0,0,0,NaN,NaN
14,0.950,Red-Winged Blackbird,23-5,0,0,0,0,NaN,NaN
14,0.950,Cw,16-23,6,7,0,13,46.154,46.154
14,0.950,Cw,23-5,9,21,0,30,30.000,30.000
14,0.950,Cliff Sparrow,16-23,0,4,0,4,0.000,0.000
14,0.950,Cliff Sparrow,23-5,0,0,0,0,NaN,NaN
14,0.950,Pig,16-23,6,6,0,12,50.000,50.000
14,0.950,Pig,23-5,0,1,0,1,0.000,0.000
14,0.950,Barn Owl,16-23,0,0,0,0,NaN,NaN
14,0.950,Barn Owl,23-5,0,0,0,0,NaN,NaN
14,0.950,Wild Pig,16-23,0,0,0,0,NaN,NaN
14,0.950,Wild Pig,23-5,0,0,0,0,NaN,NaN
14,0.950,Pennington Creek Water,16-23,0,0,0,0,NaN,NaN
14,0.950,Pennington Creek Water,23-5,0,0,0,0,NaN,NaN
14,0.950,Guinni,16-23,0,0,0,0,NaN,NaN
14,0.950,Guinni,23-5,0,0,0,0,NaN,NaN
14,0.950,Racoon,16-23,0,0,0,0,NaN,NaN
14,0.950,Racoon,23-5,0,0,0,0,NaN,NaN
14,0.950,Hu,16-23,12,8,0,20,60.000,60.000
14,0.950,Hu,23-5,22,18,0,40,55.000,55.000
14,0.950,Cw and Dg,16-23,7,12,0,19,36.842,36.842
14,0.950,Cw and Dg,23-5,13,16,0,29,44.828,44.828
14,0.950,Red Wind Blackbird,16-23,0,0,0,0,NaN,NaN
14,0.950,Red Wind Blackbird,23-5,0,0,0,0,NaN,NaN
14,0.950,Tree Swallow,16-23,0,0,0,0,NaN,NaN
14,0.950,Tree Swallow,23-5,0,0,0,0,NaN,NaN
14,0.950,Turkey Vulture,16-23,0,0,0,0,NaN,NaN
14,0.950,Turkey Vulture,23-5,0,0,0,0,NaN,NaN
14,0.950,Dg,16-23,7,9,0,16,43.750,43.750
14,0.950,Dg,23-5,31,35,0,66,46.970,46.970
14,0.950,Western Kingbird,16-23,0,0,0,0,NaN,NaN
14,0.950,Western Kingbird,23-5,0,0,0,0,NaN,NaN
14,0.950,White Crowned Sparrow,16-23,0,0,0,0,NaN,NaN
14,0.950,White Crowned Sparrow,23-5,0,5,0,5,0.000,0.000
14,0.950,Eared Grebe,16-23,0,0,0,0,NaN,NaN
14,0.950,Eared Grebe,23-5,0,5,0,5,0.000,0.000
14,0.950,cougar,16-23,0,0,0,0,NaN,NaN
14,0.950,cougar,23-5,0,0,0,0,NaN,NaN
14,0.950,Ocean Water,16-23,0,0,0,0,NaN,NaN
14,0.950,Ocean Water,23-5,0,0,0,0,NaN,NaN
14,0.950,Red Tailed Hawk,16-23,0,0,0,0,NaN,NaN
14,0.950,Red Tailed Hawk,23-5,0,1,0,1,0.000,0.000
14,0.950,Dog,16-23,51,72,0,123,41.463,41.463
14,0.950,Dog,23-5,81,139,0,220,36.818,36.818
14,0.950,Human,16-23,1727,839,0,2566,67.303,67.303
14,0.950,Human,23-5,2132,754,0,2886,73.874,73.874
14,0.950,Wild Turkey,16-23,1,2,0,3,33.333,33.333
14,0.950,Wild Turkey,23-5,0,5,0,5,0.000,0.000
14,0.950,Clark Grebe,16-23,0,0,0,0,NaN,NaN
14,0.950,Clark Grebe,23-5,0,0,0,0,NaN,NaN
14,0.950,Seagull,16-23,0,0,0,0,NaN,NaN
14,0.950,Seagull,23-5,3,8,0,11,27.273,27.273
14,0.950,Surf Scoter,16-23,0,0,0,0,NaN,NaN
14,0.950,Surf Scoter,23-5,0,0,0,0,NaN,NaN
14,0.950,Pigeon,16-23,22,124,0,146,15.068,15.068
14,0.950,Pigeon,23-5,65,135,0,200,32.500,32.500
14,0.950,Pacific Ocean Water,16-23,0,0,0,0,NaN,NaN
14,0.950,Pacific Ocean Water,23-5,0,0,0,0,NaN,NaN
14,0.950,Cat,16-23,16,20,0,36,44.444,44.444
14,0.950,Cat,23-5,16,26,0,42,38.095,38.095
14,0.950,Horse,16-23,5,9,0,14,35.714,35.714
14,0.950,Horse,23-5,20,67,0,87,22.989,22.989
14,0.950,orangutan,16-23,0,0,0,0,NaN,NaN
14,0.950,orangutan,23-5,0,0,0,0,NaN,NaN
14,0.950,Bat,16-23,36,36,0,72,50.000,50.000
14,0.950,Bat,23-5,37,35,0,72,51.389,51.389
14,0.950,Deer,16-23,11,40,0,51,21.569,21.569
14,0.950,Deer,23-5,16,123,0,139,11.511,11.511
14,0.950,Great Horned Owl,16-23,0,0,0,0,NaN,NaN
14,0.950,Great Horned Owl,23-5,0,0,0,0,NaN,NaN
14,0.950,Freshwater Lagoon,16-23,0,0,0,0,NaN,NaN
14,0.950,Freshwater Lagoon,23-5,0,0,0,0,NaN,NaN
14,0.950,Unknown Avian,16-23,0,0,0,0,NaN,NaN
14,0.950,Unknown Avian,23-5,0,0,0,0,NaN,NaN
14,0.950,Human UTI,16-23,76,81,0,157,48.408,48.408
14,0.950,Human UTI,23-5,97,118,0,215,45.116,45.116
14,0.950,unknown,16-23,0,0,0,0,NaN,NaN
14,0.950,unknown,23-5,0,2,0,2,0.000,0.000
14,0.950,SLO Creek Water,16-23,0,0,0,0,NaN,NaN
14,0.950,SLO Creek Water,23-5,0,0,0,0,NaN,NaN
14,0.950,Pig/Swine,16-23,3,5,0,8,37.500,37.500
14,0.950,Pig/Swine,23-5,8,10,0,18,44.444,44.444
14,0.950,Klebsiella,16-23,0,0,0,0,NaN,NaN
14,0.950,Klebsiella,23-5,0,0,0,0,NaN,NaN
14,0.950,Hu Cw and Dg,16-23,5,10,0,15,33.333,33.333
14,0.950,Hu Cw and Dg,23-5,5,5,0,10,50.000,50.000
14,0.950,Ground Squirrel,16-23,75,49,0,124,60.484,60.484
14,0.950,Ground Squirrel,23-5,79,65,0,144,54.861,54.861
14,0.950,Opossum,16-23,0,0,0,0,NaN,NaN
14,0.950,Opossum,23-5,0,0,0,0,NaN,NaN
14,0.950,Cow,16-23,1569,1243,0,2812,55.797,55.797
14,0.950,Cow,23-5,1533,1659,0,3192,48.026,48.026
14,0.950,Deer Mouse,16-23,0,0,0,0,NaN,NaN
14,0.950,Deer Mouse,23-5,0,0,0,0,NaN,NaN
14,0.950,OVERALL,16-23,3687,2640,0,6327,58.274,58.274
14,0.950,OVERALL,23-5,4255,3333,0,7588,56.075,56.075
14,0.960,Chicken,16-23,0,0,0,0,NaN,NaN
14,0.960,Chicken,23-5,5,2,0,7,71.429,71.429
14,0.960,Sea Lion,16-23,0,0,0,0,NaN,NaN
14,0.960,Sea Lion,23-5,0,10,0,10,0.000,0.000
14,0.960,Hu and Cw,16-23,1,5,0,6,16.667,16.667
14,0.960,Hu and Cw,23-5,9,7,0,16,56.250,56.250
14,0.960,Sheep,16-23,44,51,0,95,46.316,46.316
14,0.960,Sheep,23-5,54,37,0,91,59.341,59.341
14,0.960,Hu and Dg,16-23,7,8,0,15,46.667,46.667
14,0.960,Hu and Dg,23-5,20,25,0,45,44.444,44.444
14,0.960,Common Loon,16-23,0,0,0,0,NaN,NaN
14,0.960,Common Loon,23-5,0,0,0,0,NaN,NaN
14,0.960,Red-Winged Blackbird,16-23,0,0,0,0,NaN,NaN
14,0.960,Red-Winged Blackbird,23-5,0,0,0,0,NaN,NaN
14,0.960,Cw,16-23,6,7,0,13,46.154,46.154
14,0.960,Cw,23-5,9,21,0,30,30.000,30.000
14,0.960,Cliff Sparrow,16-23,0,4,0,4,0.000,0.000
14,0.960,Cliff Sparrow,23-5,0,0,0,0,NaN,NaN
14,0.960,Pig,16-23,6,6,0,12,50.000,50.000
14,0.960,Pig,23-5,0,1,0,1,0.000,0.000
14,0.960,Barn Owl,16-23,0,0,0,0,NaN,NaN
14,0.960,Barn Owl,23-5,0,0,0,0,NaN,NaN
14,0.960,Wild Pig,16-23,0,0,0,0,NaN,NaN
14,0.960,Wild Pig,23-5,1,0,0,1,100.000,100.000
14,0.960,Pennington Creek Water,16-23,0,0,0,0,NaN,NaN
14,0.960,Pennington Creek Water,23-5,0,0,0,0,NaN,NaN
14,0.960,Guinni,16-23,0,0,0,0,NaN,NaN
14,0.960,Guinni,23-5,0,0,0,0,NaN,NaN
14,0.960,Racoon,16-23,0,0,0,0,NaN,NaN
14,0.960,Racoon,23-5,0,0,0,0,NaN,NaN
14,0.960,Hu,16-23,12,8,0,20,60.000,60.000
14,0.960,Hu,23-5,22,18,0,40,55.000,55.000
14,0.960,Cw and Dg,16-23,7,12,0,19,36.842,36.842
14,0.960,Cw and Dg,23-5,13,16,0,29,44.828,44.828
14,0.960,Red Wind Blackbird,16-23,0,0,0,0,NaN,NaN
14,0.960,Red Wind Blackbird,23-5,0,0,0,0,NaN,NaN
14,0.960,Tree Swallow,16-23,0,0,0,0,NaN,NaN
14,0.960,Tree Swallow,23-5,0,0,0,0,NaN,NaN
14,0.960,Turkey Vulture,16-23,0,0,0,0,NaN,NaN
14,0.960,Turkey Vulture,23-5,0,0,0,0,NaN,NaN
14,0.960,Dg,16-23,7,9,0,16,43.750,43.750
14,0.960,Dg,23-5,31,35,0,66,46.970,46.970
14,0.960,Western Kingbird,16-23,0,0,0,0,NaN,NaN
14,0.960,Western Kingbird,23-5,0,0,0,0,NaN,NaN
14,0.960,White Crowned Sparrow,16-23,0,0,0,0,NaN,NaN
14,0.960,White Crowned Sparrow,23-5,0,5,0,5,0.000,0.000
14,0.960,Eared Grebe,16-23,0,0,0,0,NaN,NaN
14,0.960,Eared Grebe,23-5,0,5,0,5,0.000,0.000
14,0.960,cougar,16-23,0,0,0,0,NaN,NaN
14,0.960,cougar,23-5,0,0,0,0,NaN,NaN
14,0.960,Ocean Water,16-23,0,0,0,0,NaN,NaN
14,0.960,Ocean Water,23-5,0,0,0,0,NaN,NaN
14,0.960,Red Tailed Hawk,16-23,0,0,0,0,NaN,NaN
14,0.960,Red Tailed Hawk,23-5,0,1,0,1,0.000,0.000
14,0.960,Dog,16-23,51,72,0,123,41.463,41.463
14,0.960,Dog,23-5,81,134,0,215,37.674,37.674
14,0.960,Human,16-23,1728,838,0,2566,67.342,67.342
14,0.960,Human,23-5,2137,739,0,2876,74.305,74.305
14,0.960,Wild Turkey,16-23,1,2,0,3,33.333,33.333
14,0.960,Wild Turkey,23-5,0,10,0,10,0.000,0.000
14,0.960,Clark Grebe,16-23,0,0,0,0,NaN,NaN
14,0.960,Clark Grebe,23-5,0,0,0,0,NaN,NaN
14,0.960,Seagull,16-23,0,0,0,0,NaN,NaN
14,0.960,Seagull,23-5,3,9,0,12,25.000,25.000
14,0.960,Surf Scoter,16-23,0,0,0,0,NaN,NaN
14,0.960,Surf Scoter,23-5,0,2,0,2,0.000,0.000
14,0.960,Pigeon,16-23,22,124,0,146,15.068,15.068
14,0.960,Pigeon,23-5,66,151,0,217,30.415,30.415
14,0.960,Pacific Ocean Water,16-23,0,0,0,0,NaN,NaN
14,0.960,Pacific Ocean Water,23-5,0,0,0,0,NaN,NaN
14,0.960,Cat,16-23,16,20,0,36,44.444,44.444
14,0.960,Cat,23-5,16,26,0,42,38.095,38.095
14,0.960,Horse,16-23,5,9,0,14,35.714,35.714
14,0.960,Horse,23-5,20,67,0,87,22.989,22.989
14,0.960,orangutan,16-23,0,0,0,0,NaN,NaN
14,0.960,orangutan,23-5,0,0,0,0,NaN,NaN
14,0.960,Bat,16-23,36,36,0,72,50.000,50.000
14,0.960,Bat,23-5,37,35,0,72,51.389,51.389
14,0.960,Deer,16-23,11,40,0,51,21.569,21.569
14,0.960,Deer,23-5,16,123,0,139,11.511,11.511
14,0.960,Great Horned Owl,16-23,0,0,0,0,NaN,NaN
14,0.960,Great Horned Owl,23-5,0,0,0,0,NaN,NaN
14,0.960,Freshwater Lagoon,16-23,0,0,0,0,NaN,NaN
14,0.960,Freshwater Lagoon,23-5,0,0,0,0,NaN,NaN
14,0.960,Unknown Avian,16-23,0,0,0,0,NaN,NaN
14,0.960,Unknown Avian,23-5,0,0,0,0,NaN,NaN
14,0.960,Human UTI,16-23,76,82,0,158,48.101,48.101
14,0.960,Human UTI,23-5,97,117,0,214,45.327,45.327
14,0.960,unknown,16-23,0,0,0,0,NaN,NaN
14,0.960,unknown,23-5,0,2,0,2,0.000,0.000
14,0.960,SLO Creek Water,16-23,0,0,0,0,NaN,NaN
14,0.960,SLO Creek Water,23-5,0,0,0,0,NaN,NaN
14,0.960,Pig/Swine,16-23,3,5,0,8,37.500,37.500
14,0.960,Pig/Swine,23-5,8,10,0,18,44.444,44.444
14,0.960,Klebsiella,16-23,0,0,0,0,NaN,NaN
14,0.960,Klebsiella,23-5,0,0,0,0,NaN,NaN
14,0.960,Hu Cw and Dg,16-23,5,10,0,15,33.333,33.333
14,0.960,Hu Cw and Dg,23-5,5,5,0,10,50.000,50.000
14,0.960,Ground Squirrel,16-23,75,49,0,124,60.484,60.484
14,0.960,Ground Squirrel,23-5,79,67,0,146,54.110,54.110
14,0.960,Opossum,16-23,0,0,0,0,NaN,NaN
14,0.960,Opossum,23-5,0,0,0,0,NaN,NaN
14,0.960,Cow,16-23,1567,1233,0,2800,55.964,55.964
14,0.960,Cow,23-5,1533,1635,0,3168,48.390,48.390
14,0.960,Deer Mouse,16-23,0,0,0,0,NaN,NaN
14,0.960,Deer Mouse,23-5,0,0,0,0,NaN,NaN
14,0.960,OVERALL,16-23,3686,2630,0,6316,58.360,58.360
14,0.960,OVERALL,23-5,4262,3315,0,7577,56.249,56.249
14,0.970,Chicken,16-23,0,0,0,0,NaN,NaN
14,0.970,Chicken,23-5,5,2,0,7,71.429,71.429
14,0.970,Sea Lion,16-23,0,0,0,0,NaN,NaN
14,0.970,Sea Lion,23-5,0,10,0,10,0.000,0.000
14,0.970,Hu and Cw,16-23,1,5,0,6,16.667,16.667
14,0.970,Hu and Cw,23-5,9,7,0,16,56.250,56.250
14,0.970,Sheep,16-23,45,52,0,97,46.392,46.392
14,0.970,Sheep,23-5,54,36,0,90,60.000,60.000
14,0.970,Hu and Dg,16-23,7,8,0,15,46.667,46.667
14,0.970,Hu and Dg,23-5,20,25,0,45,44.444,44.444
14,0.970,Common Loon,16-23,0,0,0,0,NaN,NaN
14,0.970,Common Loon,23-5,0,0,0,0,NaN,NaN
14,0.970,Red-Winged Blackbird,16-23,0,0,0,0,NaN,NaN
14,0.970,Red-Winged Blackbird,23-5,0,0,0,0,NaN,NaN
14,0.970,Cw,16-23,6,8,0,14,42.857,42.857
14,0.970,Cw,23-5,9,21,0,30,30.000,30.000
14,0.970,Cliff Sparrow,16-23,0,4,0,4,0.000,0.000
14,0.970,Cliff Sparrow,23-5,0,0,0,0,NaN,NaN
14,0.970,Pig,16-23,6,6,0,12,50.000,50.000
14,0.970,Pig,23-5,0,1,0,1,0.000,0.000
14,0.970,Barn Owl,16-23,0,0,0,0,NaN,NaN
14,0.970,Barn Owl,23-5,0,0,0,0,NaN,NaN
14,0.970,Wild Pig,16-23,0,0,0,0,NaN,NaN
14,0.970,Wild Pig,23-5,0,0,0,0,NaN,NaN
14,0.970,Pennington Creek Water,16-23,0,0,0,0,NaN,NaN
14,0.970,Pennington Creek Water,23-5,0,0,0,0,NaN,NaN
14,0.970,Guinni,16-23,0,0,0,0,NaN,NaN
14,0.970,Guinni,23-5,0,0,0,0,NaN,NaN
14,0.970,Racoon,16-23,0,0,0,0,NaN,NaN
14,0.970,Racoon,23-5,0,0,0,0,NaN,NaN
14,0.970,Hu,16-23,12,8,0,20,60.000,60.000
14,0.970,Hu,23-5,22,18,0,40,55.000,55.000
14,0.970,Cw and Dg,16-23,7,12,0,19,36.842,36.842
14,0.970,Cw and Dg,23-5,13,16,0,29,44.828,44.828
14,0.970,Red Wind Blackbird,16-23,0,0,0,0,NaN,NaN
14,0.970,Red Wind Blackbird,23-5,0,0,0,0,NaN,NaN
14,0.970,Tree Swallow,16-23,0,0,0,0,NaN,NaN
14,0.970,Tree Swallow,23-5,0,0,0,0,NaN,NaN
14,0.970,Turkey Vulture,16-23,0,0,0,0,NaN,NaN
14,0.970,Turkey Vulture,23-5,0,0,0,0,NaN,NaN
14,0.970,Dg,16-23,7,9,0,16,43.750,43.750
14,0.970,Dg,23-5,31,34,0,65,47.692,47.692
14,0.970,Western Kingbird,16-23,0,0,0,0,NaN,NaN
14,0.970,Western Kingbird,23-5,0,0,0,0,NaN,NaN
14,0.970,White Crowned Sparrow,16-23,0,0,0,0,NaN,NaN
14,0.970,White Crowned Sparrow,23-5,0,5,0,5,0.000,0.000
14,0.970,Eared Grebe,16-23,0,0,0,0,NaN,NaN
14,0.970,Eared Grebe,23-5,0,5,0,5,0.000,0.000
14,0.970,cougar,16-23,0,0,0,0,NaN,NaN
14,0.970,cougar,23-5,0,0,0,0,NaN,NaN
14,0.970,Ocean Water,16-23,0,0,0,0,NaN,NaN
14,0.970,Ocean Water,23-5,0,0,0,0,NaN,NaN
14,0.970,Red Tailed Hawk,16-23,0,0,0,0,NaN,NaN
14,0.970,Red Tailed Hawk,23-5,0,1,0,1,0.000,0.000
14,0.970,Dog,16-23,52,72,0,124,41.935,41.935
14,0.970,Dog,23-5,83,133,0,216,38.426,38.426
14,0.970,Human,16-23,1727,835,0,2562,67.408,67.408
14,0.970,Human,23-5,2137,736,0,2873,74.382,74.382
14,0.970,Wild Turkey,16-23,1,4,0,5,20.000,20.000
14,0.970,Wild Turkey,23-5,2,9,0,11,18.182,18.182
14,0.970,Clark Grebe,16-23,0,0,0,0,NaN,NaN
14,0.970,Clark Grebe,23-5,0,0,0,0,NaN,NaN
14,0.970,Seagull,16-23,0,0,0,0,NaN,NaN
14,0.970,Seagull,23-5,3,10,0,13,23.077,23.077
14,0.970,Surf Scoter,16-23,0,0,0,0,NaN,NaN
14,0.970,Surf Scoter,23-5,0,2,0,2,0.000,0.000
14,0.970,Pigeon,16-23,21,123,0,144,14.583,14.583
14,0.970,Pigeon,23-5,66,167,0,233,28.326,28.326
14,0.970,Pacific Ocean Water,16-23,0,0,0,0,NaN,NaN
14,0.970,Pacific Ocean Water,23-5,0,0,0,0,NaN,NaN
14,0.970,Cat,16-23,16,20,0,36,44.444,44.444
14,0.970,Cat,23-5,16,23,0,39,41.026,41.026
14,0.970,Horse,16-23,5,9,0,14,35.714,35.714
14,0.970,Horse,23-5,20,68,0,88,22.727,22.727
14,0.970,orangutan,16-23,0,0,0,0,NaN,NaN
14,0.970,orangutan,23-5,0,0,0,0,NaN,NaN
14,0.970,Bat,16-23,36,36,0,72,50.000,50.000
14,0.970,Bat,23-5,37,35,0,72,51.389,51.389
14,0.970,Deer,16-23,11,40,0,51,21.569,21.569
14,0.970,Deer,23-5,16,123,0,139,11.511,11.511
14,0.970,Great Horned Owl,16-23,0,0,0,0,NaN,NaN
14,0.970,Great Horned Owl,23-5,0,0,0,0,NaN,NaN
14,0.970,Freshwater Lagoon,16-23,0,0,0,0,NaN,NaN
14,0.970,Freshwater Lagoon,23-5,0,0,0,0,NaN,NaN
14,0.970,Unknown Avian,16-23,0,0,0,0,NaN,NaN
14,0.970,Unknown Avian,23-5,0,0,0,0,NaN,NaN
14,0.970,Human UTI,16-23,76,83,0,159,47.799,47.799
14,0.970,Human UTI,23-5,96,117,0,213,45.070,45.070
14,0.970,unknown,16-23,0,0,0,0,NaN,NaN
14,0.970,unknown,23-5,0,2,0,2,0.000,0.000
14,0.970,SLO Creek Water,16-23,0,0,0,0,NaN,NaN
14,0.970,SLO Creek Water,23-5,0,0,0,0,NaN,NaN
14,0.970,Pig/Swine,16-23,3,5,0,8,37.500,37.500
14,0.970,Pig/Swine,23-5,8,10,0,18,44.444,44.444
14,0.970,Klebsiella,16-23,0,0,0,0,NaN,NaN
14,0.970,Klebsiella,23-5,0,0,0,0,NaN,NaN
14,0.970,Hu Cw and Dg,16-23,5,10,0,15,33.333,33.333
14,0.970,Hu Cw and Dg,23-5,5,5,0,10,50.000,50.000
14,0.970,Ground Squirrel,16-23,75,48,0,123,60.976,60.976
14,0.970,Ground Squirrel,23-5,79,65,0,144,54.861,54.861
14,0.970,Opossum,16-23,0,0,0,0,NaN,NaN
14,0.970,Opossum,23-5,0,0,0,0,NaN,NaN
14,0.970,Cow,16-23,1561,1229,0,2790,55.950,55.950
14,0.970,Cow,23-5,1530,1609,0,3139,48.742,48.742
14,0.970,Deer Mouse,16-23,0,0,0,0,NaN,NaN
14,0.970,Deer Mouse,23-5,0,0,0,0,NaN,NaN
14,0.970,OVERALL,16-23,3680,2626,0,6306,58.357,58.357
14,0.970,OVERALL,23-5,4261,3295,0,7556,56.392,56.392
14,0.980,Chicken,16-23,0,0,0,0,NaN,NaN
14,0.980,Chicken,23-5,6,2,0,8,75.000,75.000
14,0.980,Sea Lion,16-23,0,0,0,0,NaN,NaN
14,0.980,Sea Lion,23-5,0,10,0,10,0.000,0.000
14,0.980,Hu and Cw,16-23,1,5,0,6,16.667,16.667
14,0.980,Hu and Cw,23-5,9,17,0,26,34.615,34.615
14,0.980,Sheep,16-23,48,50,0,98,48.980,48.980
14,0.980,Sheep,23-5,53,35,0,88,60.227,60.227
14,0.980,Hu and Dg,16-23,7,8,0,15,46.667,46.667
14,0.980,Hu and Dg,23-5,20,22,0,42,47.619,47.619
14,0.980,Common Loon,16-23,0,0,0,0,NaN,NaN
14,0.980,Common Loon,23-5,0,0,0,0,NaN,NaN
14,0.980,Red-Winged Blackbird,16-23,0,0,0,0,NaN,NaN
14,0.980,Red-Winged Blackbird,23-5,0,0,0,0,NaN,NaN
14,0.980,Cw,16-23,6,7,0,13,46.154,46.154
14,0.980,Cw,23-5,9,23,0,32,28.125,28.125
14,0.980,Cliff Sparrow,16-23,0,4,0,4,0.000,0.000
14,0.980,Cliff Sparrow,23-5,0,0,0,0,NaN,NaN
14,0.980,Pig,16-23,6,6,0,12,50.000,50.000
14,0.980,Pig,23-5,0,1,0,1,0.000,0.000
14,0.980,Barn Owl,16-23,0,0,0,0,NaN,NaN
14,0.980,Barn Owl,23-5,0,0,0,0,NaN,NaN
14,0.980,Wild Pig,16-23,0,0,0,0,NaN,NaN
14,0.980,Wild Pig,23-5,0,0,0,0,NaN,NaN
14,0.980,Pennington Creek Water,16-23,0,0,0,0,NaN,NaN
14,0.980,Pennington Creek Water,23-5,0,0,0,0,NaN,NaN
14,0.980,Guinni,16-23,0,0,0,0,NaN,NaN
14,0.980,Guinni,23-5,0,0,0,0,NaN,NaN
14,0.980,Racoon,16-23,0,0,0,0,NaN,NaN
14,0.980,Racoon,23-5,0,0,0,0,NaN,NaN
14,0.980,Hu,16-23,12,8,0,20,60.000,60.000
14,0.980,Hu,23-5,22,19,0,41,53.659,53.659
14,0.980,Cw and Dg,16-23,7,12,0,19,36.842,36.842
14,0.980,Cw and Dg,23-5,13,18,0,31,41.935,41.935
14,0.980,Red Wind Blackbird,16-23,0,0,0,0,NaN,NaN
14,0.980,Red Wind Blackbird,23-5,0,0,0,0,NaN,NaN
14,0.980,Tree Swallow,16-23,0,0,0,0,NaN,NaN
14,0.980,Tree Swallow,23-5,0,0,0,0,NaN,NaN
14,0.980,Turkey Vulture,16-23,0,0,0,0,NaN,NaN
14,0.980,Turkey Vulture,23-5,0,0,0,0,NaN,NaN
14,0.980,Dg,16-23,7,9,0,16,43.750,43.750
14,0.980,Dg,23-5,31,27,0,58,53.448,53.448
14,0.980,Western Kingbird,16-23,0,0,0,0,NaN,NaN
14,0.980,Western Kingbird,23-5,0,0,0,0,NaN,NaN
14,0.980,White Crowned Sparrow,16-23,0,0,0,0,NaN,NaN
14,0.980,White Crowned Sparrow,23-5,0,7,0,7,0.000,0.000
14,0.980,Eared Grebe,16-23,0,0,0,0,NaN,NaN
14,0.980,Eared Grebe,23-5,0,5,0,5,0.000,0.000
14,0.980,cougar,16-23,0,0,0,0,NaN,NaN
14,0.980,cougar,23-5,0,0,0,0,NaN,NaN
14,0.980,Ocean Water,16-23,0,0,0,0,NaN,NaN
14,0.980,Ocean Water,23-5,0,0,0,0,NaN,NaN
14,0.980,Red Tailed Hawk,16-23,0,0,0,0,NaN,NaN
14,0.980,Red Tailed Hawk,23-5,0,1,0,1,0.000,0.000
14,0.980,Dog,16-23,51,77,0,128,39.844,39.844
14,0.980,Dog,23-5,84,127,0,211,39.810,39.810
14,0.980,Human,16-23,1726,821,0,2547,67.766,67.766
14,0.980,Human,23-5,2137,720,0,2857,74.799,74.799
14,0.980,Wild Turkey,16-23,1,4,0,5,20.000,20.000
14,0.980,Wild Turkey,23-5,4,19,0,23,17.391,17.391
14,0.980,Clark Grebe,16-23,0,0,0,0,NaN,NaN
14,0.980,Clark Grebe,23-5,0,0,0,0,NaN,NaN
14,0.980,Seagull,16-23,0,0,0,0,NaN,NaN
14,0.980,Seagull,23-5,5,8,0,13,38.462,38.462
14,0.980,Surf Scoter,16-23,0,0,0,0,NaN,NaN
14,0.980,Surf Scoter,23-5,2,0,0,2,100.000,100.000
14,0.980,Pigeon,16-23,21,123,0,144,14.583,14.583
14,0.980,Pigeon,23-5,65,175,0,240,27.083,27.083
14,0.980,Pacific Ocean Water,16-23,0,0,0,0,NaN,NaN
14,0.980,Pacific Ocean Water,23-5,0,0,0,0,NaN,NaN
14,0.980,Cat,16-23,16,20,0,36,44.444,44.444
14,0.980,Cat,23-5,17,19,0,36,47.222,47.222
14,0.980,Horse,16-23,5,9,0,14,35.714,35.714
14,0.980,Horse,23-5,20,66,0,86,23.256,23.256
14,0.980,orangutan,16-23,0,0,0,0,NaN,NaN
14,0.980,orangutan,23-5,0,0,0,0,NaN,NaN
14,0.980,Bat,16-23,36,36,0,72,50.000,50.000
14,0.980,Bat,23-5,37,35,0,72,51.389,51.389
14,0.980,Deer,16-23,11,40,0,51,21.569,21.569
14,0.980,Deer,23-5,16,123,0,139,11.511,11.511
14,0.980,Great Horned Owl,16-23,0,0,0,0,NaN,NaN
14,0.980,Great Horned Owl,23-5,0,0,0,0,NaN,NaN
14,0.980,Freshwater Lagoon,16-23,0,0,0,0,NaN,NaN
14,0.980,Freshwater Lagoon,23-5,0,0,0,0,NaN,NaN
14,0.980,Unknown Avian,16-23,0,0,0,0,NaN,NaN
14,0.980,Unknown Avian,23-5,0,0,0,0,NaN,NaN
14,0.980,Human UTI,16-23,76,85,0,161,47.205,47.205
14,0.980,Human UTI,23-5,97,116,0,213,45.540,45.540
14,0.980,unknown,16-23,0,0,0,0,NaN,NaN
14,0.980,unknown,23-5,0,3,0,3,0.000,0.000
14,0.980,SLO Creek Water,16-23,0,0,0,0,NaN,NaN
14,0.980,SLO Creek Water,23-5,0,0,0,0,NaN,NaN
14,0.980,Pig/Swine,16-23,3,5,0,8,37.500,37.500
14,0.980,Pig/Swine,23-5,8,10,0,18,44.444,44.444
14,0.980,Klebsiella,16-23,0,0,0,0,NaN,NaN
14,0.980,Klebsiella,23-5,0,0,0,0,NaN,NaN
14,0.980,Hu Cw and Dg,16-23,5,10,0,15,33.333,33.333
14,0.980,Hu Cw and Dg,23-5,5,4,0,9,55.556,55.556
14,0.980,Ground Squirrel,16-23,77,49,0,126,61.111,61.111
14,0.980,Ground Squirrel,23-5,80,64,0,144,55.556,55.556
14,0.980,Opossum,16-23,0,0,0,0,NaN,NaN
14,0.980,Opossum,23-5,0,0,0,0,NaN,NaN
14,0.980,Cow,16-23,1554,1212,0,2766,56.182,56.182
14,0.980,Cow,23-5,1523,1572,0,3095,49.208,49.208
14,0.980,Deer Mouse,16-23,0,0,0,0,NaN,NaN
14,0.980,Deer Mouse,23-5,0,0,0,0,NaN,NaN
14,0.980,OVERALL,16-23,3676,2600,0,6276,58.572,58.572
14,0.980,OVERALL,23-5,4263,3248,0,7511,56.757,56.757
14,0.990,Chicken,16-23,2,6,0,8,25.000,25.000
14,0.990,Chicken,23-5,7,2,0,9,77.778,77.778
14,0.990,Sea Lion,16-23,0,0,0,0,NaN,NaN
14,0.990,Sea Lion,23-5,2,7,0,9,22.222,22.222
14,0.990,Hu and Cw,16-23,2,5,0,7,28.571,28.571
14,0.990,Hu and Cw,23-5,10,24,0,34,29.412,29.412
14,0.990,Sheep,16-23,47,51,0,98,47.959,47.959
14,0.990,Sheep,23-5,54,35,0,89,60.674,60.674
14,0.990,Hu and Dg,16-23,7,10,0,17,41.176,41.176
14,0.990,Hu and Dg,23-5,20,19,0,39,51.282,51.282
14,0.990,Common Loon,16-23,0,0,0,0,NaN,NaN
14,0.990,Common Loon,23-5,0,2,0,2,0.000,0.000
14,0.990,Red-Winged Blackbird,16-23,0,2,0,2,0.000,0.000
14,0.990,Red-Winged Blackbird,23-5,0,0,0,0,NaN,NaN
14,0.990,Cw,16-23,7,7,0,14,50.000,50.000
14,0.990,Cw,23-5,15,25,0,40,37.500,37.500
14,0.990,Cliff Sparrow,16-23,0,6,0,6,0.000,0.000
14,0.990,Cliff Sparrow,23-5,0,4,0,4,0.000,0.000
14,0.990,Pig,16-23,6,7,0,13,46.154,46.154
14,0.990,Pig,23-5,7,8,0,15,46.667,46.667
14,0.990,Barn Owl,16-23,0,0,0,0,NaN,NaN
14,0.990,Barn Owl,23-5,0,0,0,0,NaN,NaN
14,0.990,Wild Pig,16-23,0,2,0,2,0.000,0.000
14,0.990,Wild Pig,23-5,0,1,0,1,0.000,0.000
14,0.990,Pennington Creek Water,16-23,0,0,0,0,NaN,NaN
14,0.990,Pennington Creek Water,23-5,0,0,0,0,NaN,NaN
14,0.990,Guinni,16-23,0,0,0,0,NaN,NaN
14,0.990,Guinni,23-5,0,0,0,0,NaN,NaN
14,0.990,Racoon,16-23,0,0,0,0,NaN,NaN
14,0.990,Racoon,23-5,0,1,0,1,0.000,0.000
14,0.990,Hu,16-23,12,8,0,20,60.000,60.000
14,0.990,Hu,23-5,22,14,0,36,61.111,61.111
14,0.990,Cw and Dg,16-23,7,12,0,19,36.842,36.842
14,0.990,Cw and Dg,23-5,14,12,0,26,53.846,53.846
14,0.990,Red Wind Blackbird,16-23,0,0,0,0,NaN,NaN
14,0.990,Red Wind Blackbird,23-5,0,0,0,0,NaN,NaN
14,0.990,Tree Swallow,16-23,0,0,0,0,NaN,NaN
14,0.990,Tree Swallow,23-5,0,0,0,0,NaN,NaN
14,0.990,Turkey Vulture,16-23,0,0,0,0,NaN,NaN
14,0.990,Turkey Vulture,23-5,0,0,0,0,NaN,NaN
14,0.990,Dg,16-23,7,9,0,16,43.750,43.750
14,0.990,Dg,23-5,31,21,0,52,59.615,59.615
14,0.990,Western Kingbird,16-23,0,0,0,0,NaN,NaN
14,0.990,Western Kingbird,23-5,0,0,0,0,NaN,NaN
14,0.990,White Crowned Sparrow,16-23,0,0,0,0,NaN,NaN
14,0.990,White Crowned Sparrow,23-5,0,8,0,8,0.000,0.000
14,0.990,Eared Grebe,16-23,0,0,0,0,NaN,NaN
14,0.990,Eared Grebe,23-5,0,7,0,7,0.000,0.000
14,0.990,cougar,16-23,0,1,0,1,0.000,0.000
14,0.990,cougar,23-5,0,0,0,0,NaN,NaN
14,0.990,Ocean Water,16-23,0,0,0,0,NaN,NaN
14,0.990,Ocean Water,23-5,0,0,0,0,NaN,NaN
14,0.990,Red Tailed Hawk,16-23,0,0,0,0,NaN,NaN
14,0.990,Red Tailed Hawk,23-5,0,2,0,2,0.000,0.000
14,0.990,Dog,16-23,54,76,0,130,41.538,41.538
14,0.990,Dog,23-5,87,122,0,209,41.627,41.627
14,0.990,Human,16-23,1705,780,0,2485,68.612,68.612
14,0.990,Human,23-5,2121,657,0,2778,76.350,76.350
14,0.990,Wild Turkey,16-23,3,9,0,12,25.000,25.000
14,0.990,Wild Turkey,23-5,4,20,0,24,16.667,16.667
14,0.990,Clark Grebe,16-23,0,0,0,0,NaN,NaN
14,0.990,Clark Grebe,23-5,2,3,0,5,40.000,40.000
14,0.990,Seagull,16-23,0,0,0,0,NaN,NaN
14,0.990,Seagull,23-5,11,7,0,18,61.111,61.111
14,0.990,Surf Scoter,16-23,0,0,0,0,NaN,NaN
14,0.990,Surf Scoter,23-5,2,0,0,2,100.000,100.000
14,0.990,Pigeon,16-23,31,122,0,153,20.261,20.261
14,0.990,Pigeon,23-5,72,196,0,268,26.866,26.866
14,0.990,Pacific Ocean Water,16-23,0,0,0,0,NaN,NaN
14,0.990,Pacific Ocean Water,23-5,0,0,0,0,NaN,NaN
14,0.990,Cat,16-23,17,23,0,40,42.500,42.500
14,0.990,Cat,23-5,17,23,0,40,42.500,42.500
14,0.990,Horse,16-23,8,10,0,18,44.444,44.444
14,0.990,Horse,23-5,20,87,0,107,18.692,18.692
14,0.990,orangutan,16-23,0,0,0,0,NaN,NaN
14,0.990,orangutan,23-5,0,0,0,0,NaN,NaN
14,0.990,Bat,16-23,36,32,0,68,52.941,52.941
14,0.990,Bat,23-5,37,34,0,71,52.113,52.113
14,0.990,Deer,16-23,11,41,0,52,21.154,21.154
14,0.990,Deer,23-5,16,113,0,129,12.403,12.403
14,0.990,Great Horned Owl,16-23,0,0,0,0,NaN,NaN
14,0.990,Great Horned Owl,23-5,0,0,0,0,NaN,NaN
14,0.990,Freshwater Lagoon,16-23,0,0,0,0,NaN,NaN
14,0.990,Freshwater Lagoon,23-5,0,0,0,0,NaN,NaN
14,0.990,Unknown Avian,16-23,0,0,0,0,NaN,NaN
14,0.990,Unknown Avian,23-5,0,0,0,0,NaN,NaN
14,0.990,Human UTI,16-23,79,78,0,157,50.318,50.318
14,0.990,Human UTI,23-5,97,91,0,188,51.596,51.596
14,0.990,unknown,16-23,0,0,0,0,NaN,NaN
14,0.990,unknown,23-5,0,5,0,5,0.000,0.000
14,0.990,SLO Creek Water,16-23,0,0,0,0,NaN,NaN
14,0.990,SLO Creek Water,23-5,0,0,0,0,NaN,NaN
14,0.990,Pig/Swine,16-23,3,6,0,9,33.333,33.333
14,0.990,Pig/Swine,23-5,8,9,0,17,47.059,47.059
14,0.990,Klebsiella,16-23,0,0,0,0,NaN,NaN
14,0.990,Klebsiella,23-5,0,0,0,0,NaN,NaN
14,0.990,Hu Cw and Dg,16-23,5,10,0,15,33.333,33.333
14,0.990,Hu Cw and Dg,23-5,5,6,0,11,45.455,45.455
14,0.990,Ground Squirrel,16-23,80,50,0,130,61.538,61.538
14,0.990,Ground Squirrel,23-5,83,68,0,151,54.967,54.967
14,0.990,Opossum,16-23,1,0,0,1,100.000,100.000
14,0.990,Opossum,23-5,2,0,0,2,100.000,100.000
14,0.990,Cow,16-23,1521,1100,0,2621,58.031,58.031
14,0.990,Cow,23-5,1483,1423,0,2906,51.032,51.032
14,0.990,Deer Mouse,16-23,0,0,0,0,NaN,NaN
14,0.990,Deer Mouse,23-5,0,0,0,0,NaN,NaN
14,0.990,OVERALL,16-23,3651,2463,0,6114,59.715,59.715
14,0.990,OVERALL,23-5,4249,3056,0,7305,58.166,58.166
14,1.000,Chicken,16-23,0,0,0,0,NaN,NaN
14,1.000,Chicken,23-5,0,0,0,0,NaN,NaN
14,1.000,Sea Lion,16-23,0,0,0,0,NaN,NaN
14,1.000,Sea Lion,23-5,0,0,0,0,NaN,NaN
14,1.000,Hu and Cw,16-23,0,0,0,0,NaN,NaN
14,1.000,Hu and Cw,23-5,0,0,0,0,NaN,NaN
14,1.000,Sheep,16-23,0,0,0,0,NaN,NaN
14,1.000,Sheep,23-5,0,0,0,0,NaN,NaN
14,1.000,Hu and Dg,16-23,0,0,0,0,NaN,NaN
14,1.000,Hu and Dg,23-5,0,0,0,0,NaN,NaN
14,1.000,Common Loon,16-23,0,0,0,0,NaN,NaN
14,1.000,Common Loon,23-5,0,0,0,0,NaN,NaN
14,1.000,Red-Winged Blackbird,16-23,0,0,0,0,NaN,NaN
14,1.000,Red-Winged Blackbird,23-5,0,0,0,0,NaN,NaN
14,1.000,Cw,16-23,0,0,0,0,NaN,NaN
14,1.000,Cw,23-5,0,0,0,0,NaN,NaN
14,1.000,Cliff Sparrow,16-23,0,0,0,0,NaN,NaN
14,1.000,Cliff Sparrow,23-5,0,0,0,0,NaN,NaN
14,1.000,Pig,16-23,0,0,0,0,NaN,NaN
14,1.000,Pig,23-5,0,0,0,0,NaN,NaN
14,1.000,Barn Owl,16-23,0,0,0,0,NaN,NaN
14,1.000,Barn Owl,23-5,0,0,0,0,NaN,NaN
14,1.000,Wild Pig,16-23,0,0,0,0,NaN,NaN
14,1.000,Wild Pig,23-5,0,0,0,0,NaN,NaN
14,1.000,Pennington Creek Water,16-23,0,0,0,0,NaN,NaN
14,1.000,Pennington Creek Water,23-5,0,0,0,0,NaN,NaN
14,1.000,Guinni,16-23,0,0,0,0,NaN,NaN
14,1.000,Guinni,23-5,0,0,0,0,NaN,NaN
14,1.000,Racoon,16-23,0,0,0,0,NaN,NaN
14,1.000,Racoon,23-5,0,0,0,0,NaN,NaN
14,1.000,Hu,16-23,0,0,0,0,NaN,NaN
14,1.000,Hu,23-5,0,0,0,0,NaN,NaN
14,1.000,Cw and Dg,16-23,0,0,0,0,NaN,NaN
14,1.000,Cw and Dg,23-5,0,0,0,0,NaN,NaN
14,1.000,Red Wind Blackbird,16-23,0,0,0,0,NaN,NaN
14,1.000,Red Wind Blackbird,23-5,0,0,0,0,NaN,NaN
14,1.000,Tree Swallow,16-23,0,0,0,0,NaN,NaN
14,1.000,Tree Swallow,23-5,0,0,0,0,NaN,NaN
14,1.000,Turkey Vulture,16-23,0,0,0,0,NaN,NaN
14,1.000,Turkey Vulture,23-5,0,0,0,0,NaN,NaN
14,1.000,Dg,16-23,0,0,0,0,NaN,NaN
14,1.000,Dg,23-5,0,0,0,0,NaN,NaN
14,1.000,Western Kingbird,16-23,0,0,0,0,NaN,NaN
14,1.000,Western Kingbird,23-5,0,0,0,0,NaN,NaN
14,1.000,White Crowned Sparrow,16-23,0,0,0,0,NaN,NaN
14,1.000,White Crowned Sparrow,23-5,0,0,0,0,NaN,NaN
14,1.000,Eared Grebe,16-23,0,0,0,0,NaN,NaN
14,1.000,Eared Grebe,23-5,0,0,0,0,NaN,NaN
14,1.000,cougar,16-23,0,0,0,0,NaN,NaN
14,1.000,cougar,23-5,0,0,0,0,NaN,NaN
14,1.000,Ocean Water,16-23,0,0,0,0,NaN,NaN
14,1.000,Ocean Water,23-5,0,0,0,0,NaN,NaN
14,1.000,Red Tailed Hawk,16-23,0,0,0,0,NaN,NaN
14,1.000,Red Tailed Hawk,23-5,0,0,0,0,NaN,NaN
14,1.000,Dog,16-23,0,0,0,0,NaN,NaN
14,1.000,Dog,23-5,0,0,0,0,NaN,NaN
14,1.000,Human,16-23,0,0,0,0,NaN,NaN
14,1.000,Human,23-5,0,0,0,0,NaN,NaN
14,1.000,Wild Turkey,16-23,0,0,0,0,NaN,NaN
14,1.000,Wild Turkey,23-5,0,0,0,0,NaN,NaN
14,1.000,Clark Grebe,16-23,0,0,0,0,NaN,NaN
14,1.000,Clark Grebe,23-5,0,0,0,0,NaN,NaN
14,1.000,Seagull,16-23,0,0,0,0,NaN,NaN
14,1.000,Seagull,23-5,0,0,0,0,NaN,NaN
14,1.000,Surf Scoter,16-23,0,0,0,0,NaN,NaN
14,1.000,Surf Scoter,23-5,0,0,0,0,NaN,NaN
14,1.000,Pigeon,16-23,0,0,0,0,NaN,NaN
14,1.000,Pigeon,23-5,0,0,0,0,NaN,NaN
14,1.000,Pacific Ocean Water,16-23,0,0,0,0,NaN,NaN
14,1.000,Pacific Ocean Water,23-5,0,0,0,0,NaN,NaN
14,1.000,Cat,16-23,0,0,0,0,NaN,NaN
14,1.000,Cat,23-5,0,0,0,0,NaN,NaN
14,1.000,Horse,16-23,0,0,0,0,NaN,NaN
14,1.000,Horse,23-5,0,0,0,0,NaN,NaN
14,1.000,orangutan,16-23,0,0,0,0,NaN,NaN
14,1.000,orangutan,23-5,0,0,0,0,NaN,NaN
14,1.000,Bat,16-23,0,0,0,0,NaN,NaN
14,1.000,Bat,23-5,0,0,0,0,NaN,NaN
14,1.000,Deer,16-23,0,0,0,0,NaN,NaN
14,1.000,Deer,23-5,0,0,0,0,NaN,NaN
14,1.000,Great Horned Owl,16-23,0,0,0,0,NaN,NaN
14,1.000,Great Horned Owl,23-5,0,0,0,0,NaN,NaN
14,1.000,Freshwater Lagoon,16-23,0,0,0,0,NaN,NaN
14,1.000,Freshwater Lagoon,23-5,0,0,0,0,NaN,NaN
14,1.000,Unknown Avian,16-23,0,0,0,0,NaN,NaN
14,1.000,Unknown Avian,23-5,0,0,0,0,NaN,NaN
14,1.000,Human UTI,16-23,0,0,0,0,NaN,NaN
14,1.000,Human UTI,23-5,0,0,0,0,NaN,NaN
14,1.000,unknown,16-23,0,0,0,0,NaN,NaN
14,1.000,unknown,23-5,0,0,0,0,NaN,NaN
14,1.000,SLO Creek Water,16-23,0,0,0,0,NaN,NaN
14,1.000,SLO Creek Water,23-5,0,0,0,0,NaN,NaN
14,1.000,Pig/Swine,16-23,0,0,0,0,NaN,NaN
14,1.000,Pig/Swine,23-5,0,0,0,0,NaN,NaN
14,1.000,Klebsiella,16-23,0,0,0,0,NaN,NaN
14,1.000,Klebsiella,23-5,0,0,0,0,NaN,NaN
14,1.000,Hu Cw and Dg,16-23,0,0,0,0,NaN,NaN
14,1.000,Hu Cw and Dg,23-5,0,0,0,0,NaN,NaN
14,1.000,Ground Squirrel,16-23,0,0,0,0,NaN,NaN
14,1.000,Ground Squirrel,23-5,0,0,0,0,NaN,NaN
14,1.000,Opossum,16-23,0,0,0,0,NaN,NaN
14,1.000,Opossum,23-5,0,0,0,0,NaN,NaN
14,1.000,Cow,16-23,0,0,0,0,NaN,NaN
14,1.000,Cow,23-5,0,0,0,0,NaN,NaN
14,1.000,Deer Mouse,16-23,0,0,0,0,NaN,NaN
14,1.000,Deer Mouse,23-5,0,0,0,0,NaN,NaN
14,1.000,OVERALL,16-23,0,0,0,0,NaN,NaN
14,1.000,OVERALL,23-5,0,0,0,0,NaN,NaN
15,0.000,Chicken,16-23,0,0,0,0,NaN,NaN
15,0.000,Chicken,23-5,5,2,0,7,71.429,71.429
15,0.000,Sea Lion,16-23,0,0,0,0,NaN,NaN
15,0.000,Sea Lion,23-5,0,7,0,7,0.000,0.000
15,0.000,Hu and Cw,16-23,1,3,0,4,25.000,25.000
15,0.000,Hu and Cw,23-5,9,7,0,16,56.250,56.250
15,0.000,Sheep,16-23,44,53,0,97,45.361,45.361
15,0.000,Sheep,23-5,52,40,0,92,56.522,56.522
15,0.000,Hu and Dg,16-23,7,7,0,14,50.000,50.000
15,0.000,Hu and Dg,23-5,20,24,0,44,45.455,45.455
15,0.000,Common Loon,16-23,0,0,0,0,NaN,NaN
15,0.000,Common Loon,23-5,0,0,0,0,NaN,NaN
15,0.000,Red-Winged Blackbird,16-23,0,0,0,0,NaN,NaN
15,0.000,Red-Winged Blackbird,23-5,0,0,0,0,NaN,NaN
15,0.000,Cw,16-23,5,8,0,13,38.462,38.462
15,0.000,Cw,23-5,11,16,0,27,40.741,40.741
15,0.000,Cliff Sparrow,16-23,0,6,0,6,0.000,0.000
15,0.000,Cliff Sparrow,23-5,0,0,0,0,NaN,NaN
15,0.000,Pig,16-23,5,4,0,9,55.556,55.556
15,0.000,Pig,23-5,0,0,0,0,NaN,NaN
15,0.000,Barn Owl,16-23,0,0,0,0,NaN,NaN
15,0.000,Barn Owl,23-5,0,0,0,0,NaN,NaN
15,0.000,Wild Pig,16-23,0,0,0,0,NaN,NaN
15,0.000,Wild Pig,23-5,0,0,0,0,NaN,NaN
15,0.000,Pennington Creek Water,16-23,0,0,0,0,NaN,NaN
15,0.000,Pennington Creek Water,23-5,0,0,0,0,NaN,NaN
15,0.000,Guinni,16-23,0,0,0,0,NaN,NaN
15,0.000,Guinni,23-5,0,0,0,0,NaN,NaN
15,0.000,Racoon,16-23,0,0,0,0,NaN,NaN
15,0.000,Racoon,23-5,0,0,0,0,NaN,NaN
15,0.000,Hu,16-23,10,7,0,17,58.824,58.824
15,0.000,Hu,23-5,22,19,0,41,53.659,53.659
15,0.000,Cw and Dg,16-23,6,14,0,20,30.000,30.000
15,0.000,Cw and Dg,23-5,13,18,0,31,41.935,41.935
15,0.000,Red Wind Blackbird,16-23,0,0,0,0,NaN,NaN
15,0.000,Red Wind Blackbird,23-5,0,0,0,0,NaN,NaN
15,0.000,Tree Swallow,16-23,0,0,0,0,NaN,NaN
15,0.000,Tree Swallow,23-5,0,0,0,0,NaN,NaN
15,0.000,Turkey Vulture,16-23,0,0,0,0,NaN,NaN
15,0.000,Turkey Vulture,23-5,0,0,0,0,NaN,NaN
15,0.000,Dg,16-23,6,11,0,17,35.294,35.294
15,0.000,Dg,23-5,31,35,0,66,46.970,46.970
15,0.000,Western Kingbird,16-23,0,0,0,0,NaN,NaN
15,0.000,Western Kingbird,23-5,0,0,0,0,NaN,NaN
15,0.000,White Crowned Sparrow,16-23,0,0,0,0,NaN,NaN
15,0.000,White Crowned Sparrow,23-5,0,4,0,4,0.000,0.000
15,0.000,Eared Grebe,16-23,0,0,0,0,NaN,NaN
15,0.000,Eared Grebe,23-5,0,5,0,5,0.000,0.000
15,0.000,cougar,16-23,0,0,0,0,NaN,NaN
15,0.000,cougar,23-5,0,0,0,0,NaN,NaN
15,0.000,Ocean Water,16-23,0,0,0,0,NaN,NaN
15,0.000,Ocean Water,23-5,0,0,0,0,NaN,NaN
15,0.000,Red Tailed Hawk,16-23,0,0,0,0,NaN,NaN
15,0.000,Red Tailed Hawk,23-5,0,0,0,0,NaN,NaN
15,0.000,Dog,16-23,52,70,0,122,42.623,42.623
15,0.000,Dog,23-5,80,146,0,226,35.398,35.398
15,0.000,Human,16-23,1729,865,0,2594,66.654,66.654
15,0.000,Human,23-5,2134,787,0,2921,73.057,73.057
15,0.000,Wild Turkey,16-23,0,1,0,1,0.000,0.000
15,0.000,Wild Turkey,23-5,1,5,0,6,16.667,16.667
15,0.000,Clark Grebe,16-23,0,0,0,0,NaN,NaN
15,0.000,Clark Grebe,23-5,0,0,0,0,NaN,NaN
15,0.000,Seagull,16-23,0,0,0,0,NaN,NaN
15,0.000,Seagull,23-5,3,7,0,10,30.000,30.000
15,0.000,Surf Scoter,16-23,0,0,0,0,NaN,NaN
15,0.000,Surf Scoter,23-5,0,0,0,0,NaN,NaN
15,0.000,Pigeon,16-23,23,123,0,146,15.753,15.753
15,0.000,Pigeon,23-5,61,120,0,181,33.702,33.702
15,0.000,Pacific Ocean Water,16-23,0,0,0,0,NaN,NaN
15,0.000,Pacific Ocean Water,23-5,0,0,0,0,NaN,NaN
15,0.000,Cat,16-23,16,20,0,36,44.444,44.444
15,0.000,Cat,23-5,8,16,0,24,33.333,33.333
15,0.000,Horse,16-23,6,10,0,16,37.500,37.500
15,0.000,Horse,23-5,17,49,0,66,25.758,25.758
15,0.000,orangutan,16-23,0,0,0,0,NaN,NaN
15,0.000,orangutan,23-5,0,0,0,0,NaN,NaN
15,0.000,Bat,16-23,36,38,0,74,48.649,48.649
15,0.000,Bat,23-5,37,38,0,75,49.333,49.333
15,0.000,Deer,16-23,11,38,0,49,22.449,22.449
15,0.000,Deer,23-5,14,127,0,141,9.929,9.929
15,0.000,Great Horned Owl,16-23,0,0,0,0,NaN,NaN
15,0.000,Great Horned Owl,23-5,0,0,0,0,NaN,NaN
15,0.000,Freshwater Lagoon,16-23,0,0,0,0,NaN,NaN
15,0.000,Freshwater Lagoon,23-5,0,0,0,0,NaN,NaN
15,0.000,Unknown Avian,16-23,0,0,0,0,NaN,NaN
15,0.000,Unknown Avian,23-5,0,0,0,0,NaN,NaN
15,0.000,Human UTI,16-23,73,77,0,150,48.667,48.667
15,0.000,Human UTI,23-5,92,122,0,214,42.991,42.991
15,0.000,unknown,16-23,0,0,0,0,NaN,NaN
15,0.000,unknown,23-5,0,2,0,2,0.000,0.000
15,0.000,SLO Creek Water,16-23,0,0,0,0,NaN,NaN
15,0.000,SLO Creek Water,23-5,0,0,0,0,NaN,NaN
15,0.000,Pig/Swine,16-23,2,3,0,5,40.000,40.000
15,0.000,Pig/Swine,23-5,7,8,0,15,46.667,46.667
15,0.000,Klebsiella,16-23,0,0,0,0,NaN,NaN
15,0.000,Klebsiella,23-5,0,0,0,0,NaN,NaN
15,0.000,Hu Cw and Dg,16-23,3,7,0,10,30.000,30.000
15,0.000,Hu Cw and Dg,23-5,5,6,0,11,45.455,45.455
15,0.000,Ground Squirrel,16-23,74,46,0,120,61.667,61.667
15,0.000,Ground Squirrel,23-5,80,65,0,145,55.172,55.172
15,0.000,Opossum,16-23,0,0,0,0,NaN,NaN
15,0.000,Opossum,23-5,0,0,0,0,NaN,NaN
15,0.000,Cow,16-23,1571,1257,0,2828,55.552,55.552
15,0.000,Cow,23-5,1533,1700,0,3233,47.417,47.417
15,0.000,Deer Mouse,16-23,0,0,0,0,NaN,NaN
15,0.000,Deer Mouse,23-5,0,0,0,0,NaN,NaN
15,0.000,OVERALL,16-23,3680,2668,0,6348,57.971,57.971
15,0.000,OVERALL,23-5,4235,3375,0,7610,55.650,55.650
15,0.500,Chicken,16-23,0,0,0,0,NaN,NaN
15,0.500,Chicken,23-5,5,2,0,7,71.429,71.429
15,0.500,Sea Lion,16-23,0,0,0,0,NaN,NaN
15,0.500,Sea Lion,23-5,0,7,0,7,0.000,0.000
15,0.500,Hu and Cw,16-23,1,3,0,4,25.000,25.000
15,0.500,Hu and Cw,23-5,9,7,0,16,56.250,56.250
15,0.500,Sheep,16-23,44,53,0,97,45.361,45.361
15,0.500,Sheep,23-5,52,40,0,92,56.522,56.522
15,0.500,Hu and Dg,16-23,7,7,0,14,50.000,50.000
15,0.500,Hu and Dg,23-5,20,24,0,44,45.455,45.455
15,0.500,Common Loon,16-23,0,0,0,0,NaN,NaN
15,0.500,Common Loon,23-5,0,0,0,0,NaN,NaN
15,0.500,Red-Winged Blackbird,16-23,0,0,0,0,NaN,NaN
15,0.500,Red-Winged Blackbird,23-5,0,0,0,0,NaN,NaN
15,0.500,Cw,16-23,5,8,0,13,38.462,38.462
15,0.500,Cw,23-5,11,16,0,27,40.741,40.741
15,0.500,Cliff Sparrow,16-23,0,6,0,6,0.000,0.000
15,0.500,Cliff Sparrow,23-5,0,0,0,0,NaN,NaN
15,0.500,Pig,16-23,5,4,0,9,55.556,55.556
15,0.500,Pig,23-5,0,0,0,0,NaN,NaN
15,0.500,Barn Owl,16-23,0,0,0,0,NaN,NaN
15,0.500,Barn Owl,23-5,0,0,0,0,NaN,NaN
15,0.500,Wild Pig,16-23,0,0,0,0,NaN,NaN
15,0.500,Wild Pig,23-5,0,0,0,0,NaN,NaN
15,0.500,Pennington Creek Water,16-23,0,0,0,0,NaN,NaN
15,0.500,Pennington Creek Water,23-5,0,0,0,0,NaN,NaN
15,0.500,Guinni,16-23,0,0,0,0,NaN,NaN
15,0.500,Guinni,23-5,0,0,0,0,NaN,NaN
15,0.500,Racoon,16-23,0,0,0,0,NaN,NaN
15,0.500,Racoon,23-5,0,0,0,0,NaN,NaN
15,0.500,Hu,16-23,10,7,0,17,58.824,58.824
15,0.500,Hu,23-5,22,19,0,41,53.659,53.659
15,0.500,Cw and Dg,16-23,6,14,0,20,30.000,30.000
15,0.500,Cw and Dg,23-5,13,18,0,31,41.935,41.935
15,0.500,Red Wind Blackbird,16-23,0,0,0,0,NaN,NaN
15,0.500,Red Wind Blackbird,23-5,0,0,0,0,NaN,NaN
15,0.500,Tree Swallow,16-23,0,0,0,0,NaN,NaN
15,0.500,Tree Swallow,23-5,0,0,0,0,NaN,NaN
15,0.500,Turkey Vulture,16-23,0,0,0,0,NaN,NaN
15,0.500,Turkey Vulture,23-5,0,0,0,0,NaN,NaN
15,0.500,Dg,16-23,6,11,0,17,35.294,35.294
15,0.500,Dg,23-5,31,35,0,66,46.970,46.970
15,0.500,Western Kingbird,16-23,0,0,0,0,NaN,NaN
15,0.500,Western Kingbird,23-5,0,0,0,0,NaN,NaN
15,0.500,White Crowned Sparrow,16-23,0,0,0,0,NaN,NaN
15,0.500,White Crowned Sparrow,23-5,0,4,0,4,0.000,0.000
15,0.500,Eared Grebe,16-23,0,0,0,0,NaN,NaN
15,0.500,Eared Grebe,23-5,0,5,0,5,0.000,0.000
15,0.500,cougar,16-23,0,0,0,0,NaN,NaN
15,0.500,cougar,23-5,0,0,0,0,NaN,NaN
15,0.500,Ocean Water,16-23,0,0,0,0,NaN,NaN
15,0.500,Ocean Water,23-5,0,0,0,0,NaN,NaN
15,0.500,Red Tailed Hawk,16-23,0,0,0,0,NaN,NaN
15,0.500,Red Tailed Hawk,23-5,0,0,0,0,NaN,NaN
15,0.500,Dog,16-23,52,70,0,122,42.623,42.623
15,0.500,Dog,23-5,80,146,0,226,35.398,35.398
15,0.500,Human,16-23,1729,865,0,2594,66.654,66.654
15,0.500,Human,23-5,2134,787,0,2921,73.057,73.057
15,0.500,Wild Turkey,16-23,0,1,0,1,0.000,0.000
15,0.500,Wild Turkey,23-5,1,5,0,6,16.667,16.667
15,0.500,Clark Grebe,16-23,0,0,0,0,NaN,NaN
15,0.500,Clark Grebe,23-5,0,0,0,0,NaN,NaN
15,0.500,Seagull,16-23,0,0,0,0,NaN,NaN
15,0.500,Seagull,23-5,3,7,0,10,30.000,30.000
15,0.500,Surf Scoter,16-23,0,0,0,0,NaN,NaN
15,0.500,Surf Scoter,23-5,0,0,0,0,NaN,NaN
15,0.500,Pigeon,16-23,23,123,0,146,15.753,15.753
15,0.500,Pigeon,23-5,61,120,0,181,33.702,33.702
15,0.500,Pacific Ocean Water,16-23,0,0,0,0,NaN,NaN
15,0.500,Pacific Ocean Water,23-5,0,0,0,0,NaN,NaN
15,0.500,Cat,16-23,16,20,0,36,44.444,44.444
15,0.500,Cat,23-5,8,16,0,24,33.333,33.333
15,0.500,Horse,16-23,6,10,0,16,37.500,37.500
15,0.500,Horse,23-5,17,49,0,66,25.758,25.758
15,0.500,orangutan,16-23,0,0,0,0,NaN,NaN
15,0.500,orangutan,23-5,0,0,0,0,NaN,NaN
15,0.500,Bat,16-23,36,38,0,74,48.649,48.649
15,0.500,Bat,23-5,37,38,0,75,49.333,49.333
15,0.500,Deer,16-23,11,38,0,49,22.449,22.449
15,0.500,Deer,23-5,14,127,0,141,9.929,9.929
15,0.500,Great Horned Owl,16-23,0,0,0,0,NaN,NaN
15,0.500,Great Horned Owl,23-5,0,0,0,0,NaN,NaN
15,0.500,Freshwater Lagoon,16-23,0,0,0,0,NaN,NaN
15,0.500,Freshwater Lagoon,23-5,0,0,0,0,NaN,NaN
15,0.500,Unknown Avian,16-23,0,0,0,0,NaN,NaN
15,0.500,Unknown Avian,23-5,0,0,0,0,NaN,NaN
15,0.500,Human UTI,16-23,73,77,0,150,48.667,48.667
15,0.500,Human UTI,23-5,92,122,0,214,42.991,42.991
15,0.500,unknown,16-23,0,0,0,0,NaN,NaN
15,0.500,unknown,23-5,0,2,0,2,0.000,0.000
15,0.500,SLO Creek Water,16-23,0,0,0,0,NaN,NaN
15,0.500,SLO Creek Water,23-5,0,0,0,0,NaN,NaN
15,0.500,Pig/Swine,16-23,2,3,0,5,40.000,40.000
15,0.500,Pig/Swine,23-5,7,8,0,15,46.667,46.667
15,0.500,Klebsiella,16-23,0,0,0,0,NaN,NaN
15,0.500,Klebsiella,23-5,0,0,0,0,NaN,NaN
15,0.500,Hu Cw and Dg,16-23,3,7,0,10,30.000,30.000
15,0.500,Hu Cw and Dg,23-5,5,6,0,11,45.455,45.455
15,0.500,Ground Squirrel,16-23,74,46,0,120,61.667,61.667
15,0.500,Ground Squirrel,23-5,80,65,0,145,55.172,55.172
15,0.500,Opossum,16-23,0,0,0,0,NaN,NaN
15,0.500,Opossum,23-5,0,0,0,0,NaN,NaN
15,0.500,Cow,16-23,1571,1257,0,2828,55.552,55.552
15,0.500,Cow,23-5,1533,1700,0,3233,47.417,47.417
15,0.500,Deer Mouse,16-23,0,0,0,0,NaN,NaN
15,0.500,Deer Mouse,23-5,0,0,0,0,NaN,NaN
15,0.500,OVERALL,16-23,3680,2668,0,6348,57.971,57.971
15,0.500,OVERALL,23-5,4235,3375,0,7610,55.650,55.650
15,0.900,Chicken,16-23,0,0,0,0,NaN,NaN
15,0.900,Chicken,23-5,5,2,0,7,71.429,71.429
15,0.900,Sea Lion,16-23,0,0,0,0,NaN,NaN
15,0.900,Sea Lion,23-5,0,7,0,7,0.000,0.000
15,0.900,Hu and Cw,16-23,1,3,0,4,25.000,25.000
15,0.900,Hu and Cw,23-5,9,7,0,16,56.250,56.250
15,0.900,Sheep,16-23,44,53,0,97,45.361,45.361
15,0.900,Sheep,23-5,52,40,0,92,56.522,56.522
15,0.900,Hu and Dg,16-23,7,7,0,14,50.000,50.000
15,0.900,Hu and Dg,23-5,20,24,0,44,45.455,45.455
15,0.900,Common Loon,16-23,0,0,0,0,NaN,NaN
15,0.900,Common Loon,23-5,0,0,0,0,NaN,NaN
15,0.900,Red-Winged Blackbird,16-23,0,0,0,0,NaN,NaN
15,0.900,Red-Winged Blackbird,23-5,0,0,0,0,NaN,NaN
15,0.900,Cw,16-23,5,8,0,13,38.462,38.462
15,0.900,Cw,23-5,11,16,0,27,40.741,40.741
15,0.900,Cliff Sparrow,16-23,0,6,0,6,0.000,0.000
15,0.900,Cliff Sparrow,23-5,0,0,0,0,NaN,NaN
15,0.900,Pig,16-23,5,4,0,9,55.556,55.556
15,0.900,Pig,23-5,0,0,0,0,NaN,NaN
15,0.900,Barn Owl,16-23,0,0,0,0,NaN,NaN
15,0.900,Barn Owl,23-5,0,0,0,0,NaN,NaN
15,0.900,Wild Pig,16-23,0,0,0,0,NaN,NaN
15,0.900,Wild Pig,23-5,0,0,0,0,NaN,NaN
15,0.900,Pennington Creek Water,16-23,0,0,0,0,NaN,NaN
15,0.900,Pennington Creek Water,23-5,0,0,0,0,NaN,NaN
15,0.900,Guinni,16-23,0,0,0,0,NaN,NaN
15,0.900,Guinni,23-5,0,0,0,0,NaN,NaN
15,0.900,Racoon,16-23,0,0,0,0,NaN,NaN
15,0.900,Racoon,23-5,0,0,0,0,NaN,NaN
15,0.900,Hu,16-23,10,7,0,17,58.824,58.824
15,0.900,Hu,23-5,22,19,0,41,53.659,53.659
15,0.900,Cw and Dg,16-23,6,14,0,20,30.000,30.000
15,0.900,Cw and Dg,23-5,13,18,0,31,41.935,41.935
15,0.900,Red Wind Blackbird,16-23,0,0,0,0,NaN,NaN
15,0.900,Red Wind Blackbird,23-5,0,0,0,0,NaN,NaN
15,0.900,Tree Swallow,16-23,0,0,0,0,NaN,NaN
15,0.900,Tree Swallow,23-5,0,0,0,0,NaN,NaN
15,0.900,Turkey Vulture,16-23,0,0,0,0,NaN,NaN
15,0.900,Turkey Vulture,23-5,0,0,0,0,NaN,NaN
15,0.900,Dg,16-23,6,11,0,17,35.294,35.294
15,0.900,Dg,23-5,31,35,0,66,46.970,46.970
15,0.900,Western Kingbird,16-23,0,0,0,0,NaN,NaN
15,0.900,Western Kingbird,23-5,0,0,0,0,NaN,NaN
15,0.900,White Crowned Sparrow,16-23,0,0,0,0,NaN,NaN
15,0.900,White Crowned Sparrow,23-5,0,4,0,4,0.000,0.000
15,0.900,Eared Grebe,16-23,0,0,0,0,NaN,NaN
15,0.900,Eared Grebe,23-5,0,5,0,5,0.000,0.000
15,0.900,cougar,16-23,0,0,0,0,NaN,NaN
15,0.900,cougar,23-5,0,0,0,0,NaN,NaN
15,0.900,Ocean Water,16-23,0,0,0,0,NaN,NaN
15,0.900,Ocean Water,23-5,0,0,0,0,NaN,NaN
15,0.900,Red Tailed Hawk,16-23,0,0,0,0,NaN,NaN
15,0.900,Red Tailed Hawk,23-5,0,0,0,0,NaN,NaN
15,0.900,Dog,16-23,52,70,0,122,42.623,42.623
15,0.900,Dog,23-5,80,142,0,222,36.036,36.036
15,0.900,Human,16-23,1729,861,0,2590,66.757,66.757
15,0.900,Human,23-5,2134,783,0,2917,73.157,73.157
15,0.900,Wild Turkey,16-23,0,1,0,1,0.000,0.000
15,0.900,Wild Turkey,23-5,1,5,0,6,16.667,16.667
15,0.900,Clark Grebe,16-23,0,0,0,0,NaN,NaN
15,0.900,Clark Grebe,23-5,0,0,0,0,NaN,NaN
15,0.900,Seagull,16-23,0,0,0,0,NaN,NaN
15,0.900,Seagull,23-5,3,8,0,11,27.273,27.273
15,0.900,Surf Scoter,16-23,0,0,0,0,NaN,NaN
15,0.900,Surf Scoter,23-5,0,0,0,0,NaN,NaN
15,0.900,Pigeon,16-23,23,124,0,147,15.646,15.646
15,0.900,Pigeon,23-5,61,120,0,181,33.702,33.702
15,0.900,Pacific Ocean Water,16-23,0,0,0,0,NaN,NaN
15,0.900,Pacific Ocean Water,23-5,0,0,0,0,NaN,NaN
15,0.900,Cat,16-23,16,20,0,36,44.444,44.444
15,0.900,Cat,23-5,8,16,0,24,33.333,33.333
15,0.900,Horse,16-23,6,10,0,16,37.500,37.500
15,0.900,Horse,23-5,17,49,0,66,25.758,25.758
15,0.900,orangutan,16-23,0,0,0,0,NaN,NaN
15,0.900,orangutan,23-5,0,0,0,0,NaN,NaN
15,0.900,Bat,16-23,36,38,0,74,48.649,48.649
15,0.900,Bat,23-5,37,38,0,75,49.333,49.333
15,0.900,Deer,16-23,11,38,0,49,22.449,22.449
15,0.900,Deer,23-5,14,127,0,141,9.929,9.929
15,0.900,Great Horned Owl,16-23,0,0,0,0,NaN,NaN
15,0.900,Great Horned Owl,23-5,0,0,0,0,NaN,NaN
15,0.900,Freshwater Lagoon,16-23,0,0,0,0,NaN,NaN
15,0.900,Freshwater Lagoon,23-5,0,0,0,0,NaN,NaN
15,0.900,Unknown Avian,16-23,0,0,0,0,NaN,NaN
15,0.900,Unknown Avian,23-5,0,0,0,0,NaN,NaN
15,0.900,Human UTI,16-23,73,77,0,150,48.667,48.667
15,0.900,Human UTI,23-5,95,122,0,217,43.779,43.779
15,0.900,unknown,16-23,0,0,0,0,NaN,NaN
15,0.900,unknown,23-5,0,2,0,2,0.000,0.000
15,0.900,SLO Creek Water,16-23,0,0,0,0,NaN,NaN
15,0.900,SLO Creek Water,23-5,0,0,0,0,NaN,NaN
15,0.900,Pig/Swine,16-23,2,3,0,5,40.000,40.000
15,0.900,Pig/Swine,23-5,7,8,0,15,46.667,46.667
15,0.900,Klebsiella,16-23,0,0,0,0,NaN,NaN
15,0.900,Klebsiella,23-5,0,0,0,0,NaN,NaN
15,0.900,Hu Cw and Dg,16-23,3,7,0,10,30.000,30.000
15,0.900,Hu Cw and Dg,23-5,5,6,0,11,45.455,45.455
15,0.900,Ground Squirrel,16-23,74,46,0,120,61.667,61.667
15,0.900,Ground Squirrel,23-5,80,65,0,145,55.172,55.172
15,0.900,Opossum,16-23,0,0,0,0,NaN,NaN
15,0.900,Opossum,23-5,0,0,0,0,NaN,NaN
15,0.900,Cow,16-23,1573,1254,0,2827,55.642,55.642
15,0.900,Cow,23-5,1533,1696,0,3229,47.476,47.476
15,0.900,Deer Mouse,16-23,0,0,0,0,NaN,NaN
15,0.900,Deer Mouse,23-5,0,0,0,0,NaN,NaN
15,0.900,OVERALL,16-23,3682,2662,0,6344,58.039,58.039
15,0.900,OVERALL,23-5,4238,3364,0,7602,55.748,55.748
15,0.950,Chicken,16-23,0,0,0,0,NaN,NaN
15,0.950,Chicken,23-5,5,2,0,7,71.429,71.429
15,0.950,Sea Lion,16-23,0,0,0,0,NaN,NaN
15,0.950,Sea Lion,23-5,0,7,0,7,0.000,0.000
15,0.950,Hu and Cw,16-23,1,3,0,4,25.000,25.000
15,0.950,Hu and Cw,23-5,9,7,0,16,56.250,56.250
15,0.950,Sheep,16-23,44,53,0,97,45.361,45.361
15,0.950,Sheep,23-5,52,40,0,92,56.522,56.522
15,0.950,Hu and Dg,16-23,7,7,0,14,50.000,50.000
15,0.950,Hu and Dg,23-5,20,24,0,44,45.455,45.455
15,0.950,Common Loon,16-23,0,0,0,0,NaN,NaN
15,0.950,Common Loon,23-5,0,0,0,0,NaN,NaN
15,0.950,Red-Winged Blackbird,16-23,0,0,0,0,NaN,NaN
15,0.950,Red-Winged Blackbird,23-5,0,0,0,0,NaN,NaN
15,0.950,Cw,16-23,5,8,0,13,38.462,38.462
15,0.950,Cw,23-5,11,16,0,27,40.741,40.741
15,0.950,Cliff Sparrow,16-23,0,6,0,6,0.000,0.000
15,0.950,Cliff Sparrow,23-5,0,0,0,0,NaN,NaN
15,0.950,Pig,16-23,5,4,0,9,55.556,55.556
15,0.950,Pig,23-5,0,0,0,0,NaN,NaN
15,0.950,Barn Owl,16-23,0,0,0,0,NaN,NaN
15,0.950,Barn Owl,23-5,0,0,0,0,NaN,NaN
15,0.950,Wild Pig,16-23,0,0,0,0,NaN,NaN
15,0.950,Wild Pig,23-5,0,0,0,0,NaN,NaN
15,0.950,Pennington Creek Water,16-23,0,0,0,0,NaN,NaN
15,0.950,Pennington Creek Water,23-5,0,0,0,0,NaN,NaN
15,0.950,Guinni,16-23,0,0,0,0,NaN,NaN
15,0.950,Guinni,23-5,0,0,0,0,NaN,NaN
15,0.950,Racoon,16-23,0,0,0,0,NaN,NaN
15,0.950,Racoon,23-5,0,0,0,0,NaN,NaN
15,0.950,Hu,16-23,10,7,0,17,58.824,58.824
15,0.950,Hu,23-5,22,19,0,41,53.659,53.659
15,0.950,Cw and Dg,16-23,6,14,0,20,30.000,30.000
15,0.950,Cw and Dg,23-5,13,18,0,31,41.935,41.935
15,0.950,Red Wind Blackbird,16-23,0,0,0,0,NaN,NaN
15,0.950,Red Wind Blackbird,23-5,0,0,0,0,NaN,NaN
15,0.950,Tree Swallow,16-23,0,0,0,0,NaN,NaN
15,0.950,Tree Swallow,23-5,0,0,0,0,NaN,NaN
15,0.950,Turkey Vulture,16-23,0,0,0,0,NaN,NaN
15,0.950,Turkey Vulture,23-5,0,0,0,0,NaN,NaN
15,0.950,Dg,16-23,6,11,0,17,35.294,35.294
15,0.950,Dg,23-5,31,35,0,66,46.970,46.970
15,0.950,Western Kingbird,16-23,0,0,0,0,NaN,NaN
15,0.950,Western Kingbird,23-5,0,0,0,0,NaN,NaN
15,0.950,White Crowned Sparrow,16-23,0,0,0,0,NaN,NaN
15,0.950,White Crowned Sparrow,23-5,0,4,0,4,0.000,0.000
15,0.950,Eared Grebe,16-23,0,0,0,0,NaN,NaN
15,0.950,Eared Grebe,23-5,0,5,0,5,0.000,0.000
15,0.950,cougar,16-23,0,0,0,0,NaN,NaN
15,0.950,cougar,23-5,0,0,0,0,NaN,NaN
15,0.950,Ocean Water,16-23,0,0,0,0,NaN,NaN
15,0.950,Ocean Water,23-5,0,0,0,0,NaN,NaN
15,0.950,Red Tailed Hawk,16-23,0,0,0,0,NaN,NaN
15,0.950,Red Tailed Hawk,23-5,0,0,0,0,NaN,NaN
15,0.950,Dog,16-23,52,70,0,122,42.623,42.623
15,0.950,Dog,23-5,80,140,0,220,36.364,36.364
15,0.950,Human,16-23,1729,858,0,2587,66.834,66.834
15,0.950,Human,23-5,2127,775,0,2902,73.294,73.294
15,0.950,Wild Turkey,16-23,0,1,0,1,0.000,0.000
15,0.950,Wild Turkey,23-5,1,4,0,5,20.000,20.000
15,0.950,Clark Grebe,16-23,0,0,0,0,NaN,NaN
15,0.950,Clark Grebe,23-5,0,0,0,0,NaN,NaN
15,0.950,Seagull,16-23,0,0,0,0,NaN,NaN
15,0.950,Seagull,23-5,3,7,0,10,30.000,30.000
15,0.950,Surf Scoter,16-23,0,0,0,0,NaN,NaN
15,0.950,Surf Scoter,23-5,0,0,0,0,NaN,NaN
15,0.950,Pigeon,16-23,24,123,0,147,16.327,16.327
15,0.950,Pigeon,23-5,61,121,0,182,33.516,33.516
15,0.950,Pacific Ocean Water,16-23,0,0,0,0,NaN,NaN
15,0.950,Pacific Ocean Water,23-5,0,0,0,0,NaN,NaN
15,0.950,Cat,16-23,16,20,0,36,44.444,44.444
15,0.950,Cat,23-5,8,23,0,31,25.806,25.806
15,0.950,Horse,16-23,6,10,0,16,37.500,37.500
15,0.950,Horse,23-5,17,49,0,66,25.758,25.758
15,0.950,orangutan,16-23,0,0,0,0,NaN,NaN
15,0.950,orangutan,23-5,0,0,0,0,NaN,NaN
15,0.950,Bat,16-23,36,38,0,74,48.649,48.649
15,0.950,Bat,23-5,37,37,0,74,50.000,50.000
15,0.950,Deer,16-23,11,38,0,49,22.449,22.449
15,0.950,Deer,23-5,14,127,0,141,9.929,9.929
15,0.950,Great Horned Owl,16-23,0,0,0,0,NaN,NaN
15,0.950,Great Horned Owl,23-5,0,0,0,0,NaN,NaN
15,0.950,Freshwater Lagoon,16-23,0,0,0,0,NaN,NaN
15,0.950,Freshwater Lagoon,23-5,0,0,0,0,NaN,NaN
15,0.950,Unknown Avian,16-23,0,0,0,0,NaN,NaN
15,0.950,Unknown Avian,23-5,0,0,0,0,NaN,NaN
15,0.950,Human UTI,16-23,76,78,0,154,49.351,49.351
15,0.950,Human UTI,23-5,94,125,0,219,42.922,42.922
15,0.950,unknown,16-23,0,0,0,0,NaN,NaN
15,0.950,unknown,23-5,0,2,0,2,0.000,0.000
15,0.950,SLO Creek Water,16-23,0,0,0,0,NaN,NaN
15,0.950,SLO Creek Water,23-5,0,0,0,0,NaN,NaN
15,0.950,Pig/Swine,16-23,2,3,0,5,40.000,40.000
15,0.950,Pig/Swine,23-5,7,8,0,15,46.667,46.667
15,0.950,Klebsiella,16-23,0,0,0,0,NaN,NaN
15,0.950,Klebsiella,23-5,0,0,0,0,NaN,NaN
15,0.950,Hu Cw and Dg,16-23,3,7,0,10,30.000,30.000
15,0.950,Hu Cw and Dg,23-5,5,6,0,11,45.455,45.455
15,0.950,Ground Squirrel,16-23,74,46,0,120,61.667,61.667
15,0.950,Ground Squirrel,23-5,80,64,0,144,55.556,55.556
15,0.950,Opossum,16-23,0,0,0,0,NaN,NaN
15,0.950,Opossum,23-5,0,0,0,0,NaN,NaN
15,0.950,Cow,16-23,1576,1233,0,2809,56.105,56.105
15,0.950,Cow,23-5,1532,1694,0,3226,47.489,47.489
15,0.950,Deer Mouse,16-23,0,0,0,0,NaN,NaN
15,0.950,Deer Mouse,23-5,0,0,0,0,NaN,NaN
15,0.950,OVERALL,16-23,3689,2638,0,6327,58.306,58.306
15,0.950,OVERALL,23-5,4229,3359,0,7588,55.733,55.733
15,0.960,Chicken,16-23,0,0,0,0,NaN,NaN
15,0.960,Chicken,23-5,5,2,0,7,71.429,71.429
15,0.960,Sea Lion,16-23,0,0,0,0,NaN,NaN
15,0.960,Sea Lion,23-5,0,7,0,7,0.000,0.000
15,0.960,Hu and Cw,16-23,1,3,0,4,25.000,25.000
15,0.960,Hu and Cw,23-5,9,7,0,16,56.250,56.250
15,0.960,Sheep,16-23,44,53,0,97,45.361,45.361
15,0.960,Sheep,23-5,52,41,0,93,55.914,55.914
15,0.960,Hu and Dg,16-23,7,7,0,14,50.000,50.000
15,0.960,Hu and Dg,23-5,20,24,0,44,45.455,45.455
15,0.960,Common Loon,16-23,0,0,0,0,NaN,NaN
15,0.960,Common Loon,23-5,0,0,0,0,NaN,NaN
15,0.960,Red-Winged Blackbird,16-23,0,0,0,0,NaN,NaN
15,0.960,Red-Winged Blackbird,23-5,0,0,0,0,NaN,NaN
15,0.960,Cw,16-23,5,8,0,13,38.462,38.462
15,0.960,Cw,23-5,11,16,0,27,40.741,40.741
15,0.960,Cliff Sparrow,16-23,0,6,0,6,0.000,0.000
15,0.960,Cliff Sparrow,23-5,0,0,0,0,NaN,NaN
15,0.960,Pig,16-23,5,4,0,9,55.556,55.556
15,0.960,Pig,23-5,0,0,0,0,NaN,NaN
15,0.960,Barn Owl,16-23,0,0,0,0,NaN,NaN
15,0.960,Barn Owl,23-5,0,0,0,0,NaN,NaN
15,0.960,Wild Pig,16-23,0,0,0,0,NaN,NaN
15,0.960,Wild Pig,23-5,1,0,0,1,100.000,100.000
15,0.960,Pennington Creek Water,16-23,0,0,0,0,NaN,NaN
15,0.960,Pennington Creek Water,23-5,0,0,0,0,NaN,NaN
15,0.960,Guinni,16-23,0,0,0,0,NaN,NaN
15,0.960,Guinni,23-5,0,0,0,0,NaN,NaN
15,0.960,Racoon,16-23,0,0,0,0,NaN,NaN
15,0.960,Racoon,23-5,0,0,0,0,NaN,NaN
15,0.960,Hu,16-23,10,7,0,17,58.824,58.824
15,0.960,Hu,23-5,22,19,0,41,53.659,53.659
15,0.960,Cw and Dg,16-23,6,14,0,20,30.000,30.000
15,0.960,Cw and Dg,23-5,13,17,0,30,43.333,43.333
15,0.960,Red Wind Blackbird,16-23,0,0,0,0,NaN,NaN
15,0.960,Red Wind Blackbird,23-5,0,0,0,0,NaN,NaN
15,0.960,Tree Swallow,16-23,0,0,0,0,NaN,NaN
15,0.960,Tree Swallow,23-5,0,0,0,0,NaN,NaN
15,0.960,Turkey Vulture,16-23,0,0,0,0,NaN,NaN
15,0.960,Turkey Vulture,23-5,0,0,0,0,NaN,NaN
15,0.960,Dg,16-23,6,11,0,17,35.294,35.294
15,0.960,Dg,23-5,31,35,0,66,46.970,46.970
15,0.960,Western Kingbird,16-23,0,0,0,0,NaN,NaN
15,0.960,Western Kingbird,23-5,0,0,0,0,NaN,NaN
15,0.960,White Crowned Sparrow,16-23,0,0,0,0,NaN,NaN
15,0.960,White Crowned Sparrow,23-5,0,4,0,4,0.000,0.000
15,0.960,Eared Grebe,16-23,0,0,0,0,NaN,NaN
15,0.960,Eared Grebe,23-5,0,5,0,5,0.000,0.000
15,0.960,cougar,16-23,0,0,0,0,NaN,NaN
15,0.960,cougar,23-5,0,0,0,0,NaN,NaN
15,0.960,Ocean Water,16-23,0,0,0,0,NaN,NaN
15,0.960,Ocean Water,23-5,0,0,0,0,NaN,NaN
15,0.960,Red Tailed Hawk,16-23,0,0,0,0,NaN,NaN
15,0.960,Red Tailed Hawk,23-5,0,0,0,0,NaN,NaN
15,0.960,Dog,16-23,52,70,0,122,42.623,42.623
15,0.960,Dog,23-5,80,136,0,216,37.037,37.037
15,0.960,Human,16-23,1730,857,0,2587,66.873,66.873
15,0.960,Human,23-5,2132,760,0,2892,73.721,73.721
15,0.960,Wild Turkey,16-23,0,1,0,1,0.000,0.000
15,0.960,Wild Turkey,23-5,1,9,0,10,10.000,10.000
15,0.960,Clark Grebe,16-23,0,0,0,0,NaN,NaN
15,0.960,Clark Grebe,23-5,0,0,0,0,NaN,NaN
15,0.960,Seagull,16-23,0,0,0,0,NaN,NaN
15,0.960,Seagull,23-5,3,8,0,11,27.273,27.273
15,0.960,Surf Scoter,16-23,0,0,0,0,NaN,NaN
15,0.960,Surf Scoter,23-5,0,2,0,2,0.000,0.000
15,0.960,Pigeon,16-23,24,123,0,147,16.327,16.327
15,0.960,Pigeon,23-5,62,137,0,199,31.156,31.156
15,0.960,Pacific Ocean Water,16-23,0,0,0,0,NaN,NaN
15,0.960,Pacific Ocean Water,23-5,0,0,0,0,NaN,NaN
15,0.960,Cat,16-23,16,20,0,36,44.444,44.444
15,0.960,Cat,23-5,8,24,0,32,25.000,25.000
15,0.960,Horse,16-23,6,10,0,16,37.500,37.500
15,0.960,Horse,23-5,17,49,0,66,25.758,25.758
15,0.960,orangutan,16-23,0,0,0,0,NaN,NaN
15,0.960,orangutan,23-5,0,0,0,0,NaN,NaN
15,0.960,Bat,16-23,36,38,0,74,48.649,48.649
15,0.960,Bat,23-5,37,37,0,74,50.000,50.000
15,0.960,Deer,16-23,11,38,0,49,22.449,22.449
15,0.960,Deer,23-5,14,127,0,141,9.929,9.929
15,0.960,Great Horned Owl,16-23,0,0,0,0,NaN,NaN
15,0.960,Great Horned Owl,23-5,0,0,0,0,NaN,NaN
15,0.960,Freshwater Lagoon,16-23,0,0,0,0,NaN,NaN
15,0.960,Freshwater Lagoon,23-5,0,0,0,0,NaN,NaN
15,0.960,Unknown Avian,16-23,0,0,0,0,NaN,NaN
15,0.960,Unknown Avian,23-5,0,0,0,0,NaN,NaN
15,0.960,Human UTI,16-23,76,79,0,155,49.032,49.032
15,0.960,Human UTI,23-5,94,124,0,218,43.119,43.119
15,0.960,unknown,16-23,0,0,0,0,NaN,NaN
15,0.960,unknown,23-5,0,2,0,2,0.000,0.000
15,0.960,SLO Creek Water,16-23,0,0,0,0,NaN,NaN
15,0.960,SLO Creek Water,23-5,0,0,0,0,NaN,NaN
15,0.960,Pig/Swine,16-23,2,3,0,5,40.000,40.000
15,0.960,Pig/Swine,23-5,7,8,0,15,46.667,46.667
15,0.960,Klebsiella,16-23,0,0,0,0,NaN,NaN
15,0.960,Klebsiella,23-5,0,0,0,0,NaN,NaN
15,0.960,Hu Cw and Dg,16-23,3,7,0,10,30.000,30.000
15,0.960,Hu Cw and Dg,23-5,5,6,0,11,45.455,45.455
15,0.960,Ground Squirrel,16-23,74,46,0,120,61.667,61.667
15,0.960,Ground Squirrel,23-5,80,66,0,146,54.795,54.795
15,0.960,Opossum,16-23,0,0,0,0,NaN,NaN
15,0.960,Opossum,23-5,0,0,0,0,NaN,NaN
15,0.960,Cow,16-23,1574,1223,0,2797,56.275,56.275
15,0.960,Cow,23-5,1532,1669,0,3201,47.860,47.860
15,0.960,Deer Mouse,16-23,0,0,0,0,NaN,NaN
15,0.960,Deer Mouse,23-5,0,0,0,0,NaN,NaN
15,0.960,OVERALL,16-23,3688,2628,0,6316,58.391,58.391
15,0.960,OVERALL,23-5,4236,3341,0,7577,55.906,55.906
15,0.970,Chicken,16-23,0,0,0,0,NaN,NaN
15,0.970,Chicken,23-5,5,2,0,7,71.429,71.429
15,0.970,Sea Lion,16-23,0,0,0,0,NaN,NaN
15,0.970,Sea Lion,23-5,0,9,0,9,0.000,0.000
15,0.970,Hu and Cw,16-23,1,3,0,4,25.000,25.000
15,0.970,Hu and Cw,23-5,9,7,0,16,56.250,56.250
15,0.970,Sheep,16-23,45,54,0,99,45.455,45.455
15,0.970,Sheep,23-5,52,40,0,92,56.522,56.522
15,0.970,Hu and Dg,16-23,7,7,0,14,50.000,50.000
15,0.970,Hu and Dg,23-5,20,24,0,44,45.455,45.455
15,0.970,Common Loon,16-23,0,0,0,0,NaN,NaN
15,0.970,Common Loon,23-5,0,0,0,0,NaN,NaN
15,0.970,Red-Winged Blackbird,16-23,0,0,0,0,NaN,NaN
15,0.970,Red-Winged Blackbird,23-5,0,0,0,0,NaN,NaN
15,0.970,Cw,16-23,5,9,0,14,35.714,35.714
15,0.970,Cw,23-5,11,16,0,27,40.741,40.741
15,0.970,Cliff Sparrow,16-23,0,6,0,6,0.000,0.000
15,0.970,Cliff Sparrow,23-5,0,0,0,0,NaN,NaN
15,0.970,Pig,16-23,5,4,0,9,55.556,55.556
15,0.970,Pig,23-5,0,0,0,0,NaN,NaN
15,0.970,Barn Owl,16-23,0,0,0,0,NaN,NaN
15,0.970,Barn Owl,23-5,0,0,0,0,NaN,NaN
15,0.970,Wild Pig,16-23,0,0,0,0,NaN,NaN
15,0.970,Wild Pig,23-5,0,0,0,0,NaN,NaN
15,0.970,Pennington Creek Water,16-23,0,0,0,0,NaN,NaN
15,0.970,Pennington Creek Water,23-5,0,0,0,0,NaN,NaN
15,0.970,Guinni,16-23,0,0,0,0,NaN,NaN
15,0.970,Guinni,23-5,0,0,0,0,NaN,NaN
15,0.970,Racoon,16-23,0,0,0,0,NaN,NaN
15,0.970,Racoon,23-5,0,0,0,0,NaN,NaN
15,0.970,Hu,16-23,10,7,0,17,58.824,58.824
15,0.970,Hu,23-5,22,19,0,41,53.659,53.659
15,0.970,Cw and Dg,16-23,6,14,0,20,30.000,30.000
15,0.970,Cw and Dg,23-5,13,17,0,30,43.333,43.333
15,0.970,Red Wind Blackbird,16-23,0,0,0,0,NaN,NaN
15,0.970,Red Wind Blackbird,23-5,0,0,0,0,NaN,NaN
15,0.970,Tree Swallow,16-23,0,0,0,0,NaN,NaN
15,0.970,Tree Swallow,23-5,0,0,0,0,NaN,NaN
15,0.970,Turkey Vulture,16-23,0,0,0,0,NaN,NaN
15,0.970,Turkey Vulture,23-5,0,0,0,0,NaN,NaN
15,0.970,Dg,16-23,6,11,0,17,35.294,35.294
15,0.970,Dg,23-5,31,34,0,65,47.692,47.692
15,0.970,Western Kingbird,16-23,0,0,0,0,NaN,NaN
15,0.970,Western Kingbird,23-5,0,0,0,0,NaN,NaN
15,0.970,White Crowned Sparrow,16-23,0,0,0,0,NaN,NaN
15,0.970,White Crowned Sparrow,23-5,0,4,0,4,0.000,0.000
15,0.970,Eared Grebe,16-23,0,0,0,0,NaN,NaN
15,0.970,Eared Grebe,23-5,0,5,0,5,0.000,0.000
15,0.970,cougar,16-23,0,0,0,0,NaN,NaN
15,0.970,cougar,23-5,0,0,0,0,NaN,NaN
15,0.970,Ocean Water,16-23,0,0,0,0,NaN,NaN
15,0.970,Ocean Water,23-5,0,0,0,0,NaN,NaN
15,0.970,Red Tailed Hawk,16-23,0,0,0,0,NaN,NaN
15,0.970,Red Tailed Hawk,23-5,0,0,0,0,NaN,NaN
15,0.970,Dog,16-23,52,70,0,122,42.623,42.623
15,0.970,Dog,23-5,82,135,0,217,37.788,37.788
15,0.970,Human,16-23,1729,853,0,2582,66.964,66.964
15,0.970,Human,23-5,2132,755,0,2887,73.848,73.848
15,0.970,Wild Turkey,16-23,0,3,0,3,0.000,0.000
15,0.970,Wild Turkey,23-5,3,8,0,11,27.273,27.273
15,0.970,Clark Grebe,16-23,0,0,0,0,NaN,NaN
15,0.970,Clark Grebe,23-5,0,0,0,0,NaN,NaN
15,0.970,Seagull,16-23,0,0,0,0,NaN,NaN
15,0.970,Seagull,23-5,3,9,0,12,25.000,25.000
15,0.970,Surf Scoter,16-23,0,0,0,0,NaN,NaN
15,0.970,Surf Scoter,23-5,0,2,0,2,0.000,0.000
15,0.970,Pigeon,16-23,23,122,0,145,15.862,15.862
15,0.970,Pigeon,23-5,62,153,0,215,28.837,28.837
15,0.970,Pacific Ocean Water,16-23,0,0,0,0,NaN,NaN
15,0.970,Pacific Ocean Water,23-5,0,0,0,0,NaN,NaN
15,0.970,Cat,16-23,16,20,0,36,44.444,44.444
15,0.970,Cat,23-5,8,21,0,29,27.586,27.586
15,0.970,Horse,16-23,6,10,0,16,37.500,37.500
15,0.970,Horse,23-5,17,50,0,67,25.373,25.373
15,0.970,orangutan,16-23,0,0,0,0,NaN,NaN
15,0.970,orangutan,23-5,0,0,0,0,NaN,NaN
15,0.970,Bat,16-23,36,38,0,74,48.649,48.649
15,0.970,Bat,23-5,37,37,0,74,50.000,50.000
15,0.970,Deer,16-23,11,38,0,49,22.449,22.449
15,0.970,Deer,23-5,14,127,0,141,9.929,9.929
15,0.970,Great Horned Owl,16-23,0,0,0,0,NaN,NaN
15,0.970,Great Horned Owl,23-5,0,0,0,0,NaN,NaN
15,0.970,Freshwater Lagoon,16-23,0,0,0,0,NaN,NaN
15,0.970,Freshwater Lagoon,23-5,0,0,0,0,NaN,NaN
15,0.970,Unknown Avian,16-23,0,0,0,0,NaN,NaN
15,0.970,Unknown Avian,23-5,0,0,0,0,NaN,NaN
15,0.970,Human UTI,16-23,76,81,0,157,48.408,48.408
15,0.970,Human UTI,23-5,93,124,0,217,42.857,42.857
15,0.970,unknown,16-23,0,0,0,0,NaN,NaN
15,0.970,unknown,23-5,0,2,0,2,0.000,0.000
15,0.970,SLO Creek Water,16-23,0,0,0,0,NaN,NaN
15,0.970,SLO Creek Water,23-5,0,0,0,0,NaN,NaN
15,0.970,Pig/Swine,16-23,2,3,0,5,40.000,40.000
15,0.970,Pig/Swine,23-5,7,8,0,15,46.667,46.667
15,0.970,Klebsiella,16-23,0,0,0,0,NaN,NaN
15,0.970,Klebsiella,23-5,0,0,0,0,NaN,NaN
15,0.970,Hu Cw and Dg,16-23,3,7,0,10,30.000,30.000
15,0.970,Hu Cw and Dg,23-5,5,6,0,11,45.455,45.455
15,0.970,Ground Squirrel,16-23,74,45,0,119,62.185,62.185
15,0.970,Ground Squirrel,23-5,80,64,0,144,55.556,55.556
15,0.970,Opossum,16-23,0,0,0,0,NaN,NaN
15,0.970,Opossum,23-5,0,0,0,0,NaN,NaN
15,0.970,Cow,16-23,1568,1220,0,2788,56.241,56.241
15,0.970,Cow,23-5,1529,1643,0,3172,48.203,48.203
15,0.970,Deer Mouse,16-23,0,0,0,0,NaN,NaN
15,0.970,Deer Mouse,23-5,0,0,0,0,NaN,NaN
15,0.970,OVERALL,16-23,3681,2625,0,6306,58.373,58.373
15,0.970,OVERALL,23-5,4235,3321,0,7556,56.048,56.048
15,0.980,Chicken,16-23,0,0,0,0,NaN,NaN
15,0.980,Chicken,23-5,6,2,0,8,75.000,75.000
15,0.980,Sea Lion,16-23,0,0,0,0,NaN,NaN
15,0.980,Sea Lion,23-5,0,10,0,10,0.000,0.000
15,0.980,Hu and Cw,16-23,1,3,0,4,25.000,25.000
15,0.980,Hu and Cw,23-5,9,17,0,26,34.615,34.615
15,0.980,Sheep,16-23,48,51,0,99,48.485,48.485
15,0.980,Sheep,23-5,51,39,0,90,56.667,56.667
15,0.980,Hu and Dg,16-23,7,7,0,14,50.000,50.000
15,0.980,Hu and Dg,23-5,20,22,0,42,47.619,47.619
15,0.980,Common Loon,16-23,0,0,0,0,NaN,NaN
15,0.980,Common Loon,23-5,0,0,0,0,NaN,NaN
15,0.980,Red-Winged Blackbird,16-23,0,0,0,0,NaN,NaN
15,0.980,Red-Winged Blackbird,23-5,0,0,0,0,NaN,NaN
15,0.980,Cw,16-23,5,8,0,13,38.462,38.462
15,0.980,Cw,23-5,11,18,0,29,37.931,37.931
15,0.980,Cliff Sparrow,16-23,0,6,0,6,0.000,0.000
15,0.980,Cliff Sparrow,23-5,0,0,0,0,NaN,NaN
15,0.980,Pig,16-23,5,4,0,9,55.556,55.556
15,0.980,Pig,23-5,0,0,0,0,NaN,NaN
15,0.980,Barn Owl,16-23,0,0,0,0,NaN,NaN
15,0.980,Barn Owl,23-5,0,0,0,0,NaN,NaN
15,0.980,Wild Pig,16-23,0,0,0,0,NaN,NaN
15,0.980,Wild Pig,23-5,0,0,0,0,NaN,NaN
15,0.980,Pennington Creek Water,16-23,0,0,0,0,NaN,NaN
15,0.980,Pennington Creek Water,23-5,0,0,0,0,NaN,NaN
15,0.980,Guinni,16-23,0,0,0,0,NaN,NaN
15,0.980,Guinni,23-5,0,0,0,0,NaN,NaN
15,0.980,Racoon,16-23,0,0,0,0,NaN,NaN
15,0.980,Racoon,23-5,0,0,0,0,NaN,NaN
15,0.980,Hu,16-23,10,7,0,17,58.824,58.824
15,0.980,Hu,23-5,22,20,0,42,52.381,52.381
15,0.980,Cw and Dg,16-23,6,14,0,20,30.000,30.000
15,0.980,Cw and Dg,23-5,13,19,0,32,40.625,40.625
15,0.980,Red Wind Blackbird,16-23,0,0,0,0,NaN,NaN
15,0.980,Red Wind Blackbird,23-5,0,0,0,0,NaN,NaN
15,0.980,Tree Swallow,16-23,0,0,0,0,NaN,NaN
15,0.980,Tree Swallow,23-5,0,0,0,0,NaN,NaN
15,0.980,Turkey Vulture,16-23,0,0,0,0,NaN,NaN
15,0.980,Turkey Vulture,23-5,0,0,0,0,NaN,NaN
15,0.980,Dg,16-23,6,11,0,17,35.294,35.294
15,0.980,Dg,23-5,31,26,0,57,54.386,54.386
15,0.980,Western Kingbird,16-23,0,0,0,0,NaN,NaN
15,0.980,Western Kingbird,23-5,0,0,0,0,NaN,NaN
15,0.980,White Crowned Sparrow,16-23,0,0,0,0,NaN,NaN
15,0.980,White Crowned Sparrow,23-5,0,6,0,6,0.000,0.000
15,0.980,Eared Grebe,16-23,0,0,0,0,NaN,NaN
15,0.980,Eared Grebe,23-5,0,5,0,5,0.000,0.000
15,0.980,cougar,16-23,0,0,0,0,NaN,NaN
15,0.980,cougar,23-5,0,0,0,0,NaN,NaN
15,0.980,Ocean Water,16-23,0,0,0,0,NaN,NaN
15,0.980,Ocean Water,23-5,0,0,0,0,NaN,NaN
15,0.980,Red Tailed Hawk,16-23,0,0,0,0,NaN,NaN
15,0.980,Red Tailed Hawk,23-5,0,0,0,0,NaN,NaN
15,0.980,Dog,16-23,51,75,0,126,40.476,40.476
15,0.980,Dog,23-5,82,130,0,212,38.679,38.679
15,0.980,Human,16-23,1728,840,0,2568,67.290,67.290
15,0.980,Human,23-5,2132,739,0,2871,74.260,74.260
15,0.980,Wild Turkey,16-23,1,3,0,4,25.000,25.000
15,0.980,Wild Turkey,23-5,5,18,0,23,21.739,21.739
15,0.980,Clark Grebe,16-23,0,0,0,0,NaN,NaN
15,0.980,Clark Grebe,23-5,0,0,0,0,NaN,NaN
15,0.980,Seagull,16-23,0,0,0,0,NaN,NaN
15,0.980,Seagull,23-5,5,7,0,12,41.667,41.667
15,0.980,Surf Scoter,16-23,0,0,0,0,NaN,NaN
15,0.980,Surf Scoter,23-5,2,0,0,2,100.000,100.000
15,0.980,Pigeon,16-23,23,121,0,144,15.972,15.972
15,0.980,Pigeon,23-5,61,163,0,224,27.232,27.232
15,0.980,Pacific Ocean Water,16-23,0,0,0,0,NaN,NaN
15,0.980,Pacific Ocean Water,23-5,0,0,0,0,NaN,NaN
15,0.980,Cat,16-23,16,20,0,36,44.444,44.444
15,0.980,Cat,23-5,9,16,0,25,36.000,36.000
15,0.980,Horse,16-23,6,10,0,16,37.500,37.500
15,0.980,Horse,23-5,17,48,0,65,26.154,26.154
15,0.980,orangutan,16-23,0,0,0,0,NaN,NaN
15,0.980,orangutan,23-5,0,0,0,0,NaN,NaN
15,0.980,Bat,16-23,36,37,0,73,49.315,49.315
15,0.980,Bat,23-5,37,37,0,74,50.000,50.000
15,0.980,Deer,16-23,11,38,0,49,22.449,22.449
15,0.980,Deer,23-5,14,127,0,141,9.929,9.929
15,0.980,Great Horned Owl,16-23,0,0,0,0,NaN,NaN
15,0.980,Great Horned Owl,23-5,0,0,0,0,NaN,NaN
15,0.980,Freshwater Lagoon,16-23,0,0,0,0,NaN,NaN
15,0.980,Freshwater Lagoon,23-5,0,0,0,0,NaN,NaN
15,0.980,Unknown Avian,16-23,0,0,0,0,NaN,NaN
15,0.980,Unknown Avian,23-5,0,0,0,0,NaN,NaN
15,0.980,Human UTI,16-23,76,83,0,159,47.799,47.799
15,0.980,Human UTI,23-5,94,122,0,216,43.519,43.519
15,0.980,unknown,16-23,0,0,0,0,NaN,NaN
15,0.980,unknown,23-5,0,3,0,3,0.000,0.000
15,0.980,SLO Creek Water,16-23,0,0,0,0,NaN,NaN
15,0.980,SLO Creek Water,23-5,0,0,0,0,NaN,NaN
15,0.980,Pig/Swine,16-23,2,3,0,5,40.000,40.000
15,0.980,Pig/Swine,23-5,7,8,0,15,46.667,46.667
15,0.980,Klebsiella,16-23,0,0,0,0,NaN,NaN
15,0.980,Klebsiella,23-5,0,0,0,0,NaN,NaN
15,0.980,Hu Cw and Dg,16-23,3,7,0,10,30.000,30.000
15,0.980,Hu Cw and Dg,23-5,5,5,0,10,50.000,50.000
15,0.980,Ground Squirrel,16-23,77,46,0,123,62.602,62.602
15,0.980,Ground Squirrel,23-5,81,63,0,144,56.250,56.250
15,0.980,Opossum,16-23,0,0,0,0,NaN,NaN
15,0.980,Opossum,23-5,0,0,0,0,NaN,NaN
15,0.980,Cow,16-23,1560,1204,0,2764,56.440,56.440
15,0.980,Cow,23-5,1522,1605,0,3127,48.673,48.673
15,0.980,Deer Mouse,16-23,0,0,0,0,NaN,NaN
15,0.980,Deer Mouse,23-5,0,0,0,0,NaN,NaN
15,0.980,OVERALL,16-23,3678,2598,0,6276,58.604,58.604
15,0.980,OVERALL,23-5,4236,3275,0,7511,56.397,56.397
15,0.990,Chicken,16-23,2,6,0,8,25.000,25.000
15,0.990,Chicken,23-5,7,2,0,9,77.778,77.778
15,0.990,Sea Lion,16-23,0,0,0,0,NaN,NaN
15,0.990,Sea Lion,23-5,2,7,0,9,22.222,22.222
15,0.990,Hu and Cw,16-23,2,3,0,5,40.000,40.000
15,0.990,Hu and Cw,23-5,10,24,0,34,29.412,29.412
15,0.990,Sheep,16-23,47,52,0,99,47.475,47.475
15,0.990,Sheep,23-5,52,39,0,91,57.143,57.143
15,0.990,Hu and Dg,16-23,7,9,0,16,43.750,43.750
15,0.990,Hu and Dg,23-5,20,20,0,40,50.000,50.000
15,0.990,Common Loon,16-23,0,0,0,0,NaN,NaN
15,0.990,Common Loon,23-5,0,2,0,2,0.000,0.000
15,0.990,Red-Winged Blackbird,16-23,0,2,0,2,0.000,0.000
15,0.990,Red-Winged Blackbird,23-5,0,0,0,0,NaN,NaN
15,0.990,Cw,16-23,6,8,0,14,42.857,42.857
15,0.990,Cw,23-5,17,21,0,38,44.737,44.737
15,0.990,Cliff Sparrow,16-23,0,8,0,8,0.000,0.000
15,0.990,Cliff Sparrow,23-5,0,4,0,4,0.000,0.000
15,0.990,Pig,16-23,5,5,0,10,50.000,50.000
15,0.990,Pig,23-5,7,8,0,15,46.667,46.667
15,0.990,Barn Owl,16-23,0,0,0,0,NaN,NaN
15,0.990,Barn Owl,23-5,0,0,0,0,NaN,NaN
15,0.990,Wild Pig,16-23,0,2,0,2,0.000,0.000
15,0.990,Wild Pig,23-5,0,1,0,1,0.000,0.000
15,0.990,Pennington Creek Water,16-23,0,0,0,0,NaN,NaN
15,0.990,Pennington Creek Water,23-5,0,0,0,0,NaN,NaN
15,0.990,Guinni,16-23,0,0,0,0,NaN,NaN
15,0.990,Guinni,23-5,0,0,0,0,NaN,NaN
15,0.990,Racoon,16-23,0,0,0,0,NaN,NaN
15,0.990,Racoon,23-5,0,1,0,1,0.000,0.000
15,0.990,Hu,16-23,10,7,0,17,58.824,58.824
15,0.990,Hu,23-5,22,15,0,37,59.459,59.459
15,0.990,Cw and Dg,16-23,6,14,0,20,30.000,30.000
15,0.990,Cw and Dg,23-5,14,12,0,26,53.846,53.846
15,0.990,Red Wind Blackbird,16-23,0,0,0,0,NaN,NaN
15,0.990,Red Wind Blackbird,23-5,0,0,0,0,NaN,NaN
15,0.990,Tree Swallow,16-23,0,0,0,0,NaN,NaN
15,0.990,Tree Swallow,23-5,0,0,0,0,NaN,NaN
15,0.990,Turkey Vulture,16-23,0,0,0,0,NaN,NaN
15,0.990,Turkey Vulture,23-5,0,0,0,0,NaN,NaN
15,0.990,Dg,16-23,6,12,0,18,33.333,33.333
15,0.990,Dg,23-5,31,20,0,51,60.784,60.784
15,0.990,Western Kingbird,16-23,0,0,0,0,NaN,NaN
15,0.990,Western Kingbird,23-5,0,0,0,0,NaN,NaN
15,0.990,White Crowned Sparrow,16-23,0,0,0,0,NaN,NaN
15,0.990,White Crowned Sparrow,23-5,0,7,0,7,0.000,0.000
15,0.990,Eared Grebe,16-23,0,0,0,0,NaN,NaN
15,0.990,Eared Grebe,23-5,0,7,0,7,0.000,0.000
15,0.990,cougar,16-23,0,1,0,1,0.000,0.000
15,0.990,cougar,23-5,0,0,0,0,NaN,NaN
15,0.990,Ocean Water,16-23,0,0,0,0,NaN,NaN
15,0.990,Ocean Water,23-5,0,0,0,0,NaN,NaN
15,0.990,Red Tailed Hawk,16-23,0,0,0,0,NaN,NaN
15,0.990,Red Tailed Hawk,23-5,0,1,0,1,0.000,0.000
15,0.990,Dog,16-23,54,73,0,127,42.520,42.520
15,0.990,Dog,23-5,86,128,0,214,40.187,40.187
15,0.990,Human,16-23,1706,797,0,2503,68.158,68.158
15,0.990,Human,23-5,2118,673,0,2791,75.887,75.887
15,0.990,Wild Turkey,16-23,3,9,0,12,25.000,25.000
15,0.990,Wild Turkey,23-5,5,19,0,24,20.833,20.833
15,0.990,Clark Grebe,16-23,0,0,0,0,NaN,NaN
15,0.990,Clark Grebe,23-5,2,3,0,5,40.000,40.000
15,0.990,Seagull,16-23,0,0,0,0,NaN,NaN
15,0.990,Seagull,23-5,11,6,0,17,64.706,64.706
15,0.990,Surf Scoter,16-23,0,0,0,0,NaN,NaN
15,0.990,Surf Scoter,23-5,2,0,0,2,100.000,100.000
15,0.990,Pigeon,16-23,34,121,0,155,21.935,21.935
15,0.990,Pigeon,23-5,70,184,0,254,27.559,27.559
15,0.990,Pacific Ocean Water,16-23,0,0,0,0,NaN,NaN
15,0.990,Pacific Ocean Water,23-5,0,0,0,0,NaN,NaN
15,0.990,Cat,16-23,17,23,0,40,42.500,42.500
15,0.990,Cat,23-5,9,21,0,30,30.000,30.000
15,0.990,Horse,16-23,9,11,0,20,45.000,45.000
15,0.990,Horse,23-5,17,69,0,86,19.767,19.767
15,0.990,orangutan,16-23,0,0,0,0,NaN,NaN
15,0.990,orangutan,23-5,0,0,0,0,NaN,NaN
15,0.990,Bat,16-23,36,33,0,69,52.174,52.174
15,0.990,Bat,23-5,37,36,0,73,50.685,50.685
15,0.990,Deer,16-23,11,39,0,50,22.000,22.000
15,0.990,Deer,23-5,14,114,0,128,10.938,10.938
15,0.990,Great Horned Owl,16-23,0,0,0,0,NaN,NaN
15,0.990,Great Horned Owl,23-5,0,0,0,0,NaN,NaN
15,0.990,Freshwater Lagoon,16-23,0,0,0,0,NaN,NaN
15,0.990,Freshwater Lagoon,23-5,0,0,0,0,NaN,NaN
15,0.990,Unknown Avian,16-23,0,0,0,0,NaN,NaN
15,0.990,Unknown Avian,23-5,0,0,0,0,NaN,NaN
15,0.990,Human UTI,16-23,79,74,0,153,51.634,51.634
15,0.990,Human UTI,23-5,96,96,0,192,50.000,50.000
15,0.990,unknown,16-23,0,0,0,0,NaN,NaN
15,0.990,unknown,23-5,0,5,0,5,0.000,0.000
15,0.990,SLO Creek Water,16-23,0,0,0,0,NaN,NaN
15,0.990,SLO Creek Water,23-5,0,0,0,0,NaN,NaN
15,0.990,Pig/Swine,16-23,2,4,0,6,33.333,33.333
15,0.990,Pig/Swine,23-5,7,8,0,15,46.667,46.667
15,0.990,Klebsiella,16-23,0,0,0,0,NaN,NaN
15,0.990,Klebsiella,23-5,0,0,0,0,NaN,NaN
15,0.990,Hu Cw and Dg,16-23,3,7,0,10,30.000,30.000
15,0.990,Hu Cw and Dg,23-5,5,7,0,12,41.667,41.667
15,0.990,Ground Squirrel,16-23,80,47,0,127,62.992,62.992
15,0.990,Ground Squirrel,23-5,84,68,0,152,55.263,55.263
15,0.990,Opossum,16-23,1,0,0,1,100.000,100.000
15,0.990,Opossum,23-5,2,0,0,2,100.000,100.000
15,0.990,Cow,16-23,1527,1094,0,2621,58.260,58.260
15,0.990,Cow,23-5,1482,1448,0,2930,50.580,50.580
15,0.990,Deer Mouse,16-23,0,0,0,0,NaN,NaN
15,0.990,Deer Mouse,23-5,0,0,0,0,NaN,NaN
15,0.990,OVERALL,16-23,3653,2461,0,6114,59.748,59.748
15,0.990,OVERALL,23-5,4229,3076,0,7305,57.892,57.892
15,1.000,Chicken,16-23,0,0,0,0,NaN,NaN
15,1.000,Chicken,23-5,0,0,0,0,NaN,NaN
15,1.000,Sea Lion,16-23,0,0,0,0,NaN,NaN
15,1.000,Sea Lion,23-5,0,0,0,0,NaN,NaN
15,1.000,Hu and Cw,16-23,0,0,0,0,NaN,NaN
15,1.000,Hu and Cw,23-5,0,0,0,0,NaN,NaN
15,1.000,Sheep,16-23,0,0,0,0,NaN,NaN
15,1.000,Sheep,23-5,0,0,0,0,NaN,NaN
15,1.000,Hu and Dg,16-23,0,0,0,0,NaN,NaN
15,1.000,Hu and Dg,23-5,0,0,0,0,NaN,NaN
15,1.000,Common Loon,16-23,0,0,0,0,NaN,NaN
15,1.000,Common Loon,23-5,0,0,0,0,NaN,NaN
15,1.000,Red-Winged Blackbird,16-23,0,0,0,0,NaN,NaN
15,1.000,Red-Winged Blackbird,23-5,0,0,0,0,NaN,NaN
15,1.000,Cw,16-23,0,0,0,0,NaN,NaN
15,1.000,Cw,23-5,0,0,0,0,NaN,NaN
15,1.000,Cliff Sparrow,16-23,0,0,0,0,NaN,NaN
15,1.000,Cliff Sparrow,23-5,0,0,0,0,NaN,NaN
15,1.000,Pig,16-23,0,0,0,0,NaN,NaN
15,1.000,Pig,23-5,0,0,0,0,NaN,NaN
15,1.000,Barn Owl,16-23,0,0,0,0,NaN,NaN
15,1.000,Barn Owl,23-5,0,0,0,0,NaN,NaN
15,1.000,Wild Pig,16-23,0,0,0,0,NaN,NaN
15,1.000,Wild Pig,23-5,0,0,0,0,NaN,NaN
15,1.000,Pennington Creek Water,16-23,0,0,0,0,NaN,NaN
15,1.000,Pennington Creek Water,23-5,0,0,0,0,NaN,NaN
15,1.000,Guinni,16-23,0,0,0,0,NaN,NaN
15,1.000,Guinni,23-5,0,0,0,0,NaN,NaN
15,1.000,Racoon,16-23,0,0,0,0,NaN,NaN
15,1.000,Racoon,23-5,0,0,0,0,NaN,NaN
15,1.000,Hu,16-23,0,0,0,0,NaN,NaN
15,1.000,Hu,23-5,0,0,0,0,NaN,NaN
15,1.000,Cw and Dg,16-23,0,0,0,0,NaN,NaN
15,1.000,Cw and Dg,23-5,0,0,0,0,NaN,NaN
15,1.000,Red Wind Blackbird,16-23,0,0,0,0,NaN,NaN
15,1.000,Red Wind Blackbird,23-5,0,0,0,0,NaN,NaN
15,1.000,Tree Swallow,16-23,0,0,0,0,NaN,NaN
15,1.000,Tree Swallow,23-5,0,0,0,0,NaN,NaN
15,1.000,Turkey Vulture,16-23,0,0,0,0,NaN,NaN
15,1.000,Turkey Vulture,23-5,0,0,0,0,NaN,NaN
15,1.000,Dg,16-23,0,0,0,0,NaN,NaN
15,1.000,Dg,23-5,0,0,0,0,NaN,NaN
15,1.000,Western Kingbird,16-23,0,0,0,0,NaN,NaN
15,1.000,Western Kingbird,23-5,0,0,0,0,NaN,NaN
15,1.000,White Crowned Sparrow,16-23,0,0,0,0,NaN,NaN
15,1.000,White Crowned Sparrow,23-5,0,0,0,0,NaN,NaN
15,1.000,Eared Grebe,16-23,0,0,0,0,NaN,NaN
15,1.000,Eared Grebe,23-5,0,0,0,0,NaN,NaN
15,1.000,cougar,16-23,0,0,0,0,NaN,NaN
15,1.000,cougar,23-5,0,0,0,0,NaN,NaN
15,1.000,Ocean Water,16-23,0,0,0,0,NaN,NaN
15,1.000,Ocean Water,23-5,0,0,0,0,NaN,NaN
15,1.000,Red Tailed Hawk,16-23,0,0,0,0,NaN,NaN
15,1.000,Red Tailed Hawk,23-5,0,0,0,0,NaN,NaN
15,1.000,Dog,16-23,0,0,0,0,NaN,NaN
15,1.000,Dog,23-5,0,0,0,0,NaN,NaN
15,1.000,Human,16-23,0,0,0,0,NaN,NaN
15,1.000,Human,23-5,0,0,0,0,NaN,NaN
15,1.000,Wild Turkey,16-23,0,0,0,0,NaN,NaN
15,1.000,Wild Turkey,23-5,0,0,0,0,NaN,NaN
15,1.000,Clark Grebe,16-23,0,0,0,0,NaN,NaN
15,1.000,Clark Grebe,23-5,0,0,0,0,NaN,NaN
15,1.000,Seagull,16-23,0,0,0,0,NaN,NaN
15,1.000,Seagull,23-5,0,0,0,0,NaN,NaN
15,1.000,Surf Scoter,16-23,0,0,0,0,NaN,NaN
15,1.000,Surf Scoter,23-5,0,0,0,0,NaN,NaN
15,1.000,Pigeon,16-23,0,0,0,0,NaN,NaN
15,1.000,Pigeon,23-5,0,0,0,0,NaN,NaN
15,1.000,Pacific Ocean Water,16-23,0,0,0,0,NaN,NaN
15,1.000,Pacific Ocean Water,23-5,0,0,0,0,NaN,NaN
15,1.000,Cat,16-23,0,0,0,0,NaN,NaN
15,1.000,Cat,23-5,0,0,0,0,NaN,NaN
15,1.000,Horse,16-23,0,0,0,0,NaN,NaN
15,1.000,Horse,23-5,0,0,0,0,NaN,NaN
15,1.000,orangutan,16-23,0,0,0,0,NaN,NaN
15,1.000,orangutan,23-5,0,0,0,0,NaN,NaN
15,1.000,Bat,16-23,0,0,0,0,NaN,NaN
15,1.000,Bat,23-5,0,0,0,0,NaN,NaN
15,1.000,Deer,16-23,0,0,0,0,NaN,NaN
15,1.000,Deer,23-5,0,0,0,0,NaN,NaN
15,1.000,Great Horned Owl,16-23,0,0,0,0,NaN,NaN
15,1.000,Great Horned Owl,23-5,0,0,0,0,NaN,NaN
15,1.000,Freshwater Lagoon,16-23,0,0,0,0,NaN,NaN
15,1.000,Freshwater Lagoon,23-5,0,0,0,0,NaN,NaN
15,1.000,Unknown Avian,16-23,0,0,0,0,NaN,NaN
15,1.000,Unknown Avian,23-5,0,0,0,0,NaN,NaN
15,1.000,Human UTI,16-23,0,0,0,0,NaN,NaN
15,1.000,Human UTI,23-5,0,0,0,0,NaN,NaN
15,1.000,unknown,16-23,0,0,0,0,NaN,NaN
15,1.000,unknown,23-5,0,0,0,0,NaN,NaN
15,1.000,SLO Creek Water,16-23,0,0,0,0,NaN,NaN
15,1.000,SLO Creek Water,23-5,0,0,0,0,NaN,NaN
15,1.000,Pig/Swine,16-23,0,0,0,0,NaN,NaN
15,1.000,Pig/Swine,23-5,0,0,0,0,NaN,NaN
15,1.000,Klebsiella,16-23,0,0,0,0,NaN,NaN
15,1.000,Klebsiella,23-5,0,0,0,0,NaN,NaN
15,1.000,Hu Cw and Dg,16-23,0,0,0,0,NaN,NaN
15,1.000,Hu Cw and Dg,23-5,0,0,0,0,NaN,NaN
15,1.000,Ground Squirrel,16-23,0,0,0,0,NaN,NaN
15,1.000,Ground Squirrel,23-5,0,0,0,0,NaN,NaN
15,1.000,Opossum,16-23,0,0,0,0,NaN,NaN
15,1.000,Opossum,23-5,0,0,0,0,NaN,NaN
15,1.000,Cow,16-23,0,0,0,0,NaN,NaN
15,1.000,Cow,23-5,0,0,0,0,NaN,NaN
15,1.000,Deer Mouse,16-23,0,0,0,0,NaN,NaN
15,1.000,Deer Mouse,23-5,0,0,0,0,NaN,NaN
15,1.000,OVERALL,16-23,0,0,0,0,NaN,NaN
15,1.000,OVERALL,23-5,0,0,0,0,NaN,NaN
16,0.000,Chicken,16-23,0,0,0,0,NaN,NaN
16,0.000,Chicken,23-5,4,2,0,6,66.667,66.667
16,0.000,Sea Lion,16-23,0,0,0,0,NaN,NaN
16,0.000,Sea Lion,23-5,0,6,0,6,0.000,0.000
16,0.000,Hu and Cw,16-23,0,4,0,4,0.000,0.000
16,0.000,Hu and Cw,23-5,10,7,0,17,58.824,58.824
16,0.000,Sheep,16-23,44,48,0,92,47.826,47.826
16,0.000,Sheep,23-5,53,41,0,94,56.383,56.383
16,0.000,Hu and Dg,16-23,7,6,0,13,53.846,53.846
16,0.000,Hu and Dg,23-5,18,24,0,42,42.857,42.857
16,0.000,Common Loon,16-23,0,0,0,0,NaN,NaN
16,0.000,Common Loon,23-5,0,0,0,0,NaN,NaN
16,0.000,Red-Winged Blackbird,16-23,0,0,0,0,NaN,NaN
16,0.000,Red-Winged Blackbird,23-5,0,0,0,0,NaN,NaN
16,0.000,Cw,16-23,4,6,0,10,40.000,40.000
16,0.000,Cw,23-5,12,13,0,25,48.000,48.000
16,0.000,Cliff Sparrow,16-23,0,5,0,5,0.000,0.000
16,0.000,Cliff Sparrow,23-5,0,0,0,0,NaN,NaN
16,0.000,Pig,16-23,2,4,0,6,33.333,33.333
16,0.000,Pig,23-5,0,0,0,0,NaN,NaN
16,0.000,Barn Owl,16-23,0,0,0,0,NaN,NaN
16,0.000,Barn Owl,23-5,0,0,0,0,NaN,NaN
16,0.000,Wild Pig,16-23,0,0,0,0,NaN,NaN
16,0.000,Wild Pig,23-5,0,0,0,0,NaN,NaN
16,0.000,Pennington Creek Water,16-23,0,0,0,0,NaN,NaN
16,0.000,Pennington Creek Water,23-5,0,0,0,0,NaN,NaN
16,0.000,Guinni,16-23,0,0,0,0,NaN,NaN
16,0.000,Guinni,23-5,0,0,0,0,NaN,NaN
16,0.000,Racoon,16-23,0,0,0,0,NaN,NaN
16,0.000,Racoon,23-5,0,0,0,0,NaN,NaN
16,0.000,Hu,16-23,8,6,0,14,57.143,57.143
16,0.000,Hu,23-5,22,21,0,43,51.163,51.163
16,0.000,Cw and Dg,16-23,4,13,0,17,23.529,23.529
16,0.000,Cw and Dg,23-5,14,20,0,34,41.176,41.176
16,0.000,Red Wind Blackbird,16-23,0,0,0,0,NaN,NaN
16,0.000,Red Wind Blackbird,23-5,0,0,0,0,NaN,NaN
16,0.000,Tree Swallow,16-23,0,0,0,0,NaN,NaN
16,0.000,Tree Swallow,23-5,0,0,0,0,NaN,NaN
16,0.000,Turkey Vulture,16-23,0,0,0,0,NaN,NaN
16,0.000,Turkey Vulture,23-5,0,0,0,0,NaN,NaN
16,0.000,Dg,16-23,5,11,0,16,31.250,31.250
16,0.000,Dg,23-5,31,37,0,68,45.588,45.588
16,0.000,Western Kingbird,16-23,0,0,0,0,NaN,NaN
16,0.000,Western Kingbird,23-5,0,0,0,0,NaN,NaN
16,0.000,White Crowned Sparrow,16-23,0,0,0,0,NaN,NaN
16,0.000,White Crowned Sparrow,23-5,0,2,0,2,0.000,0.000
16,0.000,Eared Grebe,16-23,0,0,0,0,NaN,NaN
16,0.000,Eared Grebe,23-5,0,6,0,6,0.000,0.000
16,0.000,cougar,16-23,0,0,0,0,NaN,NaN
16,0.000,cougar,23-5,0,0,0,0,NaN,NaN
16,0.000,Ocean Water,16-23,0,0,0,0,NaN,NaN
16,0.000,Ocean Water,23-5,0,0,0,0,NaN,NaN
16,0.000,Red Tailed Hawk,16-23,0,0,0,0,NaN,NaN
16,0.000,Red Tailed Hawk,23-5,0,0,0,0,NaN,NaN
16,0.000,Dog,16-23,52,70,0,122,42.623,42.623
16,0.000,Dog,23-5,82,151,0,233,35.193,35.193
16,0.000,Human,16-23,1735,884,0,2619,66.247,66.247
16,0.000,Human,23-5,2129,804,0,2933,72.588,72.588
16,0.000,Wild Turkey,16-23,0,1,0,1,0.000,0.000
16,0.000,Wild Turkey,23-5,1,4,0,5,20.000,20.000
16,0.000,Clark Grebe,16-23,0,0,0,0,NaN,NaN
16,0.000,Clark Grebe,23-5,0,0,0,0,NaN,NaN
16,0.000,Seagull,16-23,0,0,0,0,NaN,NaN
16,0.000,Seagull,23-5,3,7,0,10,30.000,30.000
16,0.000,Surf Scoter,16-23,0,0,0,0,NaN,NaN
16,0.000,Surf Scoter,23-5,0,0,0,0,NaN,NaN
16,0.000,Pigeon,16-23,19,121,0,140,13.571,13.571
16,0.000,Pigeon,23-5,55,119,0,174,31.609,31.609
16,0.000,Pacific Ocean Water,16-23,0,0,0,0,NaN,NaN
16,0.000,Pacific Ocean Water,23-5,0,0,0,0,NaN,NaN
16,0.000,Cat,16-23,13,17,0,30,43.333,43.333
16,0.000,Cat,23-5,8,15,0,23,34.783,34.783
16,0.000,Horse,16-23,4,9,0,13,30.769,30.769
16,0.000,Horse,23-5,13,38,0,51,25.490,25.490
16,0.000,orangutan,16-23,0,0,0,0,NaN,NaN
16,0.000,orangutan,23-5,0,0,0,0,NaN,NaN
16,0.000,Bat,16-23,36,37,0,73,49.315,49.315
16,0.000,Bat,23-5,37,41,0,78,47.436,47.436
16,0.000,Deer,16-23,10,36,0,46,21.739,21.739
16,0.000,Deer,23-5,14,129,0,143,9.790,9.790
16,0.000,Great Horned Owl,16-23,0,0,0,0,NaN,NaN
16,0.000,Great Horned Owl,23-5,0,0,0,0,NaN,NaN
16,0.000,Freshwater Lagoon,16-23,0,0,0,0,NaN,NaN
16,0.000,Freshwater Lagoon,23-5,0,0,0,0,NaN,NaN
16,0.000,Unknown Avian,16-23,0,0,0,0,NaN,NaN
16,0.000,Unknown Avian,23-5,0,0,0,0,NaN,NaN
16,0.000,Human UTI,16-23,65,71,0,136,47.794,47.794
16,0.000,Human UTI,23-5,91,122,0,213,42.723,42.723
16,0.000,unknown,16-23,0,0,0,0,NaN,NaN
16,0.000,unknown,23-5,0,2,0,2,0.000,0.000
16,0.000,SLO Creek Water,16-23,0,0,0,0,NaN,NaN
16,0.000,SLO Creek Water,23-5,0,0,0,0,NaN,NaN
16,0.000,Pig/Swine,16-23,2,2,0,4,50.000,50.000
16,0.000,Pig/Swine,23-5,7,8,0,15,46.667,46.667
16,0.000,Klebsiella,16-23,0,0,0,0,NaN,NaN
16,0.000,Klebsiella,23-5,0,0,0,0,NaN,NaN
16,0.000,Hu Cw and Dg,16-23,3,7,0,10,30.000,30.000
16,0.000,Hu Cw and Dg,23-5,3,5,0,8,37.500,37.500
16,0.000,Ground Squirrel,16-23,73,44,0,117,62.393,62.393
16,0.000,Ground Squirrel,23-5,76,63,0,139,54.676,54.676
16,0.000,Opossum,16-23,0,0,0,0,NaN,NaN
16,0.000,Opossum,23-5,0,0,0,0,NaN,NaN
16,0.000,Cow,16-23,1570,1290,0,2860,54.895,54.895
16,0.000,Cow,23-5,1523,1717,0,3240,47.006,47.006
16,0.000,Deer Mouse,16-23,0,0,0,0,NaN,NaN
16,0.000,Deer Mouse,23-5,0,0,0,0,NaN,NaN
16,0.000,OVERALL,16-23,3656,2692,0,6348,57.593,57.593
16,0.000,OVERALL,23-5,4206,3404,0,7610,55.269,55.269
16,0.500,Chicken,16-23,0,0,0,0,NaN,NaN
16,0.500,Chicken,23-5,4,2,0,6,66.667,66.667
16,0.500,Sea Lion,16-23,0,0,0,0,NaN,NaN
16,0.500,Sea Lion,23-5,0,6,0,6,0.000,0.000
16,0.500,Hu and Cw,16-23,0,4,0,4,0.000,0.000
16,0.500,Hu and Cw,23-5,10,7,0,17,58.824,58.824
16,0.500,Sheep,16-23,44,48,0,92,47.826,47.826
16,0.500,Sheep,23-5,53,41,0,94,56.383,56.383
16,0.500,Hu and Dg,16-23,7,6,0,13,53.846,53.846
16,0.500,Hu and Dg,23-5,18,24,0,42,42.857,42.857
16,0.500,Common Loon,16-23,0,0,0,0,NaN,NaN
16,0.500,Common Loon,23-5,0,0,0,0,NaN,NaN
16,0.500,Red-Winged Blackbird,16-23,0,0,0,0,NaN,NaN
16,0.500,Red-Winged Blackbird,23-5,0,0,0,0,NaN,NaN
16,0.500,Cw,16-23,4,6,0,10,40.000,40.000
16,0.500,Cw,23-5,12,13,0,25,48.000,48.000
16,0.500,Cliff Sparrow,16-23,0,5,0,5,0.000,0.000
16,0.500,Cliff Sparrow,23-5,0,0,0,0,NaN,NaN
16,0.500,Pig,16-23,2,4,0,6,33.333,33.333
16,0.500,Pig,23-5,0,0,0,0,NaN,NaN
16,0.500,Barn Owl,16-23,0,0,0,0,NaN,NaN
16,0.500,Barn Owl,23-5,0,0,0,0,NaN,NaN
16,0.500,Wild Pig,16-23,0,0,0,0,NaN,NaN
16,0.500,Wild Pig,23-5,0,0,0,0,NaN,NaN
16,0.500,Pennington Creek Water,16-23,0,0,0,0,NaN,NaN
16,0.500,Pennington Creek Water,23-5,0,0,0,0,NaN,NaN
16,0.500,Guinni,16-23,0,0,0,0,NaN,NaN
16,0.500,Guinni,23-5,0,0,0,0,NaN,NaN
16,0.500,Racoon,16-23,0,0,0,0,NaN,NaN
16,0.500,Racoon,23-5,0,0,0,0,NaN,NaN
16,0.500,Hu,16-23,8,6,0,14,57.143,57.143
16,0.500,Hu,23-5,22,21,0,43,51.163,51.163
16,0.500,Cw and Dg,16-23,4,13,0,17,23.529,23.529
16,0.500,Cw and Dg,23-5,14,20,0,34,41.176,41.176
16,0.500,Red Wind Blackbird,16-23,0,0,0,0,NaN,NaN
16,0.500,Red Wind Blackbird,23-5,0,0,0,0,NaN,NaN
16,0.500,Tree Swallow,16-23,0,0,0,0,NaN,NaN
16,0.500,Tree Swallow,23-5,0,0,0,0,NaN,NaN
16,0.500,Turkey Vulture,16-23,0,0,0,0,NaN,NaN
16,0.500,Turkey Vulture,23-5,0,0,0,0,NaN,NaN
16,0.500,Dg,16-23,5,11,0,16,31.250,31.250
16,0.500,Dg,23-5,31,37,0,68,45.588,45.588
16,0.500,Western Kingbird,16-23,0,0,0,0,NaN,NaN
16,0.500,Western Kingbird,23-5,0,0,0,0,NaN,NaN
16,0.500,White Crowned Sparrow,16-23,0,0,0,0,NaN,NaN
16,0.500,White Crowned Sparrow,23-5,0,2,0,2,0.000,0.000
16,0.500,Eared Grebe,16-23,0,0,0,0,NaN,NaN
16,0.500,Eared Grebe,23-5,0,6,0,6,0.000,0.000
16,0.500,cougar,16-23,0,0,0,0,NaN,NaN
16,0.500,cougar,23-5,0,0,0,0,NaN,NaN
16,0.500,Ocean Water,16-23,0,0,0,0,NaN,NaN
16,0.500,Ocean Water,23-5,0,0,0,0,NaN,NaN
16,0.500,Red Tailed Hawk,16-23,0,0,0,0,NaN,NaN
16,0.500,Red Tailed Hawk,23-5,0,0,0,0,NaN,NaN
16,0.500,Dog,16-23,52,70,0,122,42.623,42.623
16,0.500,Dog,23-5,82,151,0,233,35.193,35.193
16,0.500,Human,16-23,1735,884,0,2619,66.247,66.247
16,0.500,Human,23-5,2129,804,0,2933,72.588,72.588
16,0.500,Wild Turkey,16-23,0,1,0,1,0.000,0.000
16,0.500,Wild Turkey,23-5,1,4,0,5,20.000,20.000
16,0.500,Clark Grebe,16-23,0,0,0,0,NaN,NaN
16,0.500,Clark Grebe,23-5,0,0,0,0,NaN,NaN
16,0.500,Seagull,16-23,0,0,0,0,NaN,NaN
16,0.500,Seagull,23-5,3,7,0,10,30.000,30.000
16,0.500,Surf Scoter,16-23,0,0,0,0,NaN,NaN
16,0.500,Surf Scoter,23-5,0,0,0,0,NaN,NaN
16,0.500,Pigeon,16-23,19,121,0,140,13.571,13.571
16,0.500,Pigeon,23-5,55,119,0,174,31.609,31.609
16,0.500,Pacific Ocean Water,16-23,0,0,0,0,NaN,NaN
16,0.500,Pacific Ocean Water,23-5,0,0,0,0,NaN,NaN
16,0.500,Cat,16-23,13,17,0,30,43.333,43.333
16,0.500,Cat,23-5,8,15,0,23,34.783,34.783
16,0.500,Horse,16-23,4,9,0,13,30.769,30.769
16,0.500,Horse,23-5,13,38,0,51,25.490,25.490
16,0.500,orangutan,16-23,0,0,0,0,NaN,NaN
16,0.500,orangutan,23-5,0,0,0,0,NaN,NaN
16,0.500,Bat,16-23,36,37,0,73,49.315,49.315
16,0.500,Bat,23-5,37,41,0,78,47.436,47.436
16,0.500,Deer,16-23,10,36,0,46,21.739,21.739
16,0.500,Deer,23-5,14,129,0,143,9.790,9.790
16,0.500,Great Horned Owl,16-23,0,0,0,0,NaN,NaN
16,0.500,Great Horned Owl,23-5,0,0,0,0,NaN,NaN
16,0.500,Freshwater Lagoon,16-23,0,0,0,0,NaN,NaN
16,0.500,Freshwater Lagoon,23-5,0,0,0,0,NaN,NaN
16,0.500,Unknown Avian,16-23,0,0,0,0,NaN,NaN
16,0.500,Unknown Avian,23-5,0,0,0,0,NaN,NaN
16,0.500,Human UTI,16-23,65,71,0,136,47.794,47.794
16,0.500,Human UTI,23-5,91,122,0,213,42.723,42.723
16,0.500,unknown,16-23,0,0,0,0,NaN,NaN
16,0.500,unknown,23-5,0,2,0,2,0.000,0.000
16,0.500,SLO Creek Water,16-23,0,0,0,0,NaN,NaN
16,0.500,SLO Creek Water,23-5,0,0,0,0,NaN,NaN
16,0.500,Pig/Swine,16-23,2,2,0,4,50.000,50.000
16,0.500,Pig/Swine,23-5,7,8,0,15,46.667,46.667
16,0.500,Klebsiella,16-23,0,0,0,0,NaN,NaN
16,0.500,Klebsiella,23-5,0,0,0,0,NaN,NaN
16,0.500,Hu Cw and Dg,16-23,3,7,0,10,30.000,30.000
16,0.500,Hu Cw and Dg,23-5,3,5,0,8,37.500,37.500
16,0.500,Ground Squirrel,16-23,73,44,0,117,62.393,62.393
16,0.500,Ground Squirrel,23-5,76,63,0,139,54.676,54.676
16,0.500,Opossum,16-23,0,0,0,0,NaN,NaN
16,0.500,Opossum,23-5,0,0,0,0,NaN,NaN
16,0.500,Cow,16-23,1570,1290,0,2860,54.895,54.895
16,0.500,Cow,23-5,1523,1717,0,3240,47.006,47.006
16,0.500,Deer Mouse,16-23,0,0,0,0,NaN,NaN
16,0.500,Deer Mouse,23-5,0,0,0,0,NaN,NaN
16,0.500,OVERALL,16-23,3656,2692,0,6348,57.593,57.593
16,0.500,OVERALL,23-5,4206,3404,0,7610,55.269,55.269
16,0.900,Chicken,16-23,0,0,0,0,NaN,NaN
16,0.900,Chicken,23-5,4,2,0,6,66.667,66.667
16,0.900,Sea Lion,16-23,0,0,0,0,NaN,NaN
16,0.900,Sea Lion,23-5,0,6,0,6,0.000,0.000
16,0.900,Hu and Cw,16-23,0,4,0,4,0.000,0.000
16,0.900,Hu and Cw,23-5,10,7,0,17,58.824,58.824
16,0.900,Sheep,16-23,44,48,0,92,47.826,47.826
16,0.900,Sheep,23-5,53,41,0,94,56.383,56.383
16,0.900,Hu and Dg,16-23,7,6,0,13,53.846,53.846
16,0.900,Hu and Dg,23-5,18,24,0,42,42.857,42.857
16,0.900,Common Loon,16-23,0,0,0,0,NaN,NaN
16,0.900,Common Loon,23-5,0,0,0,0,NaN,NaN
16,0.900,Red-Winged Blackbird,16-23,0,0,0,0,NaN,NaN
16,0.900,Red-Winged Blackbird,23-5,0,0,0,0,NaN,NaN
16,0.900,Cw,16-23,4,6,0,10,40.000,40.000
16,0.900,Cw,23-5,12,13,0,25,48.000,48.000
16,0.900,Cliff Sparrow,16-23,0,5,0,5,0.000,0.000
16,0.900,Cliff Sparrow,23-5,0,0,0,0,NaN,NaN
16,0.900,Pig,16-23,2,4,0,6,33.333,33.333
16,0.900,Pig,23-5,0,0,0,0,NaN,NaN
16,0.900,Barn Owl,16-23,0,0,0,0,NaN,NaN
16,0.900,Barn Owl,23-5,0,0,0,0,NaN,NaN
16,0.900,Wild Pig,16-23,0,0,0,0,NaN,NaN
16,0.900,Wild Pig,23-5,0,0,0,0,NaN,NaN
16,0.900,Pennington Creek Water,16-23,0,0,0,0,NaN,NaN
16,0.900,Pennington Creek Water,23-5,0,0,0,0,NaN,NaN
16,0.900,Guinni,16-23,0,0,0,0,NaN,NaN
16,0.900,Guinni,23-5,0,0,0,0,NaN,NaN
16,0.900,Racoon,16-23,0,0,0,0,NaN,NaN
16,0.900,Racoon,23-5,0,0,0,0,NaN,NaN
16,0.900,Hu,16-23,8,6,0,14,57.143,57.143
16,0.900,Hu,23-5,22,21,0,43,51.163,51.163
16,0.900,Cw and Dg,16-23,4,13,0,17,23.529,23.529
16,0.900,Cw and Dg,23-5,14,20,0,34,41.176,41.176
16,0.900,Red Wind Blackbird,16-23,0,0,0,0,NaN,NaN
16,0.900,Red Wind Blackbird,23-5,0,0,0,0,NaN,NaN
16,0.900,Tree Swallow,16-23,0,0,0,0,NaN,NaN
16,0.900,Tree Swallow,23-5,0,0,0,0,NaN,NaN
16,0.900,Turkey Vulture,16-23,0,0,0,0,NaN,NaN
16,0.900,Turkey Vulture,23-5,0,0,0,0,NaN,NaN
16,0.900,Dg,16-23,5,11,0,16,31.250,31.250
16,0.900,Dg,23-5,31,37,0,68,45.588,45.588
16,0.900,Western Kingbird,16-23,0,0,0,0,NaN,NaN
16,0.900,Western Kingbird,23-5,0,0,0,0,NaN,NaN
16,0.900,White Crowned Sparrow,16-23,0,0,0,0,NaN,NaN
16,0.900,White Crowned Sparrow,23-5,0,2,0,2,0.000,0.000
16,0.900,Eared Grebe,16-23,0,0,0,0,NaN,NaN
16,0.900,Eared Grebe,23-5,0,6,0,6,0.000,0.000
16,0.900,cougar,16-23,0,0,0,0,NaN,NaN
16,0.900,cougar,23-5,0,0,0,0,NaN,NaN
16,0.900,Ocean Water,16-23,0,0,0,0,NaN,NaN
16,0.900,Ocean Water,23-5,0,0,0,0,NaN,NaN
16,0.900,Red Tailed Hawk,16-23,0,0,0,0,NaN,NaN
16,0.900,Red Tailed Hawk,23-5,0,0,0,0,NaN,NaN
16,0.900,Dog,16-23,52,70,0,122,42.623,42.623
16,0.900,Dog,23-5,82,147,0,229,35.808,35.808
16,0.900,Human,16-23,1735,880,0,2615,66.348,66.348
16,0.900,Human,23-5,2129,800,0,2929,72.687,72.687
16,0.900,Wild Turkey,16-23,0,1,0,1,0.000,0.000
16,0.900,Wild Turkey,23-5,1,4,0,5,20.000,20.000
16,0.900,Clark Grebe,16-23,0,0,0,0,NaN,NaN
16,0.900,Clark Grebe,23-5,0,0,0,0,NaN,NaN
16,0.900,Seagull,16-23,0,0,0,0,NaN,NaN
16,0.900,Seagull,23-5,3,8,0,11,27.273,27.273
16,0.900,Surf Scoter,16-23,0,0,0,0,NaN,NaN
16,0.900,Surf Scoter,23-5,0,0,0,0,NaN,NaN
16,0.900,Pigeon,16-23,19,121,0,140,13.571,13.571
16,0.900,Pigeon,23-5,55,119,0,174,31.609,31.609
16,0.900,Pacific Ocean Water,16-23,0,0,0,0,NaN,NaN
16,0.900,Pacific Ocean Water,23-5,0,0,0,0,NaN,NaN
16,0.900,Cat,16-23,13,17,0,30,43.333,43.333
16,0.900,Cat,23-5,8,15,0,23,34.783,34.783
16,0.900,Horse,16-23,4,9,0,13,30.769,30.769
16,0.900,Horse,23-5,13,38,0,51,25.490,25.490
16,0.900,orangutan,16-23,0,0,0,0,NaN,NaN
16,0.900,orangutan,23-5,0,0,0,0,NaN,NaN
16,0.900,Bat,16-23,36,37,0,73,49.315,49.315
16,0.900,Bat,23-5,37,41,0,78,47.436,47.436
16,0.900,Deer,16-23,10,36,0,46,21.739,21.739
16,0.900,Deer,23-5,14,129,0,143,9.790,9.790
16,0.900,Great Horned Owl,16-23,0,0,0,0,NaN,NaN
16,0.900,Great Horned Owl,23-5,0,0,0,0,NaN,NaN
16,0.900,Freshwater Lagoon,16-23,0,0,0,0,NaN,NaN
16,0.900,Freshwater Lagoon,23-5,0,0,0,0,NaN,NaN
16,0.900,Unknown Avian,16-23,0,0,0,0,NaN,NaN
16,0.900,Unknown Avian,23-5,0,0,0,0,NaN,NaN
16,0.900,Human UTI,16-23,65,71,0,136,47.794,47.794
16,0.900,Human UTI,23-5,94,122,0,216,43.519,43.519
16,0.900,unknown,16-23,0,0,0,0,NaN,NaN
16,0.900,unknown,23-5,0,2,0,2,0.000,0.000
16,0.900,SLO Creek Water,16-23,0,0,0,0,NaN,NaN
16,0.900,SLO Creek Water,23-5,0,0,0,0,NaN,NaN
16,0.900,Pig/Swine,16-23,2,2,0,4,50.000,50.000
16,0.900,Pig/Swine,23-5,7,8,0,15,46.667,46.667
16,0.900,Klebsiella,16-23,0,0,0,0,NaN,NaN
16,0.900,Klebsiella,23-5,0,0,0,0,NaN,NaN
16,0.900,Hu Cw and Dg,16-23,3,7,0,10,30.000,30.000
16,0.900,Hu Cw and Dg,23-5,3,5,0,8,37.500,37.500
16,0.900,Ground Squirrel,16-23,73,44,0,117,62.393,62.393
16,0.900,Ground Squirrel,23-5,76,63,0,139,54.676,54.676
16,0.900,Opossum,16-23,0,0,0,0,NaN,NaN
16,0.900,Opossum,23-5,0,0,0,0,NaN,NaN
16,0.900,Cow,16-23,1572,1288,0,2860,54.965,54.965
16,0.900,Cow,23-5,1523,1713,0,3236,47.064,47.064
16,0.900,Deer Mouse,16-23,0,0,0,0,NaN,NaN
16,0.900,Deer Mouse,23-5,0,0,0,0,NaN,NaN
16,0.900,OVERALL,16-23,3658,2686,0,6344,57.661,57.661
16,0.900,OVERALL,23-5,4209,3393,0,7602,55.367,55.367
16,0.950,Chicken,16-23,0,0,0,0,NaN,NaN
16,0.950,Chicken,23-5,4,2,0,6,66.667,66.667
16,0.950,Sea Lion,16-23,0,0,0,0,NaN,NaN
16,0.950,Sea Lion,23-5,0,6,0,6,0.000,0.000
16,0.950,Hu and Cw,16-23,0,4,0,4,0.000,0.000
16,0.950,Hu and Cw,23-5,10,7,0,17,58.824,58.824
16,0.950,Sheep,16-23,44,48,0,92,47.826,47.826
16,0.950,Sheep,23-5,53,41,0,94,56.383,56.383
16,0.950,Hu and Dg,16-23,7,6,0,13,53.846,53.846
16,0.950,Hu and Dg,23-5,18,24,0,42,42.857,42.857
16,0.950,Common Loon,16-23,0,0,0,0,NaN,NaN
16,0.950,Common Loon,23-5,0,0,0,0,NaN,NaN
16,0.950,Red-Winged Blackbird,16-23,0,0,0,0,NaN,NaN
16,0.950,Red-Winged Blackbird,23-5,0,0,0,0,NaN,NaN
16,0.950,Cw,16-23,4,6,0,10,40.000,40.000
16,0.950,Cw,23-5,12,13,0,25,48.000,48.000
16,0.950,Cliff Sparrow,16-23,0,5,0,5,0.000,0.000
16,0.950,Cliff Sparrow,23-5,0,0,0,0,NaN,NaN
16,0.950,Pig,16-23,2,4,0,6,33.333,33.333
16,0.950,Pig,23-5,0,0,0,0,NaN,NaN
16,0.950,Barn Owl,16-23,0,0,0,0,NaN,NaN
16,0.950,Barn Owl,23-5,0,0,0,0,NaN,NaN
16,0.950,Wild Pig,16-23,0,0,0,0,NaN,NaN
16,0.950,Wild Pig,23-5,0,0,0,0,NaN,NaN
16,0.950,Pennington Creek Water,16-23,0,0,0,0,NaN,NaN
16,0.950,Pennington Creek Water,23-5,0,0,0,0,NaN,NaN
16,0.950,Guinni,16-23,0,0,0,0,NaN,NaN
16,0.950,Guinni,23-5,0,0,0,0,NaN,NaN
16,0.950,Racoon,16-23,0,0,0,0,NaN,NaN
16,0.950,Racoon,23-5,0,0,0,0,NaN,NaN
16,0.950,Hu,16-23,8,6,0,14,57.143,57.143
16,0.950,Hu,23-5,22,21,0,43,51.163,51.163
16,0.950,Cw and Dg,16-23,4,13,0,17,23.529,23.529
16,0.950,Cw and Dg,23-5,14,20,0,34,41.176,41.176
16,0.950,Red Wind Blackbird,16-23,0,0,0,0,NaN,NaN
16,0.950,Red Wind Blackbird,23-5,0,0,0,0,NaN,NaN
16,0.950,Tree Swallow,16-23,0,0,0,0,NaN,NaN
16,0.950,Tree Swallow,23-5,0,0,0,0,NaN,NaN
16,0.950,Turkey Vulture,16-23,0,0,0,0,NaN,NaN
16,0.950,Turkey Vulture,23-5,0,0,0,0,NaN,NaN
16,0.950,Dg,16-23,5,11,0,16,31.250,31.250
16,0.950,Dg,23-5,31,36,0,67,46.269,46.269
16,0.950,Western Kingbird,16-23,0,0,0,0,NaN,NaN
16,0.950,Western Kingbird,23-5,0,0,0,0,NaN,NaN
16,0.950,White Crowned Sparrow,16-23,0,0,0,0,NaN,NaN
16,0.950,White Crowned Sparrow,23-5,0,2,0,2,0.000,0.000
16,0.950,Eared Grebe,16-23,0,0,0,0,NaN,NaN
16,0.950,Eared Grebe,23-5,0,6,0,6,0.000,0.000
16,0.950,cougar,16-23,0,0,0,0,NaN,NaN
16,0.950,cougar,23-5,0,0,0,0,NaN,NaN
16,0.950,Ocean Water,16-23,0,0,0,0,NaN,NaN
16,0.950,Ocean Water,23-5,0,0,0,0,NaN,NaN
16,0.950,Red Tailed Hawk,16-23,0,0,0,0,NaN,NaN
16,0.950,Red Tailed Hawk,23-5,0,0,0,0,NaN,NaN
16,0.950,Dog,16-23,52,70,0,122,42.623,42.623
16,0.950,Dog,23-5,82,145,0,227,36.123,36.123
16,0.950,Human,16-23,1735,877,0,2612,66.424,66.424
16,0.950,Human,23-5,2122,793,0,2915,72.796,72.796
16,0.950,Wild Turkey,16-23,0,1,0,1,0.000,0.000
16,0.950,Wild Turkey,23-5,1,3,0,4,25.000,25.000
16,0.950,Clark Grebe,16-23,0,0,0,0,NaN,NaN
16,0.950,Clark Grebe,23-5,0,0,0,0,NaN,NaN
16,0.950,Seagull,16-23,0,0,0,0,NaN,NaN
16,0.950,Seagull,23-5,3,7,0,10,30.000,30.000
16,0.950,Surf Scoter,16-23,0,0,0,0,NaN,NaN
16,0.950,Surf Scoter,23-5,0,0,0,0,NaN,NaN
16,0.950,Pigeon,16-23,20,120,0,140,14.286,14.286
16,0.950,Pigeon,23-5,55,120,0,175,31.429,31.429
16,0.950,Pacific Ocean Water,16-23,0,0,0,0,NaN,NaN
16,0.950,Pacific Ocean Water,23-5,0,0,0,0,NaN,NaN
16,0.950,Cat,16-23,13,17,0,30,43.333,43.333
16,0.950,Cat,23-5,8,22,0,30,26.667,26.667
16,0.950,Horse,16-23,4,9,0,13,30.769,30.769
16,0.950,Horse,23-5,13,38,0,51,25.490,25.490
16,0.950,orangutan,16-23,0,0,0,0,NaN,NaN
16,0.950,orangutan,23-5,0,0,0,0,NaN,NaN
16,0.950,Bat,16-23,36,37,0,73,49.315,49.315
16,0.950,Bat,23-5,37,40,0,77,48.052,48.052
16,0.950,Deer,16-23,10,36,0,46,21.739,21.739
16,0.950,Deer,23-5,14,129,0,143,9.790,9.790
16,0.950,Great Horned Owl,16-23,0,0,0,0,NaN,NaN
16,0.950,Great Horned Owl,23-5,0,0,0,0,NaN,NaN
16,0.950,Freshwater Lagoon,16-23,0,0,0,0,NaN,NaN
16,0.950,Freshwater Lagoon,23-5,0,0,0,0,NaN,NaN
16,0.950,Unknown Avian,16-23,0,0,0,0,NaN,NaN
16,0.950,Unknown Avian,23-5,0,0,0,0,NaN,NaN
16,0.950,Human UTI,16-23,68,72,0,140,48.571,48.571
16,0.950,Human UTI,23-5,93,125,0,218,42.661,42.661
16,0.950,unknown,16-23,0,0,0,0,NaN,NaN
16,0.950,unknown,23-5,0,2,0,2,0.000,0.000
16,0.950,SLO Creek Water,16-23,0,0,0,0,NaN,NaN
16,0.950,SLO Creek Water,23-5,0,0,0,0,NaN,NaN
16,0.950,Pig/Swine,16-23,2,2,0,4,50.000,50.000
16,0.950,Pig/Swine,23-5,7,8,0,15,46.667,46.667
16,0.950,Klebsiella,16-23,0,0,0,0,NaN,NaN
16,0.950,Klebsiella,23-5,0,0,0,0,NaN,NaN
16,0.950,Hu Cw and Dg,16-23,3,7,0,10,30.000,30.000
16,0.950,Hu Cw and Dg,23-5,3,5,0,8,37.500,37.500
16,0.950,Ground Squirrel,16-23,73,44,0,117,62.393,62.393
16,0.950,Ground Squirrel,23-5,76,62,0,138,55.072,55.072
16,0.950,Opossum,16-23,0,0,0,0,NaN,NaN
16,0.950,Opossum,23-5,0,0,0,0,NaN,NaN
16,0.950,Cow,16-23,1575,1267,0,2842,55.419,55.419
16,0.950,Cow,23-5,1523,1710,0,3233,47.108,47.108
16,0.950,Deer Mouse,16-23,0,0,0,0,NaN,NaN
16,0.950,Deer Mouse,23-5,0,0,0,0,NaN,NaN
16,0.950,OVERALL,16-23,3665,2662,0,6327,57.926,57.926
16,0.950,OVERALL,23-5,4201,3387,0,7588,55.364,55.364
16,0.960,Chicken,16-23,0,0,0,0,NaN,NaN
16,0.960,Chicken,23-5,4,2,0,6,66.667,66.667
16,0.960,Sea Lion,16-23,0,0,0,0,NaN,NaN
16,0.960,Sea Lion,23-5,0,6,0,6,0.000,0.000
16,0.960,Hu and Cw,16-23,0,4,0,4,0.000,0.000
16,0.960,Hu and Cw,23-5,10,7,0,17,58.824,58.824
16,0.960,Sheep,16-23,44,48,0,92,47.826,47.826
16,0.960,Sheep,23-5,53,42,0,95,55.789,55.789
16,0.960,Hu and Dg,16-23,7,6,0,13,53.846,53.846
16,0.960,Hu and Dg,23-5,18,24,0,42,42.857,42.857
16,0.960,Common Loon,16-23,0,0,0,0,NaN,NaN
16,0.960,Common Loon,23-5,0,0,0,0,NaN,NaN
16,0.960,Red-Winged Blackbird,16-23,0,0,0,0,NaN,NaN
16,0.960,Red-Winged Blackbird,23-5,0,0,0,0,NaN,NaN
16,0.960,Cw,16-23,4,6,0,10,40.000,40.000
16,0.960,Cw,23-5,12,13,0,25,48.000,48.000
16,0.960,Cliff Sparrow,16-23,0,5,0,5,0.000,0.000
16,0.960,Cliff Sparrow,23-5,0,0,0,0,NaN,NaN
16,0.960,Pig,16-23,2,4,0,6,33.333,33.333
16,0.960,Pig,23-5,0,0,0,0,NaN,NaN
16,0.960,Barn Owl,16-23,0,0,0,0,NaN,NaN
16,0.960,Barn Owl,23-5,0,0,0,0,NaN,NaN
16,0.960,Wild Pig,16-23,0,0,0,0,NaN,NaN
16,0.960,Wild Pig,23-5,1,0,0,1,100.000,100.000
16,0.960,Pennington Creek Water,16-23,0,0,0,0,NaN,NaN
16,0.960,Pennington Creek Water,23-5,0,0,0,0,NaN,NaN
16,0.960,Guinni,16-23,0,0,0,0,NaN,NaN
16,0.960,Guinni,23-5,0,0,0,0,NaN,NaN
16,0.960,Racoon,16-23,0,0,0,0,NaN,NaN
16,0.960,Racoon,23-5,0,0,0,0,NaN,NaN
16,0.960,Hu,16-23,8,6,0,14,57.143,57.143
16,0.960,Hu,23-5,22,21,0,43,51.163,51.163
16,0.960,Cw and Dg,16-23,4,13,0,17,23.529,23.529
16,0.960,Cw and Dg,23-5,14,19,0,33,42.424,42.424
16,0.960,Red Wind Blackbird,16-23,0,0,0,0,NaN,NaN
16,0.960,Red Wind Blackbird,23-5,0,0,0,0,NaN,NaN
16,0.960,Tree Swallow,16-23,0,0,0,0,NaN,NaN
16,0.960,Tree Swallow,23-5,0,0,0,0,NaN,NaN
16,0.960,Turkey Vulture,16-23,0,0,0,0,NaN,NaN
16,0.960,Turkey Vulture,23-5,0,0,0,0,NaN,NaN
16,0.960,Dg,16-23,5,11,0,16,31.250,31.250
16,0.960,Dg,23-5,31,36,0,67,46.269,46.269
16,0.960,Western Kingbird,16-23,0,0,0,0,NaN,NaN
16,0.960,Western Kingbird,23-5,0,0,0,0,NaN,NaN
16,0.960,White Crowned Sparrow,16-23,0,0,0,0,NaN,NaN
16,0.960,White Crowned Sparrow,23-5,0,2,0,2,0.000,0.000
16,0.960,Eared Grebe,16-23,0,0,0,0,NaN,NaN
16,0.960,Eared Grebe,23-5,0,6,0,6,0.000,0.000
16,0.960,cougar,16-23,0,0,0,0,NaN,NaN
16,0.960,cougar,23-5,0,0,0,0,NaN,NaN
16,0.960,Ocean Water,16-23,0,0,0,0,NaN,NaN
16,0.960,Ocean Water,23-5,0,0,0,0,NaN,NaN
16,0.960,Red Tailed Hawk,16-23,0,0,0,0,NaN,NaN
16,0.960,Red Tailed Hawk,23-5,0,0,0,0,NaN,NaN
16,0.960,Dog,16-23,52,70,0,122,42.623,42.623
16,0.960,Dog,23-5,82,140,0,222,36.937,36.937
16,0.960,Human,16-23,1736,876,0,2612,66.462,66.462
16,0.960,Human,23-5,2127,778,0,2905,73.219,73.219
16,0.960,Wild Turkey,16-23,0,1,0,1,0.000,0.000
16,0.960,Wild Turkey,23-5,1,8,0,9,11.111,11.111
16,0.960,Clark Grebe,16-23,0,0,0,0,NaN,NaN
16,0.960,Clark Grebe,23-5,0,0,0,0,NaN,NaN
16,0.960,Seagull,16-23,0,0,0,0,NaN,NaN
16,0.960,Seagull,23-5,3,8,0,11,27.273,27.273
16,0.960,Surf Scoter,16-23,0,0,0,0,NaN,NaN
16,0.960,Surf Scoter,23-5,0,2,0,2,0.000,0.000
16,0.960,Pigeon,16-23,20,120,0,140,14.286,14.286
16,0.960,Pigeon,23-5,56,136,0,192,29.167,29.167
16,0.960,Pacific Ocean Water,16-23,0,0,0,0,NaN,NaN
16,0.960,Pacific Ocean Water,23-5,0,0,0,0,NaN,NaN
16,0.960,Cat,16-23,13,17,0,30,43.333,43.333
16,0.960,Cat,23-5,8,23,0,31,25.806,25.806
16,0.960,Horse,16-23,4,9,0,13,30.769,30.769
16,0.960,Horse,23-5,13,38,0,51,25.490,25.490
16,0.960,orangutan,16-23,0,0,0,0,NaN,NaN
16,0.960,orangutan,23-5,0,0,0,0,NaN,NaN
16,0.960,Bat,16-23,36,37,0,73,49.315,49.315
16,0.960,Bat,23-5,37,40,0,77,48.052,48.052
16,0.960,Deer,16-23,10,36,0,46,21.739,21.739
16,0.960,Deer,23-5,14,129,0,143,9.790,9.790
16,0.960,Great Horned Owl,16-23,0,0,0,0,NaN,NaN
16,0.960,Great Horned Owl,23-5,0,0,0,0,NaN,NaN
16,0.960,Freshwater Lagoon,16-23,0,0,0,0,NaN,NaN
16,0.960,Freshwater Lagoon,23-5,0,0,0,0,NaN,NaN
16,0.960,Unknown Avian,16-23,0,0,0,0,NaN,NaN
16,0.960,Unknown Avian,23-5,0,0,0,0,NaN,NaN
16,0.960,Human UTI,16-23,68,73,0,141,48.227,48.227
16,0.960,Human UTI,23-5,93,124,0,217,42.857,42.857
16,0.960,unknown,16-23,0,0,0,0,NaN,NaN
16,0.960,unknown,23-5,0,2,0,2,0.000,0.000
16,0.960,SLO Creek Water,16-23,0,0,0,0,NaN,NaN
16,0.960,SLO Creek Water,23-5,0,0,0,0,NaN,NaN
16,0.960,Pig/Swine,16-23,2,2,0,4,50.000,50.000
16,0.960,Pig/Swine,23-5,7,8,0,15,46.667,46.667
16,0.960,Klebsiella,16-23,0,0,0,0,NaN,NaN
16,0.960,Klebsiella,23-5,0,0,0,0,NaN,NaN
16,0.960,Hu Cw and Dg,16-23,3,7,0,10,30.000,30.000
16,0.960,Hu Cw and Dg,23-5,3,5,0,8,37.500,37.500
16,0.960,Ground Squirrel,16-23,73,44,0,117,62.393,62.393
16,0.960,Ground Squirrel,23-5,76,64,0,140,54.286,54.286
16,0.960,Opossum,16-23,0,0,0,0,NaN,NaN
16,0.960,Opossum,23-5,0,0,0,0,NaN,NaN
16,0.960,Cow,16-23,1573,1257,0,2830,55.583,55.583
16,0.960,Cow,23-5,1523,1686,0,3209,47.460,47.460
16,0.960,Deer Mouse,16-23,0,0,0,0,NaN,NaN
16,0.960,Deer Mouse,23-5,0,0,0,0,NaN,NaN
16,0.960,OVERALL,16-23,3664,2652,0,6316,58.011,58.011
16,0.960,OVERALL,23-5,4208,3369,0,7577,55.536,55.536
16,0.970,Chicken,16-23,0,0,0,0,NaN,NaN
16,0.970,Chicken,23-5,4,2,0,6,66.667,66.667
16,0.970,Sea Lion,16-23,0,0,0,0,NaN,NaN
16,0.970,Sea Lion,23-5,0,8,0,8,0.000,0.000
16,0.970,Hu and Cw,16-23,0,4,0,4,0.000,0.000
16,0.970,Hu and Cw,23-5,10,7,0,17,58.824,58.824
16,0.970,Sheep,16-23,45,49,0,94,47.872,47.872
16,0.970,Sheep,23-5,53,41,0,94,56.383,56.383
16,0.970,Hu and Dg,16-23,7,6,0,13,53.846,53.846
16,0.970,Hu and Dg,23-5,18,24,0,42,42.857,42.857
16,0.970,Common Loon,16-23,0,0,0,0,NaN,NaN
16,0.970,Common Loon,23-5,0,0,0,0,NaN,NaN
16,0.970,Red-Winged Blackbird,16-23,0,0,0,0,NaN,NaN
16,0.970,Red-Winged Blackbird,23-5,0,0,0,0,NaN,NaN
16,0.970,Cw,16-23,4,7,0,11,36.364,36.364
16,0.970,Cw,23-5,12,13,0,25,48.000,48.000
16,0.970,Cliff Sparrow,16-23,0,5,0,5,0.000,0.000
16,0.970,Cliff Sparrow,23-5,0,0,0,0,NaN,NaN
16,0.970,Pig,16-23,2,4,0,6,33.333,33.333
16,0.970,Pig,23-5,0,0,0,0,NaN,NaN
16,0.970,Barn Owl,16-23,0,0,0,0,NaN,NaN
16,0.970,Barn Owl,23-5,0,0,0,0,NaN,NaN
16,0.970,Wild Pig,16-23,0,0,0,0,NaN,NaN
16,0.970,Wild Pig,23-5,0,0,0,0,NaN,NaN
16,0.970,Pennington Creek Water,16-23,0,0,0,0,NaN,NaN
16,0.970,Pennington Creek Water,23-5,0,0,0,0,NaN,NaN
16,0.970,Guinni,16-23,0,0,0,0,NaN,NaN
16,0.970,Guinni,23-5,0,0,0,0,NaN,NaN
16,0.970,Racoon,16-23,0,0,0,0,NaN,NaN
16,0.970,Racoon,23-5,0,0,0,0,NaN,NaN
16,0.970,Hu,16-23,8,6,0,14,57.143,57.143
16,0.970,Hu,23-5,22,21,0,43,51.163,51.163
16,0.970,Cw and Dg,16-23,4,13,0,17,23.529,23.529
16,0.970,Cw and Dg,23-5,14,19,0,33,42.424,42.424
16,0.970,Red Wind Blackbird,16-23,0,0,0,0,NaN,NaN
16,0.970,Red Wind Blackbird,23-5,0,0,0,0,NaN,NaN
16,0.970,Tree Swallow,16-23,0,0,0,0,NaN,NaN
16,0.970,Tree Swallow,23-5,0,0,0,0,NaN,NaN
16,0.970,Turkey Vulture,16-23,0,0,0,0,NaN,NaN
16,0.970,Turkey Vulture,23-5,0,0,0,0,NaN,NaN
16,0.970,Dg,16-23,5,11,0,16,31.250,31.250
16,0.970,Dg,23-5,31,34,0,65,47.692,47.692
16,0.970,Western Kingbird,16-23,0,0,0,0,NaN,NaN
16,0.970,Western Kingbird,23-5,0,0,0,0,NaN,NaN
16,0.970,White Crowned Sparrow,16-23,0,0,0,0,NaN,NaN
16,0.970,White Crowned Sparrow,23-5,0,2,0,2,0.000,0.000
16,0.970,Eared Grebe,16-23,0,0,0,0,NaN,NaN
16,0.970,Eared Grebe,23-5,0,6,0,6,0.000,0.000
16,0.970,cougar,16-23,0,0,0,0,NaN,NaN
16,0.970,cougar,23-5,0,0,0,0,NaN,NaN
16,0.970,Ocean Water,16-23,0,0,0,0,NaN,NaN
16,0.970,Ocean Water,23-5,0,0,0,0,NaN,NaN
16,0.970,Red Tailed Hawk,16-23,0,0,0,0,NaN,NaN
16,0.970,Red Tailed Hawk,23-5,0,0,0,0,NaN,NaN
16,0.970,Dog,16-23,52,70,0,122,42.623,42.623
16,0.970,Dog,23-5,84,139,0,223,37.668,37.668
16,0.970,Human,16-23,1735,873,0,2608,66.526,66.526
16,0.970,Human,23-5,2127,773,0,2900,73.345,73.345
16,0.970,Wild Turkey,16-23,0,3,0,3,0.000,0.000
16,0.970,Wild Turkey,23-5,3,7,0,10,30.000,30.000
16,0.970,Clark Grebe,16-23,0,0,0,0,NaN,NaN
16,0.970,Clark Grebe,23-5,0,0,0,0,NaN,NaN
16,0.970,Seagull,16-23,0,0,0,0,NaN,NaN
16,0.970,Seagull,23-5,3,9,0,12,25.000,25.000
16,0.970,Surf Scoter,16-23,0,0,0,0,NaN,NaN
16,0.970,Surf Scoter,23-5,0,2,0,2,0.000,0.000
16,0.970,Pigeon,16-23,19,119,0,138,13.768,13.768
16,0.970,Pigeon,23-5,56,152,0,208,26.923,26.923
16,0.970,Pacific Ocean Water,16-23,0,0,0,0,NaN,NaN
16,0.970,Pacific Ocean Water,23-5,0,0,0,0,NaN,NaN
16,0.970,Cat,16-23,13,17,0,30,43.333,43.333
16,0.970,Cat,23-5,8,20,0,28,28.571,28.571
16,0.970,Horse,16-23,4,9,0,13,30.769,30.769
16,0.970,Horse,23-5,13,39,0,52,25.000,25.000
16,0.970,orangutan,16-23,0,0,0,0,NaN,NaN
16,0.970,orangutan,23-5,0,0,0,0,NaN,NaN
16,0.970,Bat,16-23,36,37,0,73,49.315,49.315
16,0.970,Bat,23-5,37,40,0,77,48.052,48.052
16,0.970,Deer,16-23,10,36,0,46,21.739,21.739
16,0.970,Deer,23-5,14,129,0,143,9.790,9.790
16,0.970,Great Horned Owl,16-23,0,0,0,0,NaN,NaN
16,0.970,Great Horned Owl,23-5,0,0,0,0,NaN,NaN
16,0.970,Freshwater Lagoon,16-23,0,0,0,0,NaN,NaN
16,0.970,Freshwater Lagoon,23-5,0,0,0,0,NaN,NaN
16,0.970,Unknown Avian,16-23,0,0,0,0,NaN,NaN
16,0.970,Unknown Avian,23-5,0,0,0,0,NaN,NaN
16,0.970,Human UTI,16-23,68,74,0,142,47.887,47.887
16,0.970,Human UTI,23-5,92,124,0,216,42.593,42.593
16,0.970,unknown,16-23,0,0,0,0,NaN,NaN
16,0.970,unknown,23-5,0,2,0,2,0.000,0.000
16,0.970,SLO Creek Water,16-23,0,0,0,0,NaN,NaN
16,0.970,SLO Creek Water,23-5,0,0,0,0,NaN,NaN
16,0.970,Pig/Swine,16-23,2,2,0,4,50.000,50.000
16,0.970,Pig/Swine,23-5,7,8,0,15,46.667,46.667
16,0.970,Klebsiella,16-23,0,0,0,0,NaN,NaN
16,0.970,Klebsiella,23-5,0,0,0,0,NaN,NaN
16,0.970,Hu Cw and Dg,16-23,3,7,0,10,30.000,30.000
16,0.970,Hu Cw and Dg,23-5,3,5,0,8,37.500,37.500
16,0.970,Ground Squirrel,16-23,73,43,0,116,62.931,62.931
16,0.970,Ground Squirrel,23-5,76,62,0,138,55.072,55.072
16,0.970,Opossum,16-23,0,0,0,0,NaN,NaN
16,0.970,Opossum,23-5,0,0,0,0,NaN,NaN
16,0.970,Cow,16-23,1567,1254,0,2821,55.548,55.548
16,0.970,Cow,23-5,1521,1660,0,3181,47.815,47.815
16,0.970,Deer Mouse,16-23,0,0,0,0,NaN,NaN
16,0.970,Deer Mouse,23-5,0,0,0,0,NaN,NaN
16,0.970,OVERALL,16-23,3657,2649,0,6306,57.992,57.992
16,0.970,OVERALL,23-5,4208,3348,0,7556,55.691,55.691
16,0.980,Chicken,16-23,0,0,0,0,NaN,NaN
16,0.980,Chicken,23-5,5,2,0,7,71.429,71.429
16,0.980,Sea Lion,16-23,0,0,0,0,NaN,NaN
16,0.980,Sea Lion,23-5,0,9,0,9,0.000,0.000
16,0.980,Hu and Cw,16-23,0,4,0,4,0.000,0.000
16,0.980,Hu and Cw,23-5,10,17,0,27,37.037,37.037
16,0.980,Sheep,16-23,48,46,0,94,51.064,51.064
16,0.980,Sheep,23-5,52,40,0,92,56.522,56.522
16,0.980,Hu and Dg,16-23,7,6,0,13,53.846,53.846
16,0.980,Hu and Dg,23-5,18,22,0,40,45.000,45.000
16,0.980,Common Loon,16-23,0,0,0,0,NaN,NaN
16,0.980,Common Loon,23-5,0,0,0,0,NaN,NaN
16,0.980,Red-Winged Blackbird,16-23,0,0,0,0,NaN,NaN
16,0.980,Red-Winged Blackbird,23-5,0,0,0,0,NaN,NaN
16,0.980,Cw,16-23,4,6,0,10,40.000,40.000
16,0.980,Cw,23-5,12,15,0,27,44.444,44.444
16,0.980,Cliff Sparrow,16-23,0,5,0,5,0.000,0.000
16,0.980,Cliff Sparrow,23-5,0,0,0,0,NaN,NaN
16,0.980,Pig,16-23,2,4,0,6,33.333,33.333
16,0.980,Pig,23-5,0,0,0,0,NaN,NaN
16,0.980,Barn Owl,16-23,0,0,0,0,NaN,NaN
16,0.980,Barn Owl,23-5,0,0,0,0,NaN,NaN
16,0.980,Wild Pig,16-23,0,0,0,0,NaN,NaN
16,0.980,Wild Pig,23-5,0,0,0,0,NaN,NaN
16,0.980,Pennington Creek Water,16-23,0,0,0,0,NaN,NaN
16,0.980,Pennington Creek Water,23-5,0,0,0,0,NaN,NaN
16,0.980,Guinni,16-23,0,0,0,0,NaN,NaN
16,0.980,Guinni,23-5,0,0,0,0,NaN,NaN
16,0.980,Racoon,16-23,0,0,0,0,NaN,NaN
16,0.980,Racoon,23-5,0,0,0,0,NaN,NaN
16,0.980,Hu,16-23,8,6,0,14,57.143,57.143
16,0.980,Hu,23-5,22,22,0,44,50.000,50.000
16,0.980,Cw and Dg,16-23,4,13,0,17,23.529,23.529
16,0.980,Cw and Dg,23-5,14,21,0,35,40.000,40.000
16,0.980,Red Wind Blackbird,16-23,0,0,0,0,NaN,NaN
16,0.980,Red Wind Blackbird,23-5,0,0,0,0,NaN,NaN
16,0.980,Tree Swallow,16-23,0,0,0,0,NaN,NaN
16,0.980,Tree Swallow,23-5,0,0,0,0,NaN,NaN
16,0.980,Turkey Vulture,16-23,0,0,0,0,NaN,NaN
16,0.980,Turkey Vulture,23-5,0,0,0,0,NaN,NaN
16,0.980,Dg,16-23,5,11,0,16,31.250,31.250
16,0.980,Dg,23-5,31,26,0,57,54.386,54.386
16,0.980,Western Kingbird,16-23,0,0,0,0,NaN,NaN
16,0.980,Western Kingbird,23-5,0,0,0,0,NaN,NaN
16,0.980,White Crowned Sparrow,16-23,0,0,0,0,NaN,NaN
16,0.980,White Crowned Sparrow,23-5,0,4,0,4,0.000,0.000
16,0.980,Eared Grebe,16-23,0,0,0,0,NaN,NaN
16,0.980,Eared Grebe,23-5,0,6,0,6,0.000,0.000
16,0.980,cougar,16-23,0,0,0,0,NaN,NaN
16,0.980,cougar,23-5,0,0,0,0,NaN,NaN
16,0.980,Ocean Water,16-23,0,0,0,0,NaN,NaN
16,0.980,Ocean Water,23-5,0,0,0,0,NaN,NaN
16,0.980,Red Tailed Hawk,16-23,0,0,0,0,NaN,NaN
16,0.980,Red Tailed Hawk,23-5,0,0,0,0,NaN,NaN
16,0.980,Dog,16-23,51,75,0,126,40.476,40.476
16,0.980,Dog,23-5,83,132,0,215,38.605,38.605
16,0.980,Human,16-23,1735,857,0,2592,66.937,66.937
16,0.980,Human,23-5,2127,757,0,2884,73.752,73.752
16,0.980,Wild Turkey,16-23,1,3,0,4,25.000,25.000
16,0.980,Wild Turkey,23-5,5,17,0,22,22.727,22.727
16,0.980,Clark Grebe,16-23,0,0,0,0,NaN,NaN
16,0.980,Clark Grebe,23-5,0,0,0,0,NaN,NaN
16,0.980,Seagull,16-23,0,0,0,0,NaN,NaN
16,0.980,Seagull,23-5,5,7,0,12,41.667,41.667
16,0.980,Surf Scoter,16-23,0,0,0,0,NaN,NaN
16,0.980,Surf Scoter,23-5,2,0,0,2,100.000,100.000
16,0.980,Pigeon,16-23,20,120,0,140,14.286,14.286
16,0.980,Pigeon,23-5,55,162,0,217,25.346,25.346
16,0.980,Pacific Ocean Water,16-23,0,0,0,0,NaN,NaN
16,0.980,Pacific Ocean Water,23-5,0,0,0,0,NaN,NaN
16,0.980,Cat,16-23,13,17,0,30,43.333,43.333
16,0.980,Cat,23-5,9,15,0,24,37.500,37.500
16,0.980,Horse,16-23,4,9,0,13,30.769,30.769
16,0.980,Horse,23-5,13,37,0,50,26.000,26.000
16,0.980,orangutan,16-23,0,0,0,0,NaN,NaN
16,0.980,orangutan,23-5,0,0,0,0,NaN,NaN
16,0.980,Bat,16-23,36,36,0,72,50.000,50.000
16,0.980,Bat,23-5,37,40,0,77,48.052,48.052
16,0.980,Deer,16-23,10,36,0,46,21.739,21.739
16,0.980,Deer,23-5,14,129,0,143,9.790,9.790
16,0.980,Great Horned Owl,16-23,0,0,0,0,NaN,NaN
16,0.980,Great Horned Owl,23-5,0,0,0,0,NaN,NaN
16,0.980,Freshwater Lagoon,16-23,0,0,0,0,NaN,NaN
16,0.980,Freshwater Lagoon,23-5,0,0,0,0,NaN,NaN
16,0.980,Unknown Avian,16-23,0,0,0,0,NaN,NaN
16,0.980,Unknown Avian,23-5,0,0,0,0,NaN,NaN
16,0.980,Human UTI,16-23,69,76,0,145,47.586,47.586
16,0.980,Human UTI,23-5,93,123,0,216,43.056,43.056
16,0.980,unknown,16-23,0,0,0,0,NaN,NaN
16,0.980,unknown,23-5,0,3,0,3,0.000,0.000
16,0.980,SLO Creek Water,16-23,0,0,0,0,NaN,NaN
16,0.980,SLO Creek Water,23-5,0,0,0,0,NaN,NaN
16,0.980,Pig/Swine,16-23,2,2,0,4,50.000,50.000
16,0.980,Pig/Swine,23-5,7,8,0,15,46.667,46.667
16,0.980,Klebsiella,16-23,0,0,0,0,NaN,NaN
16,0.980,Klebsiella,23-5,0,0,0,0,NaN,NaN
16,0.980,Hu Cw and Dg,16-23,3,7,0,10,30.000,30.000
16,0.980,Hu Cw and Dg,23-5,3,4,0,7,42.857,42.857
16,0.980,Ground Squirrel,16-23,76,44,0,120,63.333,63.333
16,0.980,Ground Squirrel,23-5,77,61,0,138,55.797,55.797
16,0.980,Opossum,16-23,0,0,0,0,NaN,NaN
16,0.980,Opossum,23-5,0,0,0,0,NaN,NaN
16,0.980,Cow,16-23,1559,1236,0,2795,55.778,55.778
16,0.980,Cow,23-5,1514,1624,0,3138,48.247,48.247
16,0.980,Deer Mouse,16-23,0,0,0,0,NaN,NaN
16,0.980,Deer Mouse,23-5,0,0,0,0,NaN,NaN
16,0.980,OVERALL,16-23,3657,2619,0,6276,58.270,58.270
16,0.980,OVERALL,23-5,4208,3303,0,7511,56.024,56.024
16,0.990,Chicken,16-23,2,6,0,8,25.000,25.000
16,0.990,Chicken,23-5,6,2,0,8,75.000,75.000
16,0.990,Sea Lion,16-23,0,0,0,0,NaN,NaN
16,0.990,Sea Lion,23-5,2,7,0,9,22.222,22.222
16,0.990,Hu and Cw,16-23,1,4,0,5,20.000,20.000
16,0.990,Hu and Cw,23-5,11,24,0,35,31.429,31.429
16,0.990,Sheep,16-23,47,47,0,94,50.000,50.000
16,0.990,Sheep,23-5,53,40,0,93,56.989,56.989
16,0.990,Hu and Dg,16-23,7,8,0,15,46.667,46.667
16,0.990,Hu and Dg,23-5,18,20,0,38,47.368,47.368
16,0.990,Common Loon,16-23,0,0,0,0,NaN,NaN
16,0.990,Common Loon,23-5,0,2,0,2,0.000,0.000
16,0.990,Red-Winged Blackbird,16-23,0,2,0,2,0.000,0.000
16,0.990,Red-Winged Blackbird,23-5,0,0,0,0,NaN,NaN
16,0.990,Cw,16-23,5,6,0,11,45.455,45.455
16,0.990,Cw,23-5,18,18,0,36,50.000,50.000
16,0.990,Cliff Sparrow,16-23,0,7,0,7,0.000,0.000
16,0.990,Cliff Sparrow,23-5,0,4,0,4,0.000,0.000
16,0.990,Pig,16-23,2,5,0,7,28.571,28.571
16,0.990,Pig,23-5,7,8,0,15,46.667,46.667
16,0.990,Barn Owl,16-23,0,0,0,0,NaN,NaN
16,0.990,Barn Owl,23-5,0,0,0,0,NaN,NaN
16,0.990,Wild Pig,16-23,0,2,0,2,0.000,0.000
16,0.990,Wild Pig,23-5,0,1,0,1,0.000,0.000
16,0.990,Pennington Creek Water,16-23,0,0,0,0,NaN,NaN
16,0.990,Pennington Creek Water,23-5,0,0,0,0,NaN,NaN
16,0.990,Guinni,16-23,0,0,0,0,NaN,NaN
16,0.990,Guinni,23-5,0,0,0,0,NaN,NaN
16,0.990,Racoon,16-23,0,0,0,0,NaN,NaN
16,0.990,Racoon,23-5,0,1,0,1,0.000,0.000
16,0.990,Hu,16-23,8,6,0,14,57.143,57.143
16,0.990,Hu,23-5,22,16,0,38,57.895,57.895
16,0.990,Cw and Dg,16-23,4,13,0,17,23.529,23.529
16,0.990,Cw and Dg,23-5,15,14,0,29,51.724,51.724
16,0.990,Red Wind Blackbird,16-23,0,0,0,0,NaN,NaN
16,0.990,Red Wind Blackbird,23-5,0,0,0,0,NaN,NaN
16,0.990,Tree Swallow,16-23,0,0,0,0,NaN,NaN
16,0.990,Tree Swallow,23-5,0,0,0,0,NaN,NaN
16,0.990,Turkey Vulture,16-23,0,0,0,0,NaN,NaN
16,0.990,Turkey Vulture,23-5,0,0,0,0,NaN,NaN
16,0.990,Dg,16-23,5,11,0,16,31.250,31.250
16,0.990,Dg,23-5,31,20,0,51,60.784,60.784
16,0.990,Western Kingbird,16-23,0,0,0,0,NaN,NaN
16,0.990,Western Kingbird,23-5,0,0,0,0,NaN,NaN
16,0.990,White Crowned Sparrow,16-23,0,0,0,0,NaN,NaN
16,0.990,White Crowned Sparrow,23-5,0,5,0,5,0.000,0.000
16,0.990,Eared Grebe,16-23,0,0,0,0,NaN,NaN
16,0.990,Eared Grebe,23-5,0,8,0,8,0.000,0.000
16,0.990,cougar,16-23,0,1,0,1,0.000,0.000
16,0.990,cougar,23-5,0,0,0,0,NaN,NaN
16,0.990,Ocean Water,16-23,0,0,0,0,NaN,NaN
16,0.990,Ocean Water,23-5,0,0,0,0,NaN,NaN
16,0.990,Red Tailed Hawk,16-23,0,0,0,0,NaN,NaN
16,0.990,Red Tailed Hawk,23-5,0,1,0,1,0.000,0.000
16,0.990,Dog,16-23,54,72,0,126,42.857,42.857
16,0.990,Dog,23-5,86,130,0,216,39.815,39.815
16,0.990,Human,16-23,1713,817,0,2530,67.708,67.708
16,0.990,Human,23-5,2112,686,0,2798,75.482,75.482
16,0.990,Wild Turkey,16-23,3,9,0,12,25.000,25.000
16,0.990,Wild Turkey,23-5,5,18,0,23,21.739,21.739
16,0.990,Clark Grebe,16-23,0,0,0,0,NaN,NaN
16,0.990,Clark Grebe,23-5,2,3,0,5,40.000,40.000
16,0.990,Seagull,16-23,0,0,0,0,NaN,NaN
16,0.990,Seagull,23-5,11,6,0,17,64.706,64.706
16,0.990,Surf Scoter,16-23,0,0,0,0,NaN,NaN
16,0.990,Surf Scoter,23-5,2,0,0,2,100.000,100.000
16,0.990,Pigeon,16-23,31,120,0,151,20.530,20.530
16,0.990,Pigeon,23-5,65,184,0,249,26.104,26.104
16,0.990,Pacific Ocean Water,16-23,0,0,0,0,NaN,NaN
16,0.990,Pacific Ocean Water,23-5,0,0,0,0,NaN,NaN
16,0.990,Cat,16-23,17,20,0,37,45.946,45.946
16,0.990,Cat,23-5,9,20,0,29,31.034,31.034
16,0.990,Horse,16-23,7,10,0,17,41.176,41.176
16,0.990,Horse,23-5,15,58,0,73,20.548,20.548
16,0.990,orangutan,16-23,0,0,0,0,NaN,NaN
16,0.990,orangutan,23-5,0,0,0,0,NaN,NaN
16,0.990,Bat,16-23,36,33,0,69,52.174,52.174
16,0.990,Bat,23-5,37,38,0,75,49.333,49.333
16,0.990,Deer,16-23,10,37,0,47,21.277,21.277
16,0.990,Deer,23-5,14,116,0,130,10.769,10.769
16,0.990,Great Horned Owl,16-23,0,0,0,0,NaN,NaN
16,0.990,Great Horned Owl,23-5,0,0,0,0,NaN,NaN
16,0.990,Freshwater Lagoon,16-23,0,0,0,0,NaN,NaN
16,0.990,Freshwater Lagoon,23-5,0,0,0,0,NaN,NaN
16,0.990,Unknown Avian,16-23,0,0,0,0,NaN,NaN
16,0.990,Unknown Avian,23-5,0,0,0,0,NaN,NaN
16,0.990,Human UTI,16-23,72,68,0,140,51.429,51.429
16,0.990,Human UTI,23-5,95,98,0,193,49.223,49.223
16,0.990,unknown,16-23,0,0,0,0,NaN,NaN
16,0.990,unknown,23-5,0,5,0,5,0.000,0.000
16,0.990,SLO Creek Water,16-23,0,0,0,0,NaN,NaN
16,0.990,SLO Creek Water,23-5,0,0,0,0,NaN,NaN
16,0.990,Pig/Swine,16-23,2,3,0,5,40.000,40.000
16,0.990,Pig/Swine,23-5,7,8,0,15,46.667,46.667
16,0.990,Klebsiella,16-23,0,0,0,0,NaN,NaN
16,0.990,Klebsiella,23-5,0,0,0,0,NaN,NaN
16,0.990,Hu Cw and Dg,16-23,3,7,0,10,30.000,30.000
16,0.990,Hu Cw and Dg,23-5,3,6,0,9,33.333,33.333
16,0.990,Ground Squirrel,16-23,79,45,0,124,63.710,63.710
16,0.990,Ground Squirrel,23-5,79,67,0,146,54.110,54.110
16,0.990,Opossum,16-23,1,0,0,1,100.000,100.000
16,0.990,Opossum,23-5,2,0,0,2,100.000,100.000
16,0.990,Cow,16-23,1525,1121,0,2646,57.634,57.634
16,0.990,Cow,23-5,1474,1470,0,2944,50.068,50.068
16,0.990,Deer Mouse,16-23,0,0,0,0,NaN,NaN
16,0.990,Deer Mouse,23-5,0,0,0,0,NaN,NaN
16,0.990,OVERALL,16-23,3634,2480,0,6114,59.437,59.437
16,0.990,OVERALL,23-5,4201,3104,0,7305,57.509,57.509
16,1.000,Chicken,16-23,0,0,0,0,NaN,NaN
16,1.000,Chicken,23-5,0,0,0,0,NaN,NaN
16,1.000,Sea Lion,16-23,0,0,0,0,NaN,NaN
16,1.000,Sea Lion,23-5,0,0,0,0,NaN,NaN
16,1.000,Hu and Cw,16-23,0,0,0,0,NaN,NaN
16,1.000,Hu and Cw,23-5,0,0,0,0,NaN,NaN
16,1.000,Sheep,16-23,0,0,0,0,NaN,NaN
16,1.000,Sheep,23-5,0,0,0,0,NaN,NaN
16,1.000,Hu and Dg,16-23,0,0,0,0,NaN,NaN
16,1.000,Hu and Dg,23-5,0,0,0,0,NaN,NaN
16,1.000,Common Loon,16-23,0,0,0,0,NaN,NaN
16,1.000,Common Loon,23-5,0,0,0,0,NaN,NaN
16,1.000,Red-Winged Blackbird,16-23,0,0,0,0,NaN,NaN
16,1.000,Red-Winged Blackbird,23-5,0,0,0,0,NaN,NaN
16,1.000,Cw,16-23,0,0,0,0,NaN,NaN
16,1.000,Cw,23-5,0,0,0,0,NaN,NaN
16,1.000,Cliff Sparrow,16-23,0,0,0,0,NaN,NaN
16,1.000,Cliff Sparrow,23-5,0,0,0,0,NaN,NaN
16,1.000,Pig,16-23,0,0,0,0,NaN,NaN
16,1.000,Pig,23-5,0,0,0,0,NaN,NaN
16,1.000,Barn Owl,16-23,0,0,0,0,NaN,NaN
16,1.000,Barn Owl,23-5,0,0,0,0,NaN,NaN
16,1.000,Wild Pig,16-23,0,0,0,0,NaN,NaN
16,1.000,Wild Pig,23-5,0,0,0,0,NaN,NaN
16,1.000,Pennington Creek Water,16-23,0,0,0,0,NaN,NaN
16,1.000,Pennington Creek Water,23-5,0,0,0,0,NaN,NaN
16,1.000,Guinni,16-23,0,0,0,0,NaN,NaN
16,1.000,Guinni,23-5,0,0,0,0,NaN,NaN
16,1.000,Racoon,16-23,0,0,0,0,NaN,NaN
16,1.000,Racoon,23-5,0,0,0,0,NaN,NaN
16,1.000,Hu,16-23,0,0,0,0,NaN,NaN
16,1.000,Hu,23-5,0,0,0,0,NaN,NaN
16,1.000,Cw and Dg,16-23,0,0,0,0,NaN,NaN
16,1.000,Cw and Dg,23-5,0,0,0,0,NaN,NaN
16,1.000,Red Wind Blackbird,16-23,0,0,0,0,NaN,NaN
16,1.000,Red Wind Blackbird,23-5,0,0,0,0,NaN,NaN
16,1.000,Tree Swallow,16-23,0,0,0,0,NaN,NaN
16,1.000,Tree Swallow,23-5,0,0,0,0,NaN,NaN
16,1.000,Turkey Vulture,16-23,0,0,0,0,NaN,NaN
16,1.000,Turkey Vulture,23-5,0,0,0,0,NaN,NaN
16,1.000,Dg,16-23,0,0,0,0,NaN,NaN
16,1.000,Dg,23-5,0,0,0,0,NaN,NaN
16,1.000,Western Kingbird,16-23,0,0,0,0,NaN,NaN
16,1.000,Western Kingbird,23-5,0,0,0,0,NaN,NaN
16,1.000,White Crowned Sparrow,16-23,0,0,0,0,NaN,NaN
16,1.000,White Crowned Sparrow,23-5,0,0,0,0,NaN,NaN
16,1.000,Eared Grebe,16-23,0,0,0,0,NaN,NaN
16,1.000,Eared Grebe,23-5,0,0,0,0,NaN,NaN
16,1.000,cougar,16-23,0,0,0,0,NaN,NaN
16,1.000,cougar,23-5,0,0,0,0,NaN,NaN
16,1.000,Ocean Water,16-23,0,0,0,0,NaN,NaN
16,1.000,Ocean Water,23-5,0,0,0,0,NaN,NaN
16,1.000,Red Tailed Hawk,16-23,0,0,0,0,NaN,NaN
16,1.000,Red Tailed Hawk,23-5,0,0,0,0,NaN,NaN
16,1.000,Dog,16-23,0,0,0,0,NaN,NaN
16,1.000,Dog,23-5,0,0,0,0,NaN,NaN
16,1.000,Human,16-23,0,0,0,0,NaN,NaN
16,1.000,Human,23-5,0,0,0,0,NaN,NaN
16,1.000,Wild Turkey,16-23,0,0,0,0,NaN,NaN
16,1.000,Wild Turkey,23-5,0,0,0,0,NaN,NaN
16,1.000,Clark Grebe,16-23,0,0,0,0,NaN,NaN
16,1.000,Clark Grebe,23-5,0,0,0,0,NaN,NaN
16,1.000,Seagull,16-23,0,0,0,0,NaN,NaN
16,1.000,Seagull,23-5,0,0,0,0,NaN,NaN
16,1.000,Surf Scoter,16-23,0,0,0,0,NaN,NaN
16,1.000,Surf Scoter,23-5,0,0,0,0,NaN,NaN
16,1.000,Pigeon,16-23,0,0,0,0,NaN,NaN
16,1.000,Pigeon,23-5,0,0,0,0,NaN,NaN
16,1.000,Pacific Ocean Water,16-23,0,0,0,0,NaN,NaN
16,1.000,Pacific Ocean Water,23-5,0,0,0,0,NaN,NaN
16,1.000,Cat,16-23,0,0,0,0,NaN,NaN
16,1.000,Cat,23-5,0,0,0,0,NaN,NaN
16,1.000,Horse,16-23,0,0,0,0,NaN,NaN
16,1.000,Horse,23-5,0,0,0,0,NaN,NaN
16,1.000,orangutan,16-23,0,0,0,0,NaN,NaN
16,1.000,orangutan,23-5,0,0,0,0,NaN,NaN
16,1.000,Bat,16-23,0,0,0,0,NaN,NaN
16,1.000,Bat,23-5,0,0,0,0,NaN,NaN
16,1.000,Deer,16-23,0,0,0,0,NaN,NaN
16,1.000,Deer,23-5,0,0,0,0,NaN,NaN
16,1.000,Great Horned Owl,16-23,0,0,0,0,NaN,NaN
16,1.000,Great Horned Owl,23-5,0,0,0,0,NaN,NaN
16,1.000,Freshwater Lagoon,16-23,0,0,0,0,NaN,NaN
16,1.000,Freshwater Lagoon,23-5,0,0,0,0,NaN,NaN
16,1.000,Unknown Avian,16-23,0,0,0,0,NaN,NaN
16,1.000,Unknown Avian,23-5,0,0,0,0,NaN,NaN
16,1.000,Human UTI,16-23,0,0,0,0,NaN,NaN
16,1.000,Human UTI,23-5,0,0,0,0,NaN,NaN
16,1.000,unknown,16-23,0,0,0,0,NaN,NaN
16,1.000,unknown,23-5,0,0,0,0,NaN,NaN
16,1.000,SLO Creek Water,16-23,0,0,0,0,NaN,NaN
16,1.000,SLO Creek Water,23-5,0,0,0,0,NaN,NaN
16,1.000,Pig/Swine,16-23,0,0,0,0,NaN,NaN
16,1.000,Pig/Swine,23-5,0,0,0,0,NaN,NaN
16,1.000,Klebsiella,16-23,0,0,0,0,NaN,NaN
16,1.000,Klebsiella,23-5,0,0,0,0,NaN,NaN
16,1.000,Hu Cw and Dg,16-23,0,0,0,0,NaN,NaN
16,1.000,Hu Cw and Dg,23-5,0,0,0,0,NaN,NaN
16,1.000,Ground Squirrel,16-23,0,0,0,0,NaN,NaN
16,1.000,Ground Squirrel,23-5,0,0,0,0,NaN,NaN
16,1.000,Opossum,16-23,0,0,0,0,NaN,NaN
16,1.000,Opossum,23-5,0,0,0,0,NaN,NaN
16,1.000,Cow,16-23,0,0,0,0,NaN,NaN
16,1.000,Cow,23-5,0,0,0,0,NaN,NaN
16,1.000,Deer Mouse,16-23,0,0,0,0,NaN,NaN
16,1.000,Deer Mouse,23-5,0,0,0,0,NaN,NaN
16,1.000,OVERALL,16-23,0,0,0,0,NaN,NaN
16,1.000,OVERALL,23-5,0,0,0,0,NaN,NaN
17,0.000,Chicken,16-23,0,0,0,0,NaN,NaN
17,0.000,Chicken,23-5,4,2,0,6,66.667,66.667
17,0.000,Sea Lion,16-23,0,0,0,0,NaN,NaN
17,0.000,Sea Lion,23-5,0,4,0,4,0.000,0.000
17,0.000,Hu and Cw,16-23,0,3,0,3,0.000,0.000
17,0.000,Hu and Cw,23-5,10,7,0,17,58.824,58.824
17,0.000,Sheep,16-23,44,47,0,91,48.352,48.352
17,0.000,Sheep,23-5,52,41,0,93,55.914,55.914
17,0.000,Hu and Dg,16-23,7,5,0,12,58.333,58.333
17,0.000,Hu and Dg,23-5,16,23,0,39,41.026,41.026
17,0.000,Common Loon,16-23,0,0,0,0,NaN,NaN
17,0.000,Common Loon,23-5,0,0,0,0,NaN,NaN
17,0.000,Red-Winged Blackbird,16-23,0,0,0,0,NaN,NaN
17,0.000,Red-Winged Blackbird,23-5,0,0,0,0,NaN,NaN
17,0.000,Cw,16-23,2,6,0,8,25.000,25.000
17,0.000,Cw,23-5,11,13,0,24,45.833,45.833
17,0.000,Cliff Sparrow,16-23,0,3,0,3,0.000,0.000
17,0.000,Cliff Sparrow,23-5,0,0,0,0,NaN,NaN
17,0.000,Pig,16-23,1,4,0,5,20.000,20.000
17,0.000,Pig,23-5,0,0,0,0,NaN,NaN
17,0.000,Barn Owl,16-23,0,0,0,0,NaN,NaN
17,0.000,Barn Owl,23-5,0,0,0,0,NaN,NaN
17,0.000,Wild Pig,16-23,0,0,0,0,NaN,NaN
17,0.000,Wild Pig,23-5,0,1,0,1,0.000,0.000
17,0.000,Pennington Creek Water,16-23,0,0,0,0,NaN,NaN
17,0.000,Pennington Creek Water,23-5,0,0,0,0,NaN,NaN
17,0.000,Guinni,16-23,0,0,0,0,NaN,NaN
17,0.000,Guinni,23-5,0,0,0,0,NaN,NaN
17,0.000,Racoon,16-23,0,0,0,0,NaN,NaN
17,0.000,Racoon,23-5,0,0,0,0,NaN,NaN
17,0.000,Hu,16-23,8,6,0,14,57.143,57.143
17,0.000,Hu,23-5,23,20,0,43,53.488,53.488
17,0.000,Cw and Dg,16-23,3,14,0,17,17.647,17.647
17,0.000,Cw and Dg,23-5,11,19,0,30,36.667,36.667
17,0.000,Red Wind Blackbird,16-23,0,0,0,0,NaN,NaN
17,0.000,Red Wind Blackbird,23-5,0,0,0,0,NaN,NaN
17,0.000,Tree Swallow,16-23,0,0,0,0,NaN,NaN
17,0.000,Tree Swallow,23-5,0,0,0,0,NaN,NaN
17,0.000,Turkey Vulture,16-23,0,0,0,0,NaN,NaN
17,0.000,Turkey Vulture,23-5,0,0,0,0,NaN,NaN
17,0.000,Dg,16-23,6,9,0,15,40.000,40.000
17,0.000,Dg,23-5,31,39,0,70,44.286,44.286
17,0.000,Western Kingbird,16-23,0,0,0,0,NaN,NaN
17,0.000,Western Kingbird,23-5,0,0,0,0,NaN,NaN
17,0.000,White Crowned Sparrow,16-23,0,0,0,0,NaN,NaN
17,0.000,White Crowned Sparrow,23-5,0,1,0,1,0.000,0.000
17,0.000,Eared Grebe,16-23,0,0,0,0,NaN,NaN
17,0.000,Eared Grebe,23-5,0,4,0,4,0.000,0.000
17,0.000,cougar,16-23,0,0,0,0,NaN,NaN
17,0.000,cougar,23-5,0,0,0,0,NaN,NaN
17,0.000,Ocean Water,16-23,0,0,0,0,NaN,NaN
17,0.000,Ocean Water,23-5,0,0,0,0,NaN,NaN
17,0.000,Red Tailed Hawk,16-23,0,0,0,0,NaN,NaN
17,0.000,Red Tailed Hawk,23-5,0,0,0,0,NaN,NaN
17,0.000,Dog,16-23,51,66,0,117,43.590,43.590
17,0.000,Dog,23-5,78,145,0,223,34.978,34.978
17,0.000,Human,16-23,1747,894,0,2641,66.149,66.149
17,0.000,Human,23-5,2123,823,0,2946,72.064,72.064
17,0.000,Wild Turkey,16-23,0,1,0,1,0.000,0.000
17,0.000,Wild Turkey,23-5,0,3,0,3,0.000,0.000
17,0.000,Clark Grebe,16-23,0,0,0,0,NaN,NaN
17,0.000,Clark Grebe,23-5,0,0,0,0,NaN,NaN
17,0.000,Seagull,16-23,0,0,0,0,NaN,NaN
17,0.000,Seagull,23-5,3,7,0,10,30.000,30.000
17,0.000,Surf Scoter,16-23,0,0,0,0,NaN,NaN
17,0.000,Surf Scoter,23-5,0,0,0,0,NaN,NaN
17,0.000,Pigeon,16-23,19,123,0,142,13.380,13.380
17,0.000,Pigeon,23-5,54,111,0,165,32.727,32.727
17,0.000,Pacific Ocean Water,16-23,0,0,0,0,NaN,NaN
17,0.000,Pacific Ocean Water,23-5,0,0,0,0,NaN,NaN
17,0.000,Cat,16-23,7,13,0,20,35.000,35.000
17,0.000,Cat,23-5,9,17,0,26,34.615,34.615
17,0.000,Horse,16-23,3,8,0,11,27.273,27.273
17,0.000,Horse,23-5,11,36,0,47,23.404,23.404
17,0.000,orangutan,16-23,0,0,0,0,NaN,NaN
17,0.000,orangutan,23-5,0,0,0,0,NaN,NaN
17,0.000,Bat,16-23,36,38,0,74,48.649,48.649
17,0.000,Bat,23-5,37,41,0,78,47.436,47.436
17,0.000,Deer,16-23,10,36,0,46,21.739,21.739
17,0.000,Deer,23-5,12,125,0,137,8.759,8.759
17,0.000,Great Horned Owl,16-23,0,0,0,0,NaN,NaN
17,0.000,Great Horned Owl,23-5,0,0,0,0,NaN,NaN
17,0.000,Freshwater Lagoon,16-23,0,0,0,0,NaN,NaN
17,0.000,Freshwater Lagoon,23-5,0,0,0,0,NaN,NaN
17,0.000,Unknown Avian,16-23,0,0,0,0,NaN,NaN
17,0.000,Unknown Avian,23-5,0,0,0,0,NaN,NaN
17,0.000,Human UTI,16-23,68,69,0,137,49.635,49.635
17,0.000,Human UTI,23-5,92,122,0,214,42.991,42.991
17,0.000,unknown,16-23,0,0,0,0,NaN,NaN
17,0.000,unknown,23-5,0,0,0,0,NaN,NaN
17,0.000,SLO Creek Water,16-23,0,0,0,0,NaN,NaN
17,0.000,SLO Creek Water,23-5,0,0,0,0,NaN,NaN
17,0.000,Pig/Swine,16-23,3,2,0,5,60.000,60.000
17,0.000,Pig/Swine,23-5,7,7,0,14,50.000,50.000
17,0.000,Klebsiella,16-23,0,0,0,0,NaN,NaN
17,0.000,Klebsiella,23-5,0,0,0,0,NaN,NaN
17,0.000,Hu Cw and Dg,16-23,2,7,0,9,22.222,22.222
17,0.000,Hu Cw and Dg,23-5,3,7,0,10,30.000,30.000
17,0.000,Ground Squirrel,16-23,74,44,0,118,62.712,62.712
17,0.000,Ground Squirrel,23-5,73,60,0,133,54.887,54.887
17,0.000,Opossum,16-23,0,0,0,0,NaN,NaN
17,0.000,Opossum,23-5,0,0,0,0,NaN,NaN
17,0.000,Cow,16-23,1567,1292,0,2859,54.809,54.809
17,0.000,Cow,23-5,1529,1743,0,3272,46.730,46.730
17,0.000,Deer Mouse,16-23,0,0,0,0,NaN,NaN
17,0.000,Deer Mouse,23-5,0,0,0,0,NaN,NaN
17,0.000,OVERALL,16-23,3658,2690,0,6348,57.624,57.624
17,0.000,OVERALL,23-5,4189,3421,0,7610,55.046,55.046
17,0.500,Chicken,16-23,0,0,0,0,NaN,NaN
17,0.500,Chicken,23-5,4,2,0,6,66.667,66.667
17,0.500,Sea Lion,16-23,0,0,0,0,NaN,NaN
17,0.500,Sea Lion,23-5,0,4,0,4,0.000,0.000
17,0.500,Hu and Cw,16-23,0,3,0,3,0.000,0.000
17,0.500,Hu and Cw,23-5,10,7,0,17,58.824,58.824
17,0.500,Sheep,16-23,44,47,0,91,48.352,48.352
17,0.500,Sheep,23-5,52,41,0,93,55.914,55.914
17,0.500,Hu and Dg,16-23,7,5,0,12,58.333,58.333
17,0.500,Hu and Dg,23-5,16,23,0,39,41.026,41.026
17,0.500,Common Loon,16-23,0,0,0,0,NaN,NaN
17,0.500,Common Loon,23-5,0,0,0,0,NaN,NaN
17,0.500,Red-Winged Blackbird,16-23,0,0,0,0,NaN,NaN
17,0.500,Red-Winged Blackbird,23-5,0,0,0,0,NaN,NaN
17,0.500,Cw,16-23,2,6,0,8,25.000,25.000
17,0.500,Cw,23-5,11,13,0,24,45.833,45.833
17,0.500,Cliff Sparrow,16-23,0,3,0,3,0.000,0.000
17,0.500,Cliff Sparrow,23-5,0,0,0,0,NaN,NaN
17,0.500,Pig,16-23,1,4,0,5,20.000,20.000
17,0.500,Pig,23-5,0,0,0,0,NaN,NaN
17,0.500,Barn Owl,16-23,0,0,0,0,NaN,NaN
17,0.500,Barn Owl,23-5,0,0,0,0,NaN,NaN
17,0.500,Wild Pig,16-23,0,0,0,0,NaN,NaN
17,0.500,Wild Pig,23-5,0,1,0,1,0.000,0.000
17,0.500,Pennington Creek Water,16-23,0,0,0,0,NaN,NaN
17,0.500,Pennington Creek Water,23-5,0,0,0,0,NaN,NaN
17,0.500,Guinni,16-23,0,0,0,0,NaN,NaN
17,0.500,Guinni,23-5,0,0,0,0,NaN,NaN
17,0.500,Racoon,16-23,0,0,0,0,NaN,NaN
17,0.500,Racoon,23-5,0,0,0,0,NaN,NaN
17,0.500,Hu,16-23,8,6,0,14,57.143,57.143
17,0.500,Hu,23-5,23,20,0,43,53.488,53.488
17,0.500,Cw and Dg,16-23,3,14,0,17,17.647,17.647
17,0.500,Cw and Dg,23-5,11,19,0,30,36.667,36.667
17,0.500,Red Wind Blackbird,16-23,0,0,0,0,NaN,NaN
17,0.500,Red Wind Blackbird,23-5,0,0,0,0,NaN,NaN
17,0.500,Tree Swallow,16-23,0,0,0,0,NaN,NaN
17,0.500,Tree Swallow,23-5,0,0,0,0,NaN,NaN
17,0.500,Turkey Vulture,16-23,0,0,0,0,NaN,NaN
17,0.500,Turkey Vulture,23-5,0,0,0,0,NaN,NaN
17,0.500,Dg,16-23,6,9,0,15,40.000,40.000
17,0.500,Dg,23-5,31,39,0,70,44.286,44.286
17,0.500,Western Kingbird,16-23,0,0,0,0,NaN,NaN
17,0.500,Western Kingbird,23-5,0,0,0,0,NaN,NaN
17,0.500,White Crowned Sparrow,16-23,0,0,0,0,NaN,NaN
17,0.500,White Crowned Sparrow,23-5,0,1,0,1,0.000,0.000
17,0.500,Eared Grebe,16-23,0,0,0,0,NaN,NaN
17,0.500,Eared Grebe,23-5,0,4,0,4,0.000,0.000
17,0.500,cougar,16-23,0,0,0,0,NaN,NaN
17,0.500,cougar,23-5,0,0,0,0,NaN,NaN
17,0.500,Ocean Water,16-23,0,0,0,0,NaN,NaN
17,0.500,Ocean Water,23-5,0,0,0,0,NaN,NaN
17,0.500,Red Tailed Hawk,16-23,0,0,0,0,NaN,NaN
17,0.500,Red Tailed Hawk,23-5,0,0,0,0,NaN,NaN
17,0.500,Dog,16-23,51,66,0,117,43.590,43.590
17,0.500,Dog,23-5,78,145,0,223,34.978,34.978
17,0.500,Human,16-23,1747,894,0,2641,66.149,66.149
17,0.500,Human,23-5,2123,823,0,2946,72.064,72.064
17,0.500,Wild Turkey,16-23,0,1,0,1,0.000,0.000
17,0.500,Wild Turkey,23-5,0,3,0,3,0.000,0.000
17,0.500,Clark Grebe,16-23,0,0,0,0,NaN,NaN
17,0.500,Clark Grebe,23-5,0,0,0,0,NaN,NaN
17,0.500,Seagull,16-23,0,0,0,0,NaN,NaN
17,0.500,Seagull,23-5,3,7,0,10,30.000,30.000
17,0.500,Surf Scoter,16-23,0,0,0,0,NaN,NaN
17,0.500,Surf Scoter,23-5,0,0,0,0,NaN,NaN
17,0.500,Pigeon,16-23,19,123,0,142,13.380,13.380
17,0.500,Pigeon,23-5,54,111,0,165,32.727,32.727
17,0.500,Pacific Ocean Water,16-23,0,0,0,0,NaN,NaN
17,0.500,Pacific Ocean Water,23-5,0,0,0,0,NaN,NaN
17,0.500,Cat,16-23,7,13,0,20,35.000,35.000
17,0.500,Cat,23-5,9,17,0,26,34.615,34.615
17,0.500,Horse,16-23,3,8,0,11,27.273,27.273
17,0.500,Horse,23-5,11,36,0,47,23.404,23.404
17,0.500,orangutan,16-23,0,0,0,0,NaN,NaN
17,0.500,orangutan,23-5,0,0,0,0,NaN,NaN
17,0.500,Bat,16-23,36,38,0,74,48.649,48.649
17,0.500,Bat,23-5,37,41,0,78,47.436,47.436
17,0.500,Deer,16-23,10,36,0,46,21.739,21.739
17,0.500,Deer,23-5,12,125,0,137,8.759,8.759
17,0.500,Great Horned Owl,16-23,0,0,0,0,NaN,NaN
17,0.500,Great Horned Owl,23-5,0,0,0,0,NaN,NaN
17,0.500,Freshwater Lagoon,16-23,0,0,0,0,NaN,NaN
17,0.500,Freshwater Lagoon,23-5,0,0,0,0,NaN,NaN
17,0.500,Unknown Avian,16-23,0,0,0,0,NaN,NaN
17,0.500,Unknown Avian,23-5,0,0,0,0,NaN,NaN
17,0.500,Human UTI,16-23,68,69,0,137,49.635,49.635
17,0.500,Human UTI,23-5,92,122,0,214,42.991,42.991
17,0.500,unknown,16-23,0,0,0,0,NaN,NaN
17,0.500,unknown,23-5,0,0,0,0,NaN,NaN
17,0.500,SLO Creek Water,16-23,0,0,0,0,NaN,NaN
17,0.500,SLO Creek Water,23-5,0,0,0,0,NaN,NaN
17,0.500,Pig/Swine,16-23,3,2,0,5,60.000,60.000
17,0.500,Pig/Swine,23-5,7,7,0,14,50.000,50.000
17,0.500,Klebsiella,16-23,0,0,0,0,NaN,NaN
17,0.500,Klebsiella,23-5,0,0,0,0,NaN,NaN
17,0.500,Hu Cw and Dg,16-23,2,7,0,9,22.222,22.222
17,0.500,Hu Cw and Dg,23-5,3,7,0,10,30.000,30.000
17,0.500,Ground Squirrel,16-23,74,44,0,118,62.712,62.712
17,0.500,Ground Squirrel,23-5,73,60,0,133,54.887,54.887
17,0.500,Opossum,16-23,0,0,0,0,NaN,NaN
17,0.500,Opossum,23-5,0,0,0,0,NaN,NaN
17,0.500,Cow,16-23,1567,1292,0,2859,54.809,54.809
17,0.500,Cow,23-5,1529,1743,0,3272,46.730,46.730
17,0.500,Deer Mouse,16-23,0,0,0,0,NaN,NaN
17,0.500,Deer Mouse,23-5,0,0,0,0,NaN,NaN
17,0.500,OVERALL,16-23,3658,2690,0,6348,57.624,57.624
17,0.500,OVERALL,23-5,4189,3421,0,7610,55.046,55.046
17,0.900,Chicken,16-23,0,0,0,0,NaN,NaN
17,0.900,Chicken,23-5,4,2,0,6,66.667,66.667
17,0.900,Sea Lion,16-23,0,0,0,0,NaN,NaN
17,0.900,Sea Lion,23-5,0,4,0,4,0.000,0.000
17,0.900,Hu and Cw,16-23,0,3,0,3,0.000,0.000
17,0.900,Hu and Cw,23-5,10,7,0,17,58.824,58.824
17,0.900,Sheep,16-23,44,47,0,91,48.352,48.352
17,0.900,Sheep,23-5,52,41,0,93,55.914,55.914
17,0.900,Hu and Dg,16-23,7,5,0,12,58.333,58.333
17,0.900,Hu and Dg,23-5,16,23,0,39,41.026,41.026
17,0.900,Common Loon,16-23,0,0,0,0,NaN,NaN
17,0.900,Common Loon,23-5,0,0,0,0,NaN,NaN
17,0.900,Red-Winged Blackbird,16-23,0,0,0,0,NaN,NaN
17,0.900,Red-Winged Blackbird,23-5,0,0,0,0,NaN,NaN
17,0.900,Cw,16-23,2,6,0,8,25.000,25.000
17,0.900,Cw,23-5,11,13,0,24,45.833,45.833
17,0.900,Cliff Sparrow,16-23,0,3,0,3,0.000,0.000
17,0.900,Cliff Sparrow,23-5,0,0,0,0,NaN,NaN
17,0.900,Pig,16-23,1,4,0,5,20.000,20.000
17,0.900,Pig,23-5,0,0,0,0,NaN,NaN
17,0.900,Barn Owl,16-23,0,0,0,0,NaN,NaN
17,0.900,Barn Owl,23-5,0,0,0,0,NaN,NaN
17,0.900,Wild Pig,16-23,0,0,0,0,NaN,NaN
17,0.900,Wild Pig,23-5,0,1,0,1,0.000,0.000
17,0.900,Pennington Creek Water,16-23,0,0,0,0,NaN,NaN
17,0.900,Pennington Creek Water,23-5,0,0,0,0,NaN,NaN
17,0.900,Guinni,16-23,0,0,0,0,NaN,NaN
17,0.900,Guinni,23-5,0,0,0,0,NaN,NaN
17,0.900,Racoon,16-23,0,0,0,0,NaN,NaN
17,0.900,Racoon,23-5,0,0,0,0,NaN,NaN
17,0.900,Hu,16-23,8,6,0,14,57.143,57.143
17,0.900,Hu,23-5,23,20,0,43,53.488,53.488
17,0.900,Cw and Dg,16-23,3,14,0,17,17.647,17.647
17,0.900,Cw and Dg,23-5,11,19,0,30,36.667,36.667
17,0.900,Red Wind Blackbird,16-23,0,0,0,0,NaN,NaN
17,0.900,Red Wind Blackbird,23-5,0,0,0,0,NaN,NaN
17,0.900,Tree Swallow,16-23,0,0,0,0,NaN,NaN
17,0.900,Tree Swallow,23-5,0,0,0,0,NaN,NaN
17,0.900,Turkey Vulture,16-23,0,0,0,0,NaN,NaN
17,0.900,Turkey Vulture,23-5,0,0,0,0,NaN,NaN
17,0.900,Dg,16-23,6,9,0,15,40.000,40.000
17,0.900,Dg,23-5,31,39,0,70,44.286,44.286
17,0.900,Western Kingbird,16-23,0,0,0,0,NaN,NaN
17,0.900,Western Kingbird,23-5,0,0,0,0,NaN,NaN
17,0.900,White Crowned Sparrow,16-23,0,0,0,0,NaN,NaN
17,0.900,White Crowned Sparrow,23-5,0,1,0,1,0.000,0.000
17,0.900,Eared Grebe,16-23,0,0,0,0,NaN,NaN
17,0.900,Eared Grebe,23-5,0,4,0,4,0.000,0.000
17,0.900,cougar,16-23,0,0,0,0,NaN,NaN
17,0.900,cougar,23-5,0,0,0,0,NaN,NaN
17,0.900,Ocean Water,16-23,0,0,0,0,NaN,NaN
17,0.900,Ocean Water,23-5,0,0,0,0,NaN,NaN
17,0.900,Red Tailed Hawk,16-23,0,0,0,0,NaN,NaN
17,0.900,Red Tailed Hawk,23-5,0,0,0,0,NaN,NaN
17,0.900,Dog,16-23,51,66,0,117,43.590,43.590
17,0.900,Dog,23-5,78,141,0,219,35.616,35.616
17,0.900,Human,16-23,1747,891,0,2638,66.224,66.224
17,0.900,Human,23-5,2123,819,0,2942,72.162,72.162
17,0.900,Wild Turkey,16-23,0,1,0,1,0.000,0.000
17,0.900,Wild Turkey,23-5,0,3,0,3,0.000,0.000
17,0.900,Clark Grebe,16-23,0,0,0,0,NaN,NaN
17,0.900,Clark Grebe,23-5,0,0,0,0,NaN,NaN
17,0.900,Seagull,16-23,0,0,0,0,NaN,NaN
17,0.900,Seagull,23-5,3,8,0,11,27.273,27.273
17,0.900,Surf Scoter,16-23,0,0,0,0,NaN,NaN
17,0.900,Surf Scoter,23-5,0,0,0,0,NaN,NaN
17,0.900,Pigeon,16-23,19,124,0,143,13.287,13.287
17,0.900,Pigeon,23-5,54,111,0,165,32.727,32.727
17,0.900,Pacific Ocean Water,16-23,0,0,0,0,NaN,NaN
17,0.900,Pacific Ocean Water,23-5,0,0,0,0,NaN,NaN
17,0.900,Cat,16-23,7,13,0,20,35.000,35.000
17,0.900,Cat,23-5,9,17,0,26,34.615,34.615
17,0.900,Horse,16-23,3,8,0,11,27.273,27.273
17,0.900,Horse,23-5,11,36,0,47,23.404,23.404
17,0.900,orangutan,16-23,0,0,0,0,NaN,NaN
17,0.900,orangutan,23-5,0,0,0,0,NaN,NaN
17,0.900,Bat,16-23,36,38,0,74,48.649,48.649
17,0.900,Bat,23-5,37,41,0,78,47.436,47.436
17,0.900,Deer,16-23,10,36,0,46,21.739,21.739
17,0.900,Deer,23-5,12,125,0,137,8.759,8.759
17,0.900,Great Horned Owl,16-23,0,0,0,0,NaN,NaN
17,0.900,Great Horned Owl,23-5,0,0,0,0,NaN,NaN
17,0.900,Freshwater Lagoon,16-23,0,0,0,0,NaN,NaN
17,0.900,Freshwater Lagoon,23-5,0,0,0,0,NaN,NaN
17,0.900,Unknown Avian,16-23,0,0,0,0,NaN,NaN
17,0.900,Unknown Avian,23-5,0,0,0,0,NaN,NaN
17,0.900,Human UTI,16-23,68,69,0,137,49.635,49.635
17,0.900,Human UTI,23-5,95,122,0,217,43.779,43.779
17,0.900,unknown,16-23,0,0,0,0,NaN,NaN
17,0.900,unknown,23-5,0,0,0,0,NaN,NaN
17,0.900,SLO Creek Water,16-23,0,0,0,0,NaN,NaN
17,0.900,SLO Creek Water,23-5,0,0,0,0,NaN,NaN
17,0.900,Pig/Swine,16-23,3,2,0,5,60.000,60.000
17,0.900,Pig/Swine,23-5,7,7,0,14,50.000,50.000
17,0.900,Klebsiella,16-23,0,0,0,0,NaN,NaN
17,0.900,Klebsiella,23-5,0,0,0,0,NaN,NaN
17,0.900,Hu Cw and Dg,16-23,2,7,0,9,22.222,22.222
17,0.900,Hu Cw and Dg,23-5,3,7,0,10,30.000,30.000
17,0.900,Ground Squirrel,16-23,74,44,0,118,62.712,62.712
17,0.900,Ground Squirrel,23-5,73,60,0,133,54.887,54.887
17,0.900,Opossum,16-23,0,0,0,0,NaN,NaN
17,0.900,Opossum,23-5,0,0,0,0,NaN,NaN
17,0.900,Cow,16-23,1568,1289,0,2857,54.883,54.883
17,0.900,Cow,23-5,1529,1739,0,3268,46.787,46.787
17,0.900,Deer Mouse,16-23,0,0,0,0,NaN,NaN
17,0.900,Deer Mouse,23-5,0,0,0,0,NaN,NaN
17,0.900,OVERALL,16-23,3659,2685,0,6344,57.677,57.677
17,0.900,OVERALL,23-5,4192,3410,0,7602,55.143,55.143
17,0.950,Chicken,16-23,0,0,0,0,NaN,NaN
17,0.950,Chicken,23-5,4,2,0,6,66.667,66.667
17,0.950,Sea Lion,16-23,0,0,0,0,NaN,NaN
17,0.950,Sea Lion,23-5,0,4,0,4,0.000,0.000
17,0.950,Hu and Cw,16-23,0,3,0,3,0.000,0.000
17,0.950,Hu and Cw,23-5,10,7,0,17,58.824,58.824
17,0.950,Sheep,16-23,44,47,0,91,48.352,48.352
17,0.950,Sheep,23-5,52,41,0,93,55.914,55.914
17,0.950,Hu and Dg,16-23,7,5,0,12,58.333,58.333
17,0.950,Hu and Dg,23-5,16,23,0,39,41.026,41.026
17,0.950,Common Loon,16-23,0,0,0,0,NaN,NaN
17,0.950,Common Loon,23-5,0,0,0,0,NaN,NaN
17,0.950,Red-Winged Blackbird,16-23,0,0,0,0,NaN,NaN
17,0.950,Red-Winged Blackbird,23-5,0,0,0,0,NaN,NaN
17,0.950,Cw,16-23,2,6,0,8,25.000,25.000
17,0.950,Cw,23-5,11,13,0,24,45.833,45.833
17,0.950,Cliff Sparrow,16-23,0,3,0,3,0.000,0.000
17,0.950,Cliff Sparrow,23-5,0,0,0,0,NaN,NaN
17,0.950,Pig,16-23,1,4,0,5,20.000,20.000
17,0.950,Pig,23-5,0,0,0,0,NaN,NaN
17,0.950,Barn Owl,16-23,0,0,0,0,NaN,NaN
17,0.950,Barn Owl,23-5,0,0,0,0,NaN,NaN
17,0.950,Wild Pig,16-23,0,0,0,0,NaN,NaN
17,0.950,Wild Pig,23-5,0,1,0,1,0.000,0.000
17,0.950,Pennington Creek Water,16-23,0,0,0,0,NaN,NaN
17,0.950,Pennington Creek Water,23-5,0,0,0,0,NaN,NaN
17,0.950,Guinni,16-23,0,0,0,0,NaN,NaN
17,0.950,Guinni,23-5,0,0,0,0,NaN,NaN
17,0.950,Racoon,16-23,0,0,0,0,NaN,NaN
17,0.950,Racoon,23-5,0,0,0,0,NaN,NaN
17,0.950,Hu,16-23,8,6,0,14,57.143,57.143
17,0.950,Hu,23-5,23,20,0,43,53.488,53.488
17,0.950,Cw and Dg,16-23,3,14,0,17,17.647,17.647
17,0.950,Cw and Dg,23-5,11,19,0,30,36.667,36.667
17,0.950,Red Wind Blackbird,16-23,0,0,0,0,NaN,NaN
17,0.950,Red Wind Blackbird,23-5,0,0,0,0,NaN,NaN
17,0.950,Tree Swallow,16-23,0,0,0,0,NaN,NaN
17,0.950,Tree Swallow,23-5,0,0,0,0,NaN,NaN
17,0.950,Turkey Vulture,16-23,0,0,0,0,NaN,NaN
17,0.950,Turkey Vulture,23-5,0,0,0,0,NaN,NaN
17,0.950,Dg,16-23,6,9,0,15,40.000,40.000
17,0.950,Dg,23-5,31,38,0,69,44.928,44.928
17,0.950,Western Kingbird,16-23,0,0,0,0,NaN,NaN
17,0.950,Western Kingbird,23-5,0,0,0,0,NaN,NaN
17,0.950,White Crowned Sparrow,16-23,0,0,0,0,NaN,NaN
17,0.950,White Crowned Sparrow,23-5,0,1,0,1,0.000,0.000
17,0.950,Eared Grebe,16-23,0,0,0,0,NaN,NaN
17,0.950,Eared Grebe,23-5,0,4,0,4,0.000,0.000
17,0.950,cougar,16-23,0,0,0,0,NaN,NaN
17,0.950,cougar,23-5,0,0,0,0,NaN,NaN
17,0.950,Ocean Water,16-23,0,0,0,0,NaN,NaN
17,0.950,Ocean Water,23-5,0,0,0,0,NaN,NaN
17,0.950,Red Tailed Hawk,16-23,0,0,0,0,NaN,NaN
17,0.950,Red Tailed Hawk,23-5,0,0,0,0,NaN,NaN
17,0.950,Dog,16-23,51,66,0,117,43.590,43.590
17,0.950,Dog,23-5,78,140,0,218,35.780,35.780
17,0.950,Human,16-23,1747,887,0,2634,66.325,66.325
17,0.950,Human,23-5,2116,812,0,2928,72.268,72.268
17,0.950,Wild Turkey,16-23,0,1,0,1,0.000,0.000
17,0.950,Wild Turkey,23-5,0,2,0,2,0.000,0.000
17,0.950,Clark Grebe,16-23,0,0,0,0,NaN,NaN
17,0.950,Clark Grebe,23-5,0,0,0,0,NaN,NaN
17,0.950,Seagull,16-23,0,0,0,0,NaN,NaN
17,0.950,Seagull,23-5,3,7,0,10,30.000,30.000
17,0.950,Surf Scoter,16-23,0,0,0,0,NaN,NaN
17,0.950,Surf Scoter,23-5,0,0,0,0,NaN,NaN
17,0.950,Pigeon,16-23,20,123,0,143,13.986,13.986
17,0.950,Pigeon,23-5,54,112,0,166,32.530,32.530
17,0.950,Pacific Ocean Water,16-23,0,0,0,0,NaN,NaN
17,0.950,Pacific Ocean Water,23-5,0,0,0,0,NaN,NaN
17,0.950,Cat,16-23,7,13,0,20,35.000,35.000
17,0.950,Cat,23-5,9,24,0,33,27.273,27.273
17,0.950,Horse,16-23,3,8,0,11,27.273,27.273
17,0.950,Horse,23-5,11,36,0,47,23.404,23.404
17,0.950,orangutan,16-23,0,0,0,0,NaN,NaN
17,0.950,orangutan,23-5,0,0,0,0,NaN,NaN
17,0.950,Bat,16-23,36,38,0,74,48.649,48.649
17,0.950,Bat,23-5,37,40,0,77,48.052,48.052
17,0.950,Deer,16-23,10,36,0,46,21.739,21.739
17,0.950,Deer,23-5,12,125,0,137,8.759,8.759
17,0.950,Great Horned Owl,16-23,0,0,0,0,NaN,NaN
17,0.950,Great Horned Owl,23-5,0,0,0,0,NaN,NaN
17,0.950,Freshwater Lagoon,16-23,0,0,0,0,NaN,NaN
17,0.950,Freshwater Lagoon,23-5,0,0,0,0,NaN,NaN
17,0.950,Unknown Avian,16-23,0,0,0,0,NaN,NaN
17,0.950,Unknown Avian,23-5,0,0,0,0,NaN,NaN
17,0.950,Human UTI,16-23,71,70,0,141,50.355,50.355
17,0.950,Human UTI,23-5,94,125,0,219,42.922,42.922
17,0.950,unknown,16-23,0,0,0,0,NaN,NaN
17,0.950,unknown,23-5,0,0,0,0,NaN,NaN
17,0.950,SLO Creek Water,16-23,0,0,0,0,NaN,NaN
17,0.950,SLO Creek Water,23-5,0,0,0,0,NaN,NaN
17,0.950,Pig/Swine,16-23,3,2,0,5,60.000,60.000
17,0.950,Pig/Swine,23-5,7,7,0,14,50.000,50.000
17,0.950,Klebsiella,16-23,0,0,0,0,NaN,NaN
17,0.950,Klebsiella,23-5,0,0,0,0,NaN,NaN
17,0.950,Hu Cw and Dg,16-23,2,7,0,9,22.222,22.222
17,0.950,Hu Cw and Dg,23-5,3,7,0,10,30.000,30.000
17,0.950,Ground Squirrel,16-23,74,44,0,118,62.712,62.712
17,0.950,Ground Squirrel,23-5,73,59,0,132,55.303,55.303
17,0.950,Opossum,16-23,0,0,0,0,NaN,NaN
17,0.950,Opossum,23-5,0,0,0,0,NaN,NaN
17,0.950,Cow,16-23,1572,1268,0,2840,55.352,55.352
17,0.950,Cow,23-5,1529,1735,0,3264,46.844,46.844
17,0.950,Deer Mouse,16-23,0,0,0,0,NaN,NaN
17,0.950,Deer Mouse,23-5,0,0,0,0,NaN,NaN
17,0.950,OVERALL,16-23,3667,2660,0,6327,57.958,57.958
17,0.950,OVERALL,23-5,4184,3404,0,7588,55.140,55.140
17,0.960,Chicken,16-23,0,0,0,0,NaN,NaN
17,0.960,Chicken,23-5,4,2,0,6,66.667,66.667
17,0.960,Sea Lion,16-23,0,0,0,0,NaN,NaN
17,0.960,Sea Lion,23-5,0,4,0,4,0.000,0.000
17,0.960,Hu and Cw,16-23,0,3,0,3,0.000,0.000
17,0.960,Hu and Cw,23-5,10,7,0,17,58.824,58.824
17,0.960,Sheep,16-23,44,47,0,91,48.352,48.352
17,0.960,Sheep,23-5,52,42,0,94,55.319,55.319
17,0.960,Hu and Dg,16-23,7,5,0,12,58.333,58.333
17,0.960,Hu and Dg,23-5,16,23,0,39,41.026,41.026
17,0.960,Common Loon,16-23,0,0,0,0,NaN,NaN
17,0.960,Common Loon,23-5,0,0,0,0,NaN,NaN
17,0.960,Red-Winged Blackbird,16-23,0,0,0,0,NaN,NaN
17,0.960,Red-Winged Blackbird,23-5,0,0,0,0,NaN,NaN
17,0.960,Cw,16-23,2,6,0,8,25.000,25.000
17,0.960,Cw,23-5,11,13,0,24,45.833,45.833
17,0.960,Cliff Sparrow,16-23,0,3,0,3,0.000,0.000
17,0.960,Cliff Sparrow,23-5,0,0,0,0,NaN,NaN
17,0.960,Pig,16-23,1,4,0,5,20.000,20.000
17,0.960,Pig,23-5,0,0,0,0,NaN,NaN
17,0.960,Barn Owl,16-23,0,0,0,0,NaN,NaN
17,0.960,Barn Owl,23-5,0,0,0,0,NaN,NaN
17,0.960,Wild Pig,16-23,0,0,0,0,NaN,NaN
17,0.960,Wild Pig,23-5,1,1,0,2,50.000,50.000
17,0.960,Pennington Creek Water,16-23,0,0,0,0,NaN,NaN
17,0.960,Pennington Creek Water,23-5,0,0,0,0,NaN,NaN
17,0.960,Guinni,16-23,0,0,0,0,NaN,NaN
17,0.960,Guinni,23-5,0,0,0,0,NaN,NaN
17,0.960,Racoon,16-23,0,0,0,0,NaN,NaN
17,0.960,Racoon,23-5,0,0,0,0,NaN,NaN
17,0.960,Hu,16-23,8,6,0,14,57.143,57.143
17,0.960,Hu,23-5,23,20,0,43,53.488,53.488
17,0.960,Cw and Dg,16-23,3,14,0,17,17.647,17.647
17,0.960,Cw and Dg,23-5,11,19,0,30,36.667,36.667
17,0.960,Red Wind Blackbird,16-23,0,0,0,0,NaN,NaN
17,0.960,Red Wind Blackbird,23-5,0,0,0,0,NaN,NaN
17,0.960,Tree Swallow,16-23,0,0,0,0,NaN,NaN
17,0.960,Tree Swallow,23-5,0,0,0,0,NaN,NaN
17,0.960,Turkey Vulture,16-23,0,0,0,0,NaN,NaN
17,0.960,Turkey Vulture,23-5,0,0,0,0,NaN,NaN
17,0.960,Dg,16-23,6,9,0,15,40.000,40.000
17,0.960,Dg,23-5,31,38,0,69,44.928,44.928
17,0.960,Western Kingbird,16-23,0,0,0,0,NaN,NaN
17,0.960,Western Kingbird,23-5,0,0,0,0,NaN,NaN
17,0.960,White Crowned Sparrow,16-23,0,0,0,0,NaN,NaN
17,0.960,White Crowned Sparrow,23-5,0,1,0,1,0.000,0.000
17,0.960,Eared Grebe,16-23,0,0,0,0,NaN,NaN
17,0.960,Eared Grebe,23-5,0,4,0,4,0.000,0.000
17,0.960,cougar,16-23,0,0,0,0,NaN,NaN
17,0.960,cougar,23-5,0,0,0,0,NaN,NaN
17,0.960,Ocean Water,16-23,0,0,0,0,NaN,NaN
17,0.960,Ocean Water,23-5,0,0,0,0,NaN,NaN
17,0.960,Red Tailed Hawk,16-23,0,0,0,0,NaN,NaN
17,0.960,Red Tailed Hawk,23-5,0,0,0,0,NaN,NaN
17,0.960,Dog,16-23,51,66,0,117,43.590,43.590
17,0.960,Dog,23-5,78,135,0,213,36.620,36.620
17,0.960,Human,16-23,1748,885,0,2633,66.388,66.388
17,0.960,Human,23-5,2120,797,0,2917,72.677,72.677
17,0.960,Wild Turkey,16-23,0,1,0,1,0.000,0.000
17,0.960,Wild Turkey,23-5,0,7,0,7,0.000,0.000
17,0.960,Clark Grebe,16-23,0,0,0,0,NaN,NaN
17,0.960,Clark Grebe,23-5,0,0,0,0,NaN,NaN
17,0.960,Seagull,16-23,0,0,0,0,NaN,NaN
17,0.960,Seagull,23-5,3,8,0,11,27.273,27.273
17,0.960,Surf Scoter,16-23,0,0,0,0,NaN,NaN
17,0.960,Surf Scoter,23-5,0,2,0,2,0.000,0.000
17,0.960,Pigeon,16-23,20,123,0,143,13.986,13.986
17,0.960,Pigeon,23-5,55,129,0,184,29.891,29.891
17,0.960,Pacific Ocean Water,16-23,0,0,0,0,NaN,NaN
17,0.960,Pacific Ocean Water,23-5,0,0,0,0,NaN,NaN
17,0.960,Cat,16-23,7,13,0,20,35.000,35.000
17,0.960,Cat,23-5,9,25,0,34,26.471,26.471
17,0.960,Horse,16-23,3,8,0,11,27.273,27.273
17,0.960,Horse,23-5,11,36,0,47,23.404,23.404
17,0.960,orangutan,16-23,0,0,0,0,NaN,NaN
17,0.960,orangutan,23-5,0,0,0,0,NaN,NaN
17,0.960,Bat,16-23,36,38,0,74,48.649,48.649
17,0.960,Bat,23-5,37,40,0,77,48.052,48.052
17,0.960,Deer,16-23,10,36,0,46,21.739,21.739
17,0.960,Deer,23-5,12,125,0,137,8.759,8.759
17,0.960,Great Horned Owl,16-23,0,0,0,0,NaN,NaN
17,0.960,Great Horned Owl,23-5,0,0,0,0,NaN,NaN
17,0.960,Freshwater Lagoon,16-23,0,0,0,0,NaN,NaN
17,0.960,Freshwater Lagoon,23-5,0,0,0,0,NaN,NaN
17,0.960,Unknown Avian,16-23,0,0,0,0,NaN,NaN
17,0.960,Unknown Avian,23-5,0,0,0,0,NaN,NaN
17,0.960,Human UTI,16-23,71,71,0,142,50.000,50.000
17,0.960,Human UTI,23-5,94,124,0,218,43.119,43.119
17,0.960,unknown,16-23,0,0,0,0,NaN,NaN
17,0.960,unknown,23-5,0,0,0,0,NaN,NaN
17,0.960,SLO Creek Water,16-23,0,0,0,0,NaN,NaN
17,0.960,SLO Creek Water,23-5,0,0,0,0,NaN,NaN
17,0.960,Pig/Swine,16-23,3,2,0,5,60.000,60.000
17,0.960,Pig/Swine,23-5,7,7,0,14,50.000,50.000
17,0.960,Klebsiella,16-23,0,0,0,0,NaN,NaN
17,0.960,Klebsiella,23-5,0,0,0,0,NaN,NaN
17,0.960,Hu Cw and Dg,16-23,2,7,0,9,22.222,22.222
17,0.960,Hu Cw and Dg,23-5,3,7,0,10,30.000,30.000
17,0.960,Ground Squirrel,16-23,74,44,0,118,62.712,62.712
17,0.960,Ground Squirrel,23-5,73,61,0,134,54.478,54.478
17,0.960,Opossum,16-23,0,0,0,0,NaN,NaN
17,0.960,Opossum,23-5,0,0,0,0,NaN,NaN
17,0.960,Cow,16-23,1570,1259,0,2829,55.497,55.497
17,0.960,Cow,23-5,1529,1710,0,3239,47.206,47.206
17,0.960,Deer Mouse,16-23,0,0,0,0,NaN,NaN
17,0.960,Deer Mouse,23-5,0,0,0,0,NaN,NaN
17,0.960,OVERALL,16-23,3666,2650,0,6316,58.043,58.043
17,0.960,OVERALL,23-5,4190,3387,0,7577,55.299,55.299
17,0.970,Chicken,16-23,0,0,0,0,NaN,NaN
17,0.970,Chicken,23-5,4,2,0,6,66.667,66.667
17,0.970,Sea Lion,16-23,0,0,0,0,NaN,NaN
17,0.970,Sea Lion,23-5,0,6,0,6,0.000,0.000
17,0.970,Hu and Cw,16-23,0,3,0,3,0.000,0.000
17,0.970,Hu and Cw,23-5,10,7,0,17,58.824,58.824
17,0.970,Sheep,16-23,45,48,0,93,48.387,48.387
17,0.970,Sheep,23-5,52,41,0,93,55.914,55.914
17,0.970,Hu and Dg,16-23,7,5,0,12,58.333,58.333
17,0.970,Hu and Dg,23-5,16,23,0,39,41.026,41.026
17,0.970,Common Loon,16-23,0,0,0,0,NaN,NaN
17,0.970,Common Loon,23-5,0,0,0,0,NaN,NaN
17,0.970,Red-Winged Blackbird,16-23,0,0,0,0,NaN,NaN
17,0.970,Red-Winged Blackbird,23-5,0,0,0,0,NaN,NaN
17,0.970,Cw,16-23,2,7,0,9,22.222,22.222
17,0.970,Cw,23-5,11,13,0,24,45.833,45.833
17,0.970,Cliff Sparrow,16-23,0,3,0,3,0.000,0.000
17,0.970,Cliff Sparrow,23-5,0,0,0,0,NaN,NaN
17,0.970,Pig,16-23,1,4,0,5,20.000,20.000
17,0.970,Pig,23-5,0,0,0,0,NaN,NaN
17,0.970,Barn Owl,16-23,0,0,0,0,NaN,NaN
17,0.970,Barn Owl,23-5,0,0,0,0,NaN,NaN
17,0.970,Wild Pig,16-23,0,0,0,0,NaN,NaN
17,0.970,Wild Pig,23-5,0,1,0,1,0.000,0.000
17,0.970,Pennington Creek Water,16-23,0,0,0,0,NaN,NaN
17,0.970,Pennington Creek Water,23-5,0,0,0,0,NaN,NaN
17,0.970,Guinni,16-23,0,0,0,0,NaN,NaN
17,0.970,Guinni,23-5,0,0,0,0,NaN,NaN
17,0.970,Racoon,16-23,0,0,0,0,NaN,NaN
17,0.970,Racoon,23-5,0,0,0,0,NaN,NaN
17,0.970,Hu,16-23,8,6,0,14,57.143,57.143
17,0.970,Hu,23-5,23,20,0,43,53.488,53.488
17,0.970,Cw and Dg,16-23,3,14,0,17,17.647,17.647
17,0.970,Cw and Dg,23-5,11,19,0,30,36.667,36.667
17,0.970,Red Wind Blackbird,16-23,0,0,0,0,NaN,NaN
17,0.970,Red Wind Blackbird,23-5,0,0,0,0,NaN,NaN
17,0.970,Tree Swallow,16-23,0,0,0,0,NaN,NaN
17,0.970,Tree Swallow,23-5,0,0,0,0,NaN,NaN
17,0.970,Turkey Vulture,16-23,0,0,0,0,NaN,NaN
17,0.970,Turkey Vulture,23-5,0,0,0,0,NaN,NaN
17,0.970,Dg,16-23,6,9,0,15,40.000,40.000
17,0.970,Dg,23-5,31,35,0,66,46.970,46.970
17,0.970,Western Kingbird,16-23,0,0,0,0,NaN,NaN
17,0.970,Western Kingbird,23-5,0,0,0,0,NaN,NaN
17,0.970,White Crowned Sparrow,16-23,0,0,0,0,NaN,NaN
17,0.970,White Crowned Sparrow,23-5,0,1,0,1,0.000,0.000
17,0.970,Eared Grebe,16-23,0,0,0,0,NaN,NaN
17,0.970,Eared Grebe,23-5,0,4,0,4,0.000,0.000
17,0.970,cougar,16-23,0,0,0,0,NaN,NaN
17,0.970,cougar,23-5,0,0,0,0,NaN,NaN
17,0.970,Ocean Water,16-23,0,0,0,0,NaN,NaN
17,0.970,Ocean Water,23-5,0,0,0,0,NaN,NaN
17,0.970,Red Tailed Hawk,16-23,0,0,0,0,NaN,NaN
17,0.970,Red Tailed Hawk,23-5,0,0,0,0,NaN,NaN
17,0.970,Dog,16-23,51,66,0,117,43.590,43.590
17,0.970,Dog,23-5,80,134,0,214,37.383,37.383
17,0.970,Human,16-23,1747,882,0,2629,66.451,66.451
17,0.970,Human,23-5,2120,792,0,2912,72.802,72.802
17,0.970,Wild Turkey,16-23,0,3,0,3,0.000,0.000
17,0.970,Wild Turkey,23-5,2,6,0,8,25.000,25.000
17,0.970,Clark Grebe,16-23,0,0,0,0,NaN,NaN
17,0.970,Clark Grebe,23-5,0,0,0,0,NaN,NaN
17,0.970,Seagull,16-23,0,0,0,0,NaN,NaN
17,0.970,Seagull,23-5,3,9,0,12,25.000,25.000
17,0.970,Surf Scoter,16-23,0,0,0,0,NaN,NaN
17,0.970,Surf Scoter,23-5,0,2,0,2,0.000,0.000
17,0.970,Pigeon,16-23,19,122,0,141,13.475,13.475
17,0.970,Pigeon,23-5,55,145,0,200,27.500,27.500
17,0.970,Pacific Ocean Water,16-23,0,0,0,0,NaN,NaN
17,0.970,Pacific Ocean Water,23-5,0,0,0,0,NaN,NaN
17,0.970,Cat,16-23,7,13,0,20,35.000,35.000
17,0.970,Cat,23-5,9,22,0,31,29.032,29.032
17,0.970,Horse,16-23,3,8,0,11,27.273,27.273
17,0.970,Horse,23-5,11,37,0,48,22.917,22.917
17,0.970,orangutan,16-23,0,0,0,0,NaN,NaN
17,0.970,orangutan,23-5,0,0,0,0,NaN,NaN
17,0.970,Bat,16-23,36,38,0,74,48.649,48.649
17,0.970,Bat,23-5,37,40,0,77,48.052,48.052
17,0.970,Deer,16-23,10,36,0,46,21.739,21.739
17,0.970,Deer,23-5,12,125,0,137,8.759,8.759
17,0.970,Great Horned Owl,16-23,0,0,0,0,NaN,NaN
17,0.970,Great Horned Owl,23-5,0,0,0,0,NaN,NaN
17,0.970,Freshwater Lagoon,16-23,0,0,0,0,NaN,NaN
17,0.970,Freshwater Lagoon,23-5,0,0,0,0,NaN,NaN
17,0.970,Unknown Avian,16-23,0,0,0,0,NaN,NaN
17,0.970,Unknown Avian,23-5,0,0,0,0,NaN,NaN
17,0.970,Human UTI,16-23,71,72,0,143,49.650,49.650
17,0.970,Human UTI,23-5,93,124,0,217,42.857,42.857
17,0.970,unknown,16-23,0,0,0,0,NaN,NaN
17,0.970,unknown,23-5,0,0,0,0,NaN,NaN
17,0.970,SLO Creek Water,16-23,0,0,0,0,NaN,NaN
17,0.970,SLO Creek Water,23-5,0,0,0,0,NaN,NaN
17,0.970,Pig/Swine,16-23,3,2,0,5,60.000,60.000
17,0.970,Pig/Swine,23-5,7,7,0,14,50.000,50.000
17,0.970,Klebsiella,16-23,0,0,0,0,NaN,NaN
17,0.970,Klebsiella,23-5,0,0,0,0,NaN,NaN
17,0.970,Hu Cw and Dg,16-23,2,7,0,9,22.222,22.222
17,0.970,Hu Cw and Dg,23-5,3,7,0,10,30.000,30.000
17,0.970,Ground Squirrel,16-23,74,43,0,117,63.248,63.248
17,0.970,Ground Squirrel,23-5,73,59,0,132,55.303,55.303
17,0.970,Opossum,16-23,0,0,0,0,NaN,NaN
17,0.970,Opossum,23-5,0,0,0,0,NaN,NaN
17,0.970,Cow,16-23,1564,1256,0,2820,55.461,55.461
17,0.970,Cow,23-5,1528,1684,0,3212,47.572,47.572
17,0.970,Deer Mouse,16-23,0,0,0,0,NaN,NaN
17,0.970,Deer Mouse,23-5,0,0,0,0,NaN,NaN
17,0.970,OVERALL,16-23,3659,2647,0,6306,58.024,58.024
17,0.970,OVERALL,23-5,4191,3365,0,7556,55.466,55.466
17,0.980,Chicken,16-23,0,0,0,0,NaN,NaN
17,0.980,Chicken,23-5,5,2,0,7,71.429,71.429
17,0.980,Sea Lion,16-23,0,0,0,0,NaN,NaN
17,0.980,Sea Lion,23-5,0,8,0,8,0.000,0.000
17,0.980,Hu and Cw,16-23,0,3,0,3,0.000,0.000
17,0.980,Hu and Cw,23-5,10,17,0,27,37.037,37.037
17,0.980,Sheep,16-23,48,45,0,93,51.613,51.613
17,0.980,Sheep,23-5,51,39,0,90,56.667,56.667
17,0.980,Hu and Dg,16-23,7,5,0,12,58.333,58.333
17,0.980,Hu and Dg,23-5,16,21,0,37,43.243,43.243
17,0.980,Common Loon,16-23,0,0,0,0,NaN,NaN
17,0.980,Common Loon,23-5,0,0,0,0,NaN,NaN
17,0.980,Red-Winged Blackbird,16-23,0,0,0,0,NaN,NaN
17,0.980,Red-Winged Blackbird,23-5,0,0,0,0,NaN,NaN
17,0.980,Cw,16-23,2,6,0,8,25.000,25.000
17,0.980,Cw,23-5,11,15,0,26,42.308,42.308
17,0.980,Cliff Sparrow,16-23,0,3,0,3,0.000,0.000
17,0.980,Cliff Sparrow,23-5,0,0,0,0,NaN,NaN
17,0.980,Pig,16-23,1,4,0,5,20.000,20.000
17,0.980,Pig,23-5,0,0,0,0,NaN,NaN
17,0.980,Barn Owl,16-23,0,0,0,0,NaN,NaN
17,0.980,Barn Owl,23-5,0,0,0,0,NaN,NaN
17,0.980,Wild Pig,16-23,0,0,0,0,NaN,NaN
17,0.980,Wild Pig,23-5,0,1,0,1,0.000,0.000
17,0.980,Pennington Creek Water,16-23,0,0,0,0,NaN,NaN
17,0.980,Pennington Creek Water,23-5,0,0,0,0,NaN,NaN
17,0.980,Guinni,16-23,0,0,0,0,NaN,NaN
17,0.980,Guinni,23-5,0,0,0,0,NaN,NaN
17,0.980,Racoon,16-23,0,0,0,0,NaN,NaN
17,0.980,Racoon,23-5,0,0,0,0,NaN,NaN
17,0.980,Hu,16-23,8,6,0,14,57.143,57.143
17,0.980,Hu,23-5,23,21,0,44,52.273,52.273
17,0.980,Cw and Dg,16-23,3,14,0,17,17.647,17.647
17,0.980,Cw and Dg,23-5,11,21,0,32,34.375,34.375
17,0.980,Red Wind Blackbird,16-23,0,0,0,0,NaN,NaN
17,0.980,Red Wind Blackbird,23-5,0,0,0,0,NaN,NaN
17,0.980,Tree Swallow,16-23,0,0,0,0,NaN,NaN
17,0.980,Tree Swallow,23-5,0,0,0,0,NaN,NaN
17,0.980,Turkey Vulture,16-23,0,0,0,0,NaN,NaN
17,0.980,Turkey Vulture,23-5,0,0,0,0,NaN,NaN
17,0.980,Dg,16-23,6,9,0,15,40.000,40.000
17,0.980,Dg,23-5,31,27,0,58,53.448,53.448
17,0.980,Western Kingbird,16-23,0,0,0,0,NaN,NaN
17,0.980,Western Kingbird,23-5,0,0,0,0,NaN,NaN
17,0.980,White Crowned Sparrow,16-23,0,0,0,0,NaN,NaN
17,0.980,White Crowned Sparrow,23-5,0,3,0,3,0.000,0.000
17,0.980,Eared Grebe,16-23,0,0,0,0,NaN,NaN
17,0.980,Eared Grebe,23-5,0,4,0,4,0.000,0.000
17,0.980,cougar,16-23,0,0,0,0,NaN,NaN
17,0.980,cougar,23-5,0,0,0,0,NaN,NaN
17,0.980,Ocean Water,16-23,0,0,0,0,NaN,NaN
17,0.980,Ocean Water,23-5,0,0,0,0,NaN,NaN
17,0.980,Red Tailed Hawk,16-23,0,0,0,0,NaN,NaN
17,0.980,Red Tailed Hawk,23-5,0,0,0,0,NaN,NaN
17,0.980,Dog,16-23,50,71,0,121,41.322,41.322
17,0.980,Dog,23-5,80,128,0,208,38.462,38.462
17,0.980,Human,16-23,1746,869,0,2615,66.769,66.769
17,0.980,Human,23-5,2120,774,0,2894,73.255,73.255
17,0.980,Wild Turkey,16-23,1,3,0,4,25.000,25.000
17,0.980,Wild Turkey,23-5,4,16,0,20,20.000,20.000
17,0.980,Clark Grebe,16-23,0,0,0,0,NaN,NaN
17,0.980,Clark Grebe,23-5,0,0,0,0,NaN,NaN
17,0.980,Seagull,16-23,0,0,0,0,NaN,NaN
17,0.980,Seagull,23-5,5,7,0,12,41.667,41.667
17,0.980,Surf Scoter,16-23,0,0,0,0,NaN,NaN
17,0.980,Surf Scoter,23-5,2,0,0,2,100.000,100.000
17,0.980,Pigeon,16-23,20,122,0,142,14.085,14.085
17,0.980,Pigeon,23-5,54,155,0,209,25.837,25.837
17,0.980,Pacific Ocean Water,16-23,0,0,0,0,NaN,NaN
17,0.980,Pacific Ocean Water,23-5,0,0,0,0,NaN,NaN
17,0.980,Cat,16-23,7,13,0,20,35.000,35.000
17,0.980,Cat,23-5,10,17,0,27,37.037,37.037
17,0.980,Horse,16-23,3,8,0,11,27.273,27.273
17,0.980,Horse,23-5,11,35,0,46,23.913,23.913
17,0.980,orangutan,16-23,0,0,0,0,NaN,NaN
17,0.980,orangutan,23-5,0,0,0,0,NaN,NaN
17,0.980,Bat,16-23,36,37,0,73,49.315,49.315
17,0.980,Bat,23-5,37,40,0,77,48.052,48.052
17,0.980,Deer,16-23,10,36,0,46,21.739,21.739
17,0.980,Deer,23-5,12,125,0,137,8.759,8.759
17,0.980,Great Horned Owl,16-23,0,0,0,0,NaN,NaN
17,0.980,Great Horned Owl,23-5,0,0,0,0,NaN,NaN
17,0.980,Freshwater Lagoon,16-23,0,0,0,0,NaN,NaN
17,0.980,Freshwater Lagoon,23-5,0,0,0,0,NaN,NaN
17,0.980,Unknown Avian,16-23,0,0,0,0,NaN,NaN
17,0.980,Unknown Avian,23-5,0,0,0,0,NaN,NaN
17,0.980,Human UTI,16-23,72,74,0,146,49.315,49.315
17,0.980,Human UTI,23-5,94,123,0,217,43.318,43.318
17,0.980,unknown,16-23,0,0,0,0,NaN,NaN
17,0.980,unknown,23-5,0,1,0,1,0.000,0.000
17,0.980,SLO Creek Water,16-23,0,0,0,0,NaN,NaN
17,0.980,SLO Creek Water,23-5,0,0,0,0,NaN,NaN
17,0.980,Pig/Swine,16-23,3,2,0,5,60.000,60.000
17,0.980,Pig/Swine,23-5,7,7,0,14,50.000,50.000
17,0.980,Klebsiella,16-23,0,0,0,0,NaN,NaN
17,0.980,Klebsiella,23-5,0,0,0,0,NaN,NaN
17,0.980,Hu Cw and Dg,16-23,2,7,0,9,22.222,22.222
17,0.980,Hu Cw and Dg,23-5,3,6,0,9,33.333,33.333
17,0.980,Ground Squirrel,16-23,77,45,0,122,63.115,63.115
17,0.980,Ground Squirrel,23-5,74,59,0,133,55.639,55.639
17,0.980,Opossum,16-23,0,0,0,0,NaN,NaN
17,0.980,Opossum,23-5,0,0,0,0,NaN,NaN
17,0.980,Cow,16-23,1555,1237,0,2792,55.695,55.695
17,0.980,Cow,23-5,1521,1647,0,3168,48.011,48.011
17,0.980,Deer Mouse,16-23,0,0,0,0,NaN,NaN
17,0.980,Deer Mouse,23-5,0,0,0,0,NaN,NaN
17,0.980,OVERALL,16-23,3657,2619,0,6276,58.270,58.270
17,0.980,OVERALL,23-5,4192,3319,0,7511,55.811,55.811
17,0.990,Chicken,16-23,2,6,0,8,25.000,25.000
17,0.990,Chicken,23-5,6,2,0,8,75.000,75.000
17,0.990,Sea Lion,16-23,0,0,0,0,NaN,NaN
17,0.990,Sea Lion,23-5,2,7,0,9,22.222,22.222
17,0.990,Hu and Cw,16-23,1,3,0,4,25.000,25.000
17,0.990,Hu and Cw,23-5,11,24,0,35,31.429,31.429
17,0.990,Sheep,16-23,47,47,0,94,50.000,50.000
17,0.990,Sheep,23-5,52,39,0,91,57.143,57.143
17,0.990,Hu and Dg,16-23,7,7,0,14,50.000,50.000
17,0.990,Hu and Dg,23-5,16,19,0,35,45.714,45.714
17,0.990,Common Loon,16-23,0,0,0,0,NaN,NaN
17,0.990,Common Loon,23-5,0,2,0,2,0.000,0.000
17,0.990,Red-Winged Blackbird,16-23,0,2,0,2,0.000,0.000
17,0.990,Red-Winged Blackbird,23-5,0,0,0,0,NaN,NaN
17,0.990,Cw,16-23,3,6,0,9,33.333,33.333
17,0.990,Cw,23-5,17,18,0,35,48.571,48.571
17,0.990,Cliff Sparrow,16-23,0,5,0,5,0.000,0.000
17,0.990,Cliff Sparrow,23-5,0,4,0,4,0.000,0.000
17,0.990,Pig,16-23,1,5,0,6,16.667,16.667
17,0.990,Pig,23-5,7,8,0,15,46.667,46.667
17,0.990,Barn Owl,16-23,0,0,0,0,NaN,NaN
17,0.990,Barn Owl,23-5,0,0,0,0,NaN,NaN
17,0.990,Wild Pig,16-23,0,2,0,2,0.000,0.000
17,0.990,Wild Pig,23-5,0,1,0,1,0.000,0.000
17,0.990,Pennington Creek Water,16-23,0,0,0,0,NaN,NaN
17,0.990,Pennington Creek Water,23-5,0,0,0,0,NaN,NaN
17,0.990,Guinni,16-23,0,0,0,0,NaN,NaN
17,0.990,Guinni,23-5,0,0,0,0,NaN,NaN
17,0.990,Racoon,16-23,0,0,0,0,NaN,NaN
17,0.990,Racoon,23-5,0,1,0,1,0.000,0.000
17,0.990,Hu,16-23,8,6,0,14,57.143,57.143
17,0.990,Hu,23-5,23,17,0,40,57.500,57.500
17,0.990,Cw and Dg,16-23,3,14,0,17,17.647,17.647
17,0.990,Cw and Dg,23-5,12,14,0,26,46.154,46.154
17,0.990,Red Wind Blackbird,16-23,0,0,0,0,NaN,NaN
17,0.990,Red Wind Blackbird,23-5,0,0,0,0,NaN,NaN
17,0.990,Tree Swallow,16-23,0,0,0,0,NaN,NaN
17,0.990,Tree Swallow,23-5,0,0,0,0,NaN,NaN
17,0.990,Turkey Vulture,16-23,0,0,0,0,NaN,NaN
17,0.990,Turkey Vulture,23-5,0,0,0,0,NaN,NaN
17,0.990,Dg,16-23,6,10,0,16,37.500,37.500
17,0.990,Dg,23-5,31,20,0,51,60.784,60.784
17,0.990,Western Kingbird,16-23,0,0,0,0,NaN,NaN
17,0.990,Western Kingbird,23-5,0,0,0,0,NaN,NaN
17,0.990,White Crowned Sparrow,16-23,0,0,0,0,NaN,NaN
17,0.990,White Crowned Sparrow,23-5,0,4,0,4,0.000,0.000
17,0.990,Eared Grebe,16-23,0,0,0,0,NaN,NaN
17,0.990,Eared Grebe,23-5,0,8,0,8,0.000,0.000
17,0.990,cougar,16-23,0,1,0,1,0.000,0.000
17,0.990,cougar,23-5,0,0,0,0,NaN,NaN
17,0.990,Ocean Water,16-23,0,0,0,0,NaN,NaN
17,0.990,Ocean Water,23-5,0,0,0,0,NaN,NaN
17,0.990,Red Tailed Hawk,16-23,0,0,0,0,NaN,NaN
17,0.990,Red Tailed Hawk,23-5,0,1,0,1,0.000,0.000
17,0.990,Dog,16-23,53,70,0,123,43.089,43.089
17,0.990,Dog,23-5,85,128,0,213,39.906,39.906
17,0.990,Human,16-23,1722,821,0,2543,67.715,67.715
17,0.990,Human,23-5,2106,700,0,2806,75.053,75.053
17,0.990,Wild Turkey,16-23,3,9,0,12,25.000,25.000
17,0.990,Wild Turkey,23-5,4,18,0,22,18.182,18.182
17,0.990,Clark Grebe,16-23,0,0,0,0,NaN,NaN
17,0.990,Clark Grebe,23-5,2,3,0,5,40.000,40.000
17,0.990,Seagull,16-23,0,0,0,0,NaN,NaN
17,0.990,Seagull,23-5,11,6,0,17,64.706,64.706
17,0.990,Surf Scoter,16-23,0,0,0,0,NaN,NaN
17,0.990,Surf Scoter,23-5,2,0,0,2,100.000,100.000
17,0.990,Pigeon,16-23,31,123,0,154,20.130,20.130
17,0.990,Pigeon,23-5,64,177,0,241,26.556,26.556
17,0.990,Pacific Ocean Water,16-23,0,0,0,0,NaN,NaN
17,0.990,Pacific Ocean Water,23-5,0,0,0,0,NaN,NaN
17,0.990,Cat,16-23,16,17,0,33,48.485,48.485
17,0.990,Cat,23-5,10,22,0,32,31.250,31.250
17,0.990,Horse,16-23,6,9,0,15,40.000,40.000
17,0.990,Horse,23-5,13,57,0,70,18.571,18.571
17,0.990,orangutan,16-23,0,0,0,0,NaN,NaN
17,0.990,orangutan,23-5,0,0,0,0,NaN,NaN
17,0.990,Bat,16-23,36,34,0,70,51.429,51.429
17,0.990,Bat,23-5,37,39,0,76,48.684,48.684
17,0.990,Deer,16-23,10,37,0,47,21.277,21.277
17,0.990,Deer,23-5,12,113,0,125,9.600,9.600
17,0.990,Great Horned Owl,16-23,0,0,0,0,NaN,NaN
17,0.990,Great Horned Owl,23-5,0,0,0,0,NaN,NaN
17,0.990,Freshwater Lagoon,16-23,0,0,0,0,NaN,NaN
17,0.990,Freshwater Lagoon,23-5,0,0,0,0,NaN,NaN
17,0.990,Unknown Avian,16-23,0,0,0,0,NaN,NaN
17,0.990,Unknown Avian,23-5,0,0,0,0,NaN,NaN
17,0.990,Human UTI,16-23,75,68,0,143,52.448,52.448
17,0.990,Human UTI,23-5,95,97,0,192,49.479,49.479
17,0.990,unknown,16-23,0,0,0,0,NaN,NaN
17,0.990,unknown,23-5,0,3,0,3,0.000,0.000
17,0.990,SLO Creek Water,16-23,0,0,0,0,NaN,NaN
17,0.990,SLO Creek Water,23-5,0,0,0,0,NaN,NaN
17,0.990,Pig/Swine,16-23,3,3,0,6,50.000,50.000
17,0.990,Pig/Swine,23-5,7,7,0,14,50.000,50.000
17,0.990,Klebsiella,16-23,0,0,0,0,NaN,NaN
17,0.990,Klebsiella,23-5,0,0,0,0,NaN,NaN
17,0.990,Hu Cw and Dg,16-23,2,7,0,9,22.222,22.222
17,0.990,Hu Cw and Dg,23-5,3,8,0,11,27.273,27.273
17,0.990,Ground Squirrel,16-23,80,46,0,126,63.492,63.492
17,0.990,Ground Squirrel,23-5,77,65,0,142,54.225,54.225
17,0.990,Opossum,16-23,1,0,0,1,100.000,100.000
17,0.990,Opossum,23-5,2,0,0,2,100.000,100.000
17,0.990,Cow,16-23,1523,1117,0,2640,57.689,57.689
17,0.990,Cow,23-5,1482,1484,0,2966,49.966,49.966
17,0.990,Deer Mouse,16-23,0,0,0,0,NaN,NaN
17,0.990,Deer Mouse,23-5,0,0,0,0,NaN,NaN
17,0.990,OVERALL,16-23,3639,2475,0,6114,59.519,59.519
17,0.990,OVERALL,23-5,4189,3116,0,7305,57.344,57.344
17,1.000,Chicken,16-23,0,0,0,0,NaN,NaN
17,1.000,Chicken,23-5,0,0,0,0,NaN,NaN
17,1.000,Sea Lion,16-23,0,0,0,0,NaN,NaN
17,1.000,Sea Lion,23-5,0,0,0,0,NaN,NaN
17,1.000,Hu and Cw,16-23,0,0,0,0,NaN,NaN
17,1.000,Hu and Cw,23-5,0,0,0,0,NaN,NaN
17,1.000,Sheep,16-23,0,0,0,0,NaN,NaN
17,1.000,Sheep,23-5,0,0,0,0,NaN,NaN
17,1.000,Hu and Dg,16-23,0,0,0,0,NaN,NaN
17,1.000,Hu and Dg,23-5,0,0,0,0,NaN,NaN
17,1.000,Common Loon,16-23,0,0,0,0,NaN,NaN
17,1.000,Common Loon,23-5,0,0,0,0,NaN,NaN
17,1.000,Red-Winged Blackbird,16-23,0,0,0,0,NaN,NaN
17,1.000,Red-Winged Blackbird,23-5,0,0,0,0,NaN,NaN
17,1.000,Cw,16-23,0,0,0,0,NaN,NaN
17,1.000,Cw,23-5,0,0,0,0,NaN,NaN
17,1.000,Cliff Sparrow,16-23,0,0,0,0,NaN,NaN
17,1.000,Cliff Sparrow,23-5,0,0,0,0,NaN,NaN
17,1.000,Pig,16-23,0,0,0,0,NaN,NaN
17,1.000,Pig,23-5,0,0,0,0,NaN,NaN
17,1.000,Barn Owl,16-23,0,0,0,0,NaN,NaN
17,1.000,Barn Owl,23-5,0,0,0,0,NaN,NaN
17,1.000,Wild Pig,16-23,0,0,0,0,NaN,NaN
17,1.000,Wild Pig,23-5,0,0,0,0,NaN,NaN
17,1.000,Pennington Creek Water,16-23,0,0,0,0,NaN,NaN
17,1.000,Pennington Creek Water,23-5,0,0,0,0,NaN,NaN
17,1.000,Guinni,16-23,0,0,0,0,NaN,NaN
17,1.000,Guinni,23-5,0,0,0,0,NaN,NaN
17,1.000,Racoon,16-23,0,0,0,0,NaN,NaN
17,1.000,Racoon,23-5,0,0,0,0,NaN,NaN
17,1.000,Hu,16-23,0,0,0,0,NaN,NaN
17,1.000,Hu,23-5,0,0,0,0,NaN,NaN
17,1.000,Cw and Dg,16-23,0,0,0,0,NaN,NaN
17,1.000,Cw and Dg,23-5,0,0,0,0,NaN,NaN
17,1.000,Red Wind Blackbird,16-23,0,0,0,0,NaN,NaN
17,1.000,Red Wind Blackbird,23-5,0,0,0,0,NaN,NaN
17,1.000,Tree Swallow,16-23,0,0,0,0,NaN,NaN
17,1.000,Tree Swallow,23-5,0,0,0,0,NaN,NaN
17,1.000,Turkey Vulture,16-23,0,0,0,0,NaN,NaN
17,1.000,Turkey Vulture,23-5,0,0,0,0,NaN,NaN
17,1.000,Dg,16-23,0,0,0,0,NaN,NaN
17,1.000,Dg,23-5,0,0,0,0,NaN,NaN
17,1.000,Western Kingbird,16-23,0,0,0,0,NaN,NaN
17,1.000,Western Kingbird,23-5,0,0,0,0,NaN,NaN
17,1.000,White Crowned Sparrow,16-23,0,0,0,0,NaN,NaN
17,1.000,White Crowned Sparrow,23-5,0,0,0,0,NaN,NaN
17,1.000,Eared Grebe,16-23,0,0,0,0,NaN,NaN
17,1.000,Eared Grebe,23-5,0,0,0,0,NaN,NaN
17,1.000,cougar,16-23,0,0,0,0,NaN,NaN
17,1.000,cougar,23-5,0,0,0,0,NaN,NaN
17,1.000,Ocean Water,16-23,0,0,0,0,NaN,NaN
17,1.000,Ocean Water,23-5,0,0,0,0,NaN,NaN
17,1.000,Red Tailed Hawk,16-23,0,0,0,0,NaN,NaN
17,1.000,Red Tailed Hawk,23-5,0,0,0,0,NaN,NaN
17,1.000,Dog,16-23,0,0,0,0,NaN,NaN
17,1.000,Dog,23-5,0,0,0,0,NaN,NaN
17,1.000,Human,16-23,0,0,0,0,NaN,NaN
17,1.000,Human,23-5,0,0,0,0,NaN,NaN
17,1.000,Wild Turkey,16-23,0,0,0,0,NaN,NaN
17,1.000,Wild Turkey,23-5,0,0,0,0,NaN,NaN
17,1.000,Clark Grebe,16-23,0,0,0,0,NaN,NaN
17,1.000,Clark Grebe,23-5,0,0,0,0,NaN,NaN
17,1.000,Seagull,16-23,0,0,0,0,NaN,NaN
17,1.000,Seagull,23-5,0,0,0,0,NaN,NaN
17,1.000,Surf Scoter,16-23,0,0,0,0,NaN,NaN
17,1.000,Surf Scoter,23-5,0,0,0,0,NaN,NaN
17,1.000,Pigeon,16-23,0,0,0,0,NaN,NaN
17,1.000,Pigeon,23-5,0,0,0,0,NaN,NaN
17,1.000,Pacific Ocean Water,16-23,0,0,0,0,NaN,NaN
17,1.000,Pacific Ocean Water,23-5,0,0,0,0,NaN,NaN
17,1.000,Cat,16-23,0,0,0,0,NaN,NaN
17,1.000,Cat,23-5,0,0,0,0,NaN,NaN
17,1.000,Horse,16-23,0,0,0,0,NaN,NaN
17,1.000,Horse,23-5,0,0,0,0,NaN,NaN
17,1.000,orangutan,16-23,0,0,0,0,NaN,NaN
17,1.000,orangutan,23-5,0,0,0,0,NaN,NaN
17,1.000,Bat,16-23,0,0,0,0,NaN,NaN
17,1.000,Bat,23-5,0,0,0,0,NaN,NaN
17,1.000,Deer,16-23,0,0,0,0,NaN,NaN
17,1.000,Deer,23-5,0,0,0,0,NaN,NaN
17,1.000,Great Horned Owl,16-23,0,0,0,0,NaN,NaN
17,1.000,Great Horned Owl,23-5,0,0,0,0,NaN,NaN
17,1.000,Freshwater Lagoon,16-23,0,0,0,0,NaN,NaN
17,1.000,Freshwater Lagoon,23-5,0,0,0,0,NaN,NaN
17,1.000,Unknown Avian,16-23,0,0,0,0,NaN,NaN
17,1.000,Unknown Avian,23-5,0,0,0,0,NaN,NaN
17,1.000,Human UTI,16-23,0,0,0,0,NaN,NaN
17,1.000,Human UTI,23-5,0,0,0,0,NaN,NaN
17,1.000,unknown,16-23,0,0,0,0,NaN,NaN
17,1.000,unknown,23-5,0,0,0,0,NaN,NaN
17,1.000,SLO Creek Water,16-23,0,0,0,0,NaN,NaN
17,1.000,SLO Creek Water,23-5,0,0,0,0,NaN,NaN
17,1.000,Pig/Swine,16-23,0,0,0,0,NaN,NaN
17,1.000,Pig/Swine,23-5,0,0,0,0,NaN,NaN
17,1.000,Klebsiella,16-23,0,0,0,0,NaN,NaN
17,1.000,Klebsiella,23-5,0,0,0,0,NaN,NaN
17,1.000,Hu Cw and Dg,16-23,0,0,0,0,NaN,NaN
17,1.000,Hu Cw and Dg,23-5,0,0,0,0,NaN,NaN
17,1.000,Ground Squirrel,16-23,0,0,0,0,NaN,NaN
17,1.000,Ground Squirrel,23-5,0,0,0,0,NaN,NaN
17,1.000,Opossum,16-23,0,0,0,0,NaN,NaN
17,1.000,Opossum,23-5,0,0,0,0,NaN,NaN
17,1.000,Cow,16-23,0,0,0,0,NaN,NaN
17,1.000,Cow,23-5,0,0,0,0,NaN,NaN
17,1.000,Deer Mouse,16-23,0,0,0,0,NaN,NaN
17,1.000,Deer Mouse,23-5,0,0,0,0,NaN,NaN
17,1.000,OVERALL,16-23,0,0,0,0,NaN,NaN
17,1.000,OVERALL,23-5,0,0,0,0,NaN,NaN
