k,alpha,species,applied-region,Successes (# Pyroprints),Failures (# Pyroprints),NonDecisions (# Pyroprints),Total,Decision Accuracy(\%),Overall Accuracy(\%)
1,0.000,Chicken,16-23,22,29,0,51,43.137,43.137
1,0.000,Chicken,23-5,28,10,0,38,73.684,73.684
1,0.000,Sea Lion,16-23,1,1,0,2,50.000,50.000
1,0.000,Sea Lion,23-5,4,3,0,7,57.143,57.143
1,0.000,Hu and Cw,16-23,14,26,0,40,35.000,35.000
1,0.000,Hu and Cw,23-5,15,33,0,48,31.250,31.250
1,0.000,Sheep,16-23,79,64,0,143,55.245,55.245
1,0.000,Sheep,23-5,78,30,0,108,72.222,72.222
1,0.000,Hu and Dg,16-23,16,24,0,40,40.000,40.000
1,0.000,Hu and Dg,23-5,20,15,0,35,57.143,57.143
1,0.000,Common Loon,16-23,2,0,0,2,100.000,100.000
1,0.000,Common Loon,23-5,0,4,0,4,0.000,0.000
1,0.000,Red-Winged Blackbird,16-23,2,5,0,7,28.571,28.571
1,0.000,Red-Winged Blackbird,23-5,2,4,0,6,33.333,33.333
1,0.000,Cw,16-23,17,25,0,42,40.476,40.476
1,0.000,Cw,23-5,29,55,0,84,34.524,34.524
1,0.000,Cliff Sparrow,16-23,16,27,0,43,37.209,37.209
1,0.000,Cliff Sparrow,23-5,12,18,0,30,40.000,40.000
1,0.000,Pig,16-23,22,14,0,36,61.111,61.111
1,0.000,Pig,23-5,20,16,0,36,55.556,55.556
1,0.000,Barn Owl,16-23,0,0,0,0,NaN,NaN
1,0.000,Barn Owl,23-5,2,6,0,8,25.000,25.000
1,0.000,Wild Pig,16-23,7,8,0,15,46.667,46.667
1,0.000,Wild Pig,23-5,7,5,0,12,58.333,58.333
1,0.000,Pennington Creek Water,16-23,0,0,0,0,NaN,NaN
1,0.000,Pennington Creek Water,23-5,0,0,0,0,NaN,NaN
1,0.000,Guinni,16-23,0,0,0,0,NaN,NaN
1,0.000,Guinni,23-5,0,2,0,2,0.000,0.000
1,0.000,Racoon,16-23,2,3,0,5,40.000,40.000
1,0.000,Racoon,23-5,0,4,0,4,0.000,0.000
1,0.000,Hu,16-23,27,9,0,36,75.000,75.000
1,0.000,Hu,23-5,25,13,0,38,65.789,65.789
1,0.000,Cw and Dg,16-23,15,21,0,36,41.667,41.667
1,0.000,Cw and Dg,23-5,19,29,0,48,39.583,39.583
1,0.000,Red Wind Blackbird,16-23,0,0,0,0,NaN,NaN
1,0.000,Red Wind Blackbird,23-5,0,1,0,1,0.000,0.000
1,0.000,Tree Swallow,16-23,2,6,0,8,25.000,25.000
1,0.000,Tree Swallow,23-5,2,1,0,3,66.667,66.667
1,0.000,Turkey Vulture,16-23,0,2,0,2,0.000,0.000
1,0.000,Turkey Vulture,23-5,0,2,0,2,0.000,0.000
1,0.000,Dg,16-23,11,16,0,27,40.741,40.741
1,0.000,Dg,23-5,27,10,0,37,72.973,72.973
1,0.000,Western Kingbird,16-23,0,3,0,3,0.000,0.000
1,0.000,Western Kingbird,23-5,0,0,0,0,NaN,NaN
1,0.000,White Crowned Sparrow,16-23,13,5,0,18,72.222,72.222
1,0.000,White Crowned Sparrow,23-5,8,7,0,15,53.333,53.333
1,0.000,Eared Grebe,16-23,0,0,0,0,NaN,NaN
1,0.000,Eared Grebe,23-5,2,2,0,4,50.000,50.000
1,0.000,cougar,16-23,0,1,0,1,0.000,0.000
1,0.000,cougar,23-5,0,0,0,0,NaN,NaN
1,0.000,Ocean Water,16-23,0,0,0,0,NaN,NaN
1,0.000,Ocean Water,23-5,0,0,0,0,NaN,NaN
1,0.000,Red Tailed Hawk,16-23,2,0,0,2,100.000,100.000
1,0.000,Red Tailed Hawk,23-5,0,10,0,10,0.000,0.000
1,0.000,Dog,16-23,97,72,0,169,57.396,57.396
1,0.000,Dog,23-5,157,121,0,278,56.475,56.475
1,0.000,Human,16-23,1767,359,0,2126,83.114,83.114
1,0.000,Human,23-5,2244,263,0,2507,89.509,89.509
1,0.000,Wild Turkey,16-23,18,56,0,74,24.324,24.324
1,0.000,Wild Turkey,23-5,14,66,0,80,17.500,17.500
1,0.000,Clark Grebe,16-23,0,0,0,0,NaN,NaN
1,0.000,Clark Grebe,23-5,2,4,0,6,33.333,33.333
1,0.000,Seagull,16-23,0,0,0,0,NaN,NaN
1,0.000,Seagull,23-5,55,9,0,64,85.938,85.938
1,0.000,Surf Scoter,16-23,0,0,0,0,NaN,NaN
1,0.000,Surf Scoter,23-5,2,1,0,3,66.667,66.667
1,0.000,Pigeon,16-23,153,193,0,346,44.220,44.220
1,0.000,Pigeon,23-5,196,372,0,568,34.507,34.507
1,0.000,Pacific Ocean Water,16-23,0,0,0,0,NaN,NaN
1,0.000,Pacific Ocean Water,23-5,0,0,0,0,NaN,NaN
1,0.000,Cat,16-23,41,21,0,62,66.129,66.129
1,0.000,Cat,23-5,46,25,0,71,64.789,64.789
1,0.000,Horse,16-23,21,42,0,63,33.333,33.333
1,0.000,Horse,23-5,51,237,0,288,17.708,17.708
1,0.000,orangutan,16-23,0,0,0,0,NaN,NaN
1,0.000,orangutan,23-5,0,0,0,0,NaN,NaN
1,0.000,Bat,16-23,36,7,0,43,83.721,83.721
1,0.000,Bat,23-5,37,21,0,58,63.793,63.793
1,0.000,Deer,16-23,17,13,0,30,56.667,56.667
1,0.000,Deer,23-5,18,46,0,64,28.125,28.125
1,0.000,Great Horned Owl,16-23,0,2,0,2,0.000,0.000
1,0.000,Great Horned Owl,23-5,1,9,0,10,10.000,10.000
1,0.000,Freshwater Lagoon,16-23,0,0,0,0,NaN,NaN
1,0.000,Freshwater Lagoon,23-5,0,0,0,0,NaN,NaN
1,0.000,Unknown Avian,16-23,0,2,0,2,0.000,0.000
1,0.000,Unknown Avian,23-5,0,2,0,2,0.000,0.000
1,0.000,Human UTI,16-23,115,78,0,193,59.585,59.585
1,0.000,Human UTI,23-5,129,82,0,211,61.137,61.137
1,0.000,unknown,16-23,6,8,0,14,42.857,42.857
1,0.000,unknown,23-5,8,13,0,21,38.095,38.095
1,0.000,SLO Creek Water,16-23,0,0,0,0,NaN,NaN
1,0.000,SLO Creek Water,23-5,6,1,0,7,85.714,85.714
1,0.000,Pig/Swine,16-23,13,11,0,24,54.167,54.167
1,0.000,Pig/Swine,23-5,12,9,0,21,57.143,57.143
1,0.000,Klebsiella,16-23,0,0,0,0,NaN,NaN
1,0.000,Klebsiella,23-5,0,0,0,0,NaN,NaN
1,0.000,Hu Cw and Dg,16-23,11,17,0,28,39.286,39.286
1,0.000,Hu Cw and Dg,23-5,21,20,0,41,51.220,51.220
1,0.000,Ground Squirrel,16-23,114,72,0,186,61.290,61.290
1,0.000,Ground Squirrel,23-5,116,66,0,182,63.736,63.736
1,0.000,Opossum,16-23,4,1,0,5,80.000,80.000
1,0.000,Opossum,23-5,5,8,0,13,38.462,38.462
1,0.000,Cow,16-23,1573,844,0,2417,65.081,65.081
1,0.000,Cow,23-5,1552,983,0,2535,61.223,61.223
1,0.000,Deer Mouse,16-23,0,5,0,5,0.000,0.000
1,0.000,Deer Mouse,23-5,0,0,0,0,NaN,NaN
1,0.000,OVERALL,16-23,4256,2092,0,6348,67.045,67.045
1,0.000,OVERALL,23-5,4972,2638,0,7610,65.335,65.335
1,0.500,Chicken,16-23,22,29,0,51,43.137,43.137
1,0.500,Chicken,23-5,28,10,0,38,73.684,73.684
1,0.500,Sea Lion,16-23,1,1,0,2,50.000,50.000
1,0.500,Sea Lion,23-5,4,3,0,7,57.143,57.143
1,0.500,Hu and Cw,16-23,14,26,0,40,35.000,35.000
1,0.500,Hu and Cw,23-5,15,33,0,48,31.250,31.250
1,0.500,Sheep,16-23,79,64,0,143,55.245,55.245
1,0.500,Sheep,23-5,78,30,0,108,72.222,72.222
1,0.500,Hu and Dg,16-23,16,24,0,40,40.000,40.000
1,0.500,Hu and Dg,23-5,20,15,0,35,57.143,57.143
1,0.500,Common Loon,16-23,2,0,0,2,100.000,100.000
1,0.500,Common Loon,23-5,0,4,0,4,0.000,0.000
1,0.500,Red-Winged Blackbird,16-23,2,5,0,7,28.571,28.571
1,0.500,Red-Winged Blackbird,23-5,2,4,0,6,33.333,33.333
1,0.500,Cw,16-23,17,25,0,42,40.476,40.476
1,0.500,Cw,23-5,29,55,0,84,34.524,34.524
1,0.500,Cliff Sparrow,16-23,16,27,0,43,37.209,37.209
1,0.500,Cliff Sparrow,23-5,12,18,0,30,40.000,40.000
1,0.500,Pig,16-23,22,14,0,36,61.111,61.111
1,0.500,Pig,23-5,20,16,0,36,55.556,55.556
1,0.500,Barn Owl,16-23,0,0,0,0,NaN,NaN
1,0.500,Barn Owl,23-5,2,6,0,8,25.000,25.000
1,0.500,Wild Pig,16-23,7,8,0,15,46.667,46.667
1,0.500,Wild Pig,23-5,7,5,0,12,58.333,58.333
1,0.500,Pennington Creek Water,16-23,0,0,0,0,NaN,NaN
1,0.500,Pennington Creek Water,23-5,0,0,0,0,NaN,NaN
1,0.500,Guinni,16-23,0,0,0,0,NaN,NaN
1,0.500,Guinni,23-5,0,2,0,2,0.000,0.000
1,0.500,Racoon,16-23,2,3,0,5,40.000,40.000
1,0.500,Racoon,23-5,0,4,0,4,0.000,0.000
1,0.500,Hu,16-23,27,9,0,36,75.000,75.000
1,0.500,Hu,23-5,25,13,0,38,65.789,65.789
1,0.500,Cw and Dg,16-23,15,21,0,36,41.667,41.667
1,0.500,Cw and Dg,23-5,19,29,0,48,39.583,39.583
1,0.500,Red Wind Blackbird,16-23,0,0,0,0,NaN,NaN
1,0.500,Red Wind Blackbird,23-5,0,1,0,1,0.000,0.000
1,0.500,Tree Swallow,16-23,2,6,0,8,25.000,25.000
1,0.500,Tree Swallow,23-5,2,1,0,3,66.667,66.667
1,0.500,Turkey Vulture,16-23,0,2,0,2,0.000,0.000
1,0.500,Turkey Vulture,23-5,0,2,0,2,0.000,0.000
1,0.500,Dg,16-23,11,16,0,27,40.741,40.741
1,0.500,Dg,23-5,27,10,0,37,72.973,72.973
1,0.500,Western Kingbird,16-23,0,3,0,3,0.000,0.000
1,0.500,Western Kingbird,23-5,0,0,0,0,NaN,NaN
1,0.500,White Crowned Sparrow,16-23,13,5,0,18,72.222,72.222
1,0.500,White Crowned Sparrow,23-5,8,7,0,15,53.333,53.333
1,0.500,Eared Grebe,16-23,0,0,0,0,NaN,NaN
1,0.500,Eared Grebe,23-5,2,2,0,4,50.000,50.000
1,0.500,cougar,16-23,0,1,0,1,0.000,0.000
1,0.500,cougar,23-5,0,0,0,0,NaN,NaN
1,0.500,Ocean Water,16-23,0,0,0,0,NaN,NaN
1,0.500,Ocean Water,23-5,0,0,0,0,NaN,NaN
1,0.500,Red Tailed Hawk,16-23,2,0,0,2,100.000,100.000
1,0.500,Red Tailed Hawk,23-5,0,10,0,10,0.000,0.000
1,0.500,Dog,16-23,97,72,0,169,57.396,57.396
1,0.500,Dog,23-5,157,121,0,278,56.475,56.475
1,0.500,Human,16-23,1767,359,0,2126,83.114,83.114
1,0.500,Human,23-5,2244,263,0,2507,89.509,89.509
1,0.500,Wild Turkey,16-23,18,56,0,74,24.324,24.324
1,0.500,Wild Turkey,23-5,14,66,0,80,17.500,17.500
1,0.500,Clark Grebe,16-23,0,0,0,0,NaN,NaN
1,0.500,Clark Grebe,23-5,2,4,0,6,33.333,33.333
1,0.500,Seagull,16-23,0,0,0,0,NaN,NaN
1,0.500,Seagull,23-5,55,9,0,64,85.938,85.938
1,0.500,Surf Scoter,16-23,0,0,0,0,NaN,NaN
1,0.500,Surf Scoter,23-5,2,1,0,3,66.667,66.667
1,0.500,Pigeon,16-23,153,193,0,346,44.220,44.220
1,0.500,Pigeon,23-5,196,372,0,568,34.507,34.507
1,0.500,Pacific Ocean Water,16-23,0,0,0,0,NaN,NaN
1,0.500,Pacific Ocean Water,23-5,0,0,0,0,NaN,NaN
1,0.500,Cat,16-23,41,21,0,62,66.129,66.129
1,0.500,Cat,23-5,46,25,0,71,64.789,64.789
1,0.500,Horse,16-23,21,42,0,63,33.333,33.333
1,0.500,Horse,23-5,51,237,0,288,17.708,17.708
1,0.500,orangutan,16-23,0,0,0,0,NaN,NaN
1,0.500,orangutan,23-5,0,0,0,0,NaN,NaN
1,0.500,Bat,16-23,36,7,0,43,83.721,83.721
1,0.500,Bat,23-5,37,21,0,58,63.793,63.793
1,0.500,Deer,16-23,17,13,0,30,56.667,56.667
1,0.500,Deer,23-5,18,46,0,64,28.125,28.125
1,0.500,Great Horned Owl,16-23,0,2,0,2,0.000,0.000
1,0.500,Great Horned Owl,23-5,1,9,0,10,10.000,10.000
1,0.500,Freshwater Lagoon,16-23,0,0,0,0,NaN,NaN
1,0.500,Freshwater Lagoon,23-5,0,0,0,0,NaN,NaN
1,0.500,Unknown Avian,16-23,0,2,0,2,0.000,0.000
1,0.500,Unknown Avian,23-5,0,2,0,2,0.000,0.000
1,0.500,Human UTI,16-23,115,78,0,193,59.585,59.585
1,0.500,Human UTI,23-5,129,82,0,211,61.137,61.137
1,0.500,unknown,16-23,6,8,0,14,42.857,42.857
1,0.500,unknown,23-5,8,13,0,21,38.095,38.095
1,0.500,SLO Creek Water,16-23,0,0,0,0,NaN,NaN
1,0.500,SLO Creek Water,23-5,6,1,0,7,85.714,85.714
1,0.500,Pig/Swine,16-23,13,11,0,24,54.167,54.167
1,0.500,Pig/Swine,23-5,12,9,0,21,57.143,57.143
1,0.500,Klebsiella,16-23,0,0,0,0,NaN,NaN
1,0.500,Klebsiella,23-5,0,0,0,0,NaN,NaN
1,0.500,Hu Cw and Dg,16-23,11,17,0,28,39.286,39.286
1,0.500,Hu Cw and Dg,23-5,21,20,0,41,51.220,51.220
1,0.500,Ground Squirrel,16-23,114,72,0,186,61.290,61.290
1,0.500,Ground Squirrel,23-5,116,66,0,182,63.736,63.736
1,0.500,Opossum,16-23,4,1,0,5,80.000,80.000
1,0.500,Opossum,23-5,5,8,0,13,38.462,38.462
1,0.500,Cow,16-23,1573,844,0,2417,65.081,65.081
1,0.500,Cow,23-5,1552,983,0,2535,61.223,61.223
1,0.500,Deer Mouse,16-23,0,5,0,5,0.000,0.000
1,0.500,Deer Mouse,23-5,0,0,0,0,NaN,NaN
1,0.500,OVERALL,16-23,4256,2092,0,6348,67.045,67.045
1,0.500,OVERALL,23-5,4972,2638,0,7610,65.335,65.335
1,0.900,Chicken,16-23,22,29,0,51,43.137,43.137
1,0.900,Chicken,23-5,28,10,0,38,73.684,73.684
1,0.900,Sea Lion,16-23,1,1,0,2,50.000,50.000
1,0.900,Sea Lion,23-5,4,3,0,7,57.143,57.143
1,0.900,Hu and Cw,16-23,14,26,0,40,35.000,35.000
1,0.900,Hu and Cw,23-5,15,33,0,48,31.250,31.250
1,0.900,Sheep,16-23,79,64,0,143,55.245,55.245
1,0.900,Sheep,23-5,78,30,0,108,72.222,72.222
1,0.900,Hu and Dg,16-23,16,24,0,40,40.000,40.000
1,0.900,Hu and Dg,23-5,20,15,0,35,57.143,57.143
1,0.900,Common Loon,16-23,2,0,0,2,100.000,100.000
1,0.900,Common Loon,23-5,0,4,0,4,0.000,0.000
1,0.900,Red-Winged Blackbird,16-23,2,5,0,7,28.571,28.571
1,0.900,Red-Winged Blackbird,23-5,2,4,0,6,33.333,33.333
1,0.900,Cw,16-23,17,25,0,42,40.476,40.476
1,0.900,Cw,23-5,29,55,0,84,34.524,34.524
1,0.900,Cliff Sparrow,16-23,16,27,0,43,37.209,37.209
1,0.900,Cliff Sparrow,23-5,12,18,0,30,40.000,40.000
1,0.900,Pig,16-23,22,14,0,36,61.111,61.111
1,0.900,Pig,23-5,20,16,0,36,55.556,55.556
1,0.900,Barn Owl,16-23,0,0,0,0,NaN,NaN
1,0.900,Barn Owl,23-5,2,6,0,8,25.000,25.000
1,0.900,Wild Pig,16-23,7,8,0,15,46.667,46.667
1,0.900,Wild Pig,23-5,7,5,0,12,58.333,58.333
1,0.900,Pennington Creek Water,16-23,0,0,0,0,NaN,NaN
1,0.900,Pennington Creek Water,23-5,0,0,0,0,NaN,NaN
1,0.900,Guinni,16-23,0,0,0,0,NaN,NaN
1,0.900,Guinni,23-5,0,2,0,2,0.000,0.000
1,0.900,Racoon,16-23,2,3,0,5,40.000,40.000
1,0.900,Racoon,23-5,0,4,0,4,0.000,0.000
1,0.900,Hu,16-23,27,9,0,36,75.000,75.000
1,0.900,Hu,23-5,25,13,0,38,65.789,65.789
1,0.900,Cw and Dg,16-23,15,21,0,36,41.667,41.667
1,0.900,Cw and Dg,23-5,19,29,0,48,39.583,39.583
1,0.900,Red Wind Blackbird,16-23,0,0,0,0,NaN,NaN
1,0.900,Red Wind Blackbird,23-5,0,1,0,1,0.000,0.000
1,0.900,Tree Swallow,16-23,2,6,0,8,25.000,25.000
1,0.900,Tree Swallow,23-5,2,1,0,3,66.667,66.667
1,0.900,Turkey Vulture,16-23,0,2,0,2,0.000,0.000
1,0.900,Turkey Vulture,23-5,0,2,0,2,0.000,0.000
1,0.900,Dg,16-23,11,16,0,27,40.741,40.741
1,0.900,Dg,23-5,27,10,0,37,72.973,72.973
1,0.900,Western Kingbird,16-23,0,3,0,3,0.000,0.000
1,0.900,Western Kingbird,23-5,0,0,0,0,NaN,NaN
1,0.900,White Crowned Sparrow,16-23,13,5,0,18,72.222,72.222
1,0.900,White Crowned Sparrow,23-5,8,7,0,15,53.333,53.333
1,0.900,Eared Grebe,16-23,0,0,0,0,NaN,NaN
1,0.900,Eared Grebe,23-5,2,2,0,4,50.000,50.000
1,0.900,cougar,16-23,0,1,0,1,0.000,0.000
1,0.900,cougar,23-5,0,0,0,0,NaN,NaN
1,0.900,Ocean Water,16-23,0,0,0,0,NaN,NaN
1,0.900,Ocean Water,23-5,0,0,0,0,NaN,NaN
1,0.900,Red Tailed Hawk,16-23,2,0,0,2,100.000,100.000
1,0.900,Red Tailed Hawk,23-5,0,10,0,10,0.000,0.000
1,0.900,Dog,16-23,97,72,0,169,57.396,57.396
1,0.900,Dog,23-5,157,119,0,276,56.884,56.884
1,0.900,Human,16-23,1767,357,0,2124,83.192,83.192
1,0.900,Human,23-5,2244,261,0,2505,89.581,89.581
1,0.900,Wild Turkey,16-23,18,56,0,74,24.324,24.324
1,0.900,Wild Turkey,23-5,14,66,0,80,17.500,17.500
1,0.900,Clark Grebe,16-23,0,0,0,0,NaN,NaN
1,0.900,Clark Grebe,23-5,2,3,0,5,40.000,40.000
1,0.900,Seagull,16-23,0,0,0,0,NaN,NaN
1,0.900,Seagull,23-5,55,9,0,64,85.938,85.938
1,0.900,Surf Scoter,16-23,0,0,0,0,NaN,NaN
1,0.900,Surf Scoter,23-5,2,1,0,3,66.667,66.667
1,0.900,Pigeon,16-23,153,193,0,346,44.220,44.220
1,0.900,Pigeon,23-5,196,372,0,568,34.507,34.507
1,0.900,Pacific Ocean Water,16-23,0,0,0,0,NaN,NaN
1,0.900,Pacific Ocean Water,23-5,0,0,0,0,NaN,NaN
1,0.900,Cat,16-23,41,21,0,62,66.129,66.129
1,0.900,Cat,23-5,46,25,0,71,64.789,64.789
1,0.900,Horse,16-23,21,42,0,63,33.333,33.333
1,0.900,Horse,23-5,51,237,0,288,17.708,17.708
1,0.900,orangutan,16-23,0,0,0,0,NaN,NaN
1,0.900,orangutan,23-5,0,0,0,0,NaN,NaN
1,0.900,Bat,16-23,36,7,0,43,83.721,83.721
1,0.900,Bat,23-5,37,21,0,58,63.793,63.793
1,0.900,Deer,16-23,17,13,0,30,56.667,56.667
1,0.900,Deer,23-5,18,46,0,64,28.125,28.125
1,0.900,Great Horned Owl,16-23,0,2,0,2,0.000,0.000
1,0.900,Great Horned Owl,23-5,1,9,0,10,10.000,10.000
1,0.900,Freshwater Lagoon,16-23,0,0,0,0,NaN,NaN
1,0.900,Freshwater Lagoon,23-5,0,0,0,0,NaN,NaN
1,0.900,Unknown Avian,16-23,0,2,0,2,0.000,0.000
1,0.900,Unknown Avian,23-5,0,2,0,2,0.000,0.000
1,0.900,Human UTI,16-23,115,78,0,193,59.585,59.585
1,0.900,Human UTI,23-5,129,82,0,211,61.137,61.137
1,0.900,unknown,16-23,6,8,0,14,42.857,42.857
1,0.900,unknown,23-5,8,13,0,21,38.095,38.095
1,0.900,SLO Creek Water,16-23,0,0,0,0,NaN,NaN
1,0.900,SLO Creek Water,23-5,6,1,0,7,85.714,85.714
1,0.900,Pig/Swine,16-23,13,11,0,24,54.167,54.167
1,0.900,Pig/Swine,23-5,12,9,0,21,57.143,57.143
1,0.900,Klebsiella,16-23,0,0,0,0,NaN,NaN
1,0.900,Klebsiella,23-5,0,0,0,0,NaN,NaN
1,0.900,Hu Cw and Dg,16-23,11,17,0,28,39.286,39.286
1,0.900,Hu Cw and Dg,23-5,21,20,0,41,51.220,51.220
1,0.900,Ground Squirrel,16-23,114,72,0,186,61.290,61.290
1,0.900,Ground Squirrel,23-5,116,66,0,182,63.736,63.736
1,0.900,Opossum,16-23,4,1,0,5,80.000,80.000
1,0.900,Opossum,23-5,5,8,0,13,38.462,38.462
1,0.900,Cow,16-23,1573,842,0,2415,65.135,65.135
1,0.900,Cow,23-5,1552,980,0,2532,61.295,61.295
1,0.900,Deer Mouse,16-23,0,5,0,5,0.000,0.000
1,0.900,Deer Mouse,23-5,0,0,0,0,NaN,NaN
1,0.900,OVERALL,16-23,4256,2088,0,6344,67.087,67.087
1,0.900,OVERALL,23-5,4972,2630,0,7602,65.404,65.404
1,0.950,Chicken,16-23,22,29,0,51,43.137,43.137
1,0.950,Chicken,23-5,28,10,0,38,73.684,73.684
1,0.950,Sea Lion,16-23,1,1,0,2,50.000,50.000
1,0.950,Sea Lion,23-5,4,3,0,7,57.143,57.143
1,0.950,Hu and Cw,16-23,14,26,0,40,35.000,35.000
1,0.950,Hu and Cw,23-5,15,33,0,48,31.250,31.250
1,0.950,Sheep,16-23,79,64,0,143,55.245,55.245
1,0.950,Sheep,23-5,78,30,0,108,72.222,72.222
1,0.950,Hu and Dg,16-23,16,24,0,40,40.000,40.000
1,0.950,Hu and Dg,23-5,20,15,0,35,57.143,57.143
1,0.950,Common Loon,16-23,2,0,0,2,100.000,100.000
1,0.950,Common Loon,23-5,0,4,0,4,0.000,0.000
1,0.950,Red-Winged Blackbird,16-23,2,5,0,7,28.571,28.571
1,0.950,Red-Winged Blackbird,23-5,2,4,0,6,33.333,33.333
1,0.950,Cw,16-23,17,25,0,42,40.476,40.476
1,0.950,Cw,23-5,29,55,0,84,34.524,34.524
1,0.950,Cliff Sparrow,16-23,16,27,0,43,37.209,37.209
1,0.950,Cliff Sparrow,23-5,12,18,0,30,40.000,40.000
1,0.950,Pig,16-23,22,14,0,36,61.111,61.111
1,0.950,Pig,23-5,20,16,0,36,55.556,55.556
1,0.950,Barn Owl,16-23,0,0,0,0,NaN,NaN
1,0.950,Barn Owl,23-5,2,6,0,8,25.000,25.000
1,0.950,Wild Pig,16-23,7,8,0,15,46.667,46.667
1,0.950,Wild Pig,23-5,7,4,0,11,63.636,63.636
1,0.950,Pennington Creek Water,16-23,0,0,0,0,NaN,NaN
1,0.950,Pennington Creek Water,23-5,0,0,0,0,NaN,NaN
1,0.950,Guinni,16-23,0,0,0,0,NaN,NaN
1,0.950,Guinni,23-5,0,2,0,2,0.000,0.000
1,0.950,Racoon,16-23,2,3,0,5,40.000,40.000
1,0.950,Racoon,23-5,0,4,0,4,0.000,0.000
1,0.950,Hu,16-23,27,9,0,36,75.000,75.000
1,0.950,Hu,23-5,25,13,0,38,65.789,65.789
1,0.950,Cw and Dg,16-23,15,21,0,36,41.667,41.667
1,0.950,Cw and Dg,23-5,18,29,0,47,38.298,38.298
1,0.950,Red Wind Blackbird,16-23,0,0,0,0,NaN,NaN
1,0.950,Red Wind Blackbird,23-5,0,1,0,1,0.000,0.000
1,0.950,Tree Swallow,16-23,2,6,0,8,25.000,25.000
1,0.950,Tree Swallow,23-5,2,1,0,3,66.667,66.667
1,0.950,Turkey Vulture,16-23,0,2,0,2,0.000,0.000
1,0.950,Turkey Vulture,23-5,0,2,0,2,0.000,0.000
1,0.950,Dg,16-23,11,16,0,27,40.741,40.741
1,0.950,Dg,23-5,27,10,0,37,72.973,72.973
1,0.950,Western Kingbird,16-23,0,3,0,3,0.000,0.000
1,0.950,Western Kingbird,23-5,0,0,0,0,NaN,NaN
1,0.950,White Crowned Sparrow,16-23,13,5,0,18,72.222,72.222
1,0.950,White Crowned Sparrow,23-5,8,7,0,15,53.333,53.333
1,0.950,Eared Grebe,16-23,0,0,0,0,NaN,NaN
1,0.950,Eared Grebe,23-5,2,2,0,4,50.000,50.000
1,0.950,cougar,16-23,0,1,0,1,0.000,0.000
1,0.950,cougar,23-5,0,0,0,0,NaN,NaN
1,0.950,Ocean Water,16-23,0,0,0,0,NaN,NaN
1,0.950,Ocean Water,23-5,0,0,0,0,NaN,NaN
1,0.950,Red Tailed Hawk,16-23,2,0,0,2,100.000,100.000
1,0.950,Red Tailed Hawk,23-5,0,10,0,10,0.000,0.000
1,0.950,Dog,16-23,97,72,0,169,57.396,57.396
1,0.950,Dog,23-5,157,119,0,276,56.884,56.884
1,0.950,Human,16-23,1767,355,0,2122,83.270,83.270
1,0.950,Human,23-5,2244,258,0,2502,89.688,89.688
1,0.950,Wild Turkey,16-23,18,56,0,74,24.324,24.324
1,0.950,Wild Turkey,23-5,14,66,0,80,17.500,17.500
1,0.950,Clark Grebe,16-23,0,0,0,0,NaN,NaN
1,0.950,Clark Grebe,23-5,2,3,0,5,40.000,40.000
1,0.950,Seagull,16-23,0,0,0,0,NaN,NaN
1,0.950,Seagull,23-5,55,8,0,63,87.302,87.302
1,0.950,Surf Scoter,16-23,0,0,0,0,NaN,NaN
1,0.950,Surf Scoter,23-5,2,0,0,2,100.000,100.000
1,0.950,Pigeon,16-23,153,193,0,346,44.220,44.220
1,0.950,Pigeon,23-5,196,372,0,568,34.507,34.507
1,0.950,Pacific Ocean Water,16-23,0,0,0,0,NaN,NaN
1,0.950,Pacific Ocean Water,23-5,0,0,0,0,NaN,NaN
1,0.950,Cat,16-23,41,21,0,62,66.129,66.129
1,0.950,Cat,23-5,46,25,0,71,64.789,64.789
1,0.950,Horse,16-23,21,42,0,63,33.333,33.333
1,0.950,Horse,23-5,51,237,0,288,17.708,17.708
1,0.950,orangutan,16-23,0,0,0,0,NaN,NaN
1,0.950,orangutan,23-5,0,0,0,0,NaN,NaN
1,0.950,Bat,16-23,36,7,0,43,83.721,83.721
1,0.950,Bat,23-5,37,18,0,55,67.273,67.273
1,0.950,Deer,16-23,17,13,0,30,56.667,56.667
1,0.950,Deer,23-5,18,46,0,64,28.125,28.125
1,0.950,Great Horned Owl,16-23,0,2,0,2,0.000,0.000
1,0.950,Great Horned Owl,23-5,1,9,0,10,10.000,10.000
1,0.950,Freshwater Lagoon,16-23,0,0,0,0,NaN,NaN
1,0.950,Freshwater Lagoon,23-5,0,0,0,0,NaN,NaN
1,0.950,Unknown Avian,16-23,0,2,0,2,0.000,0.000
1,0.950,Unknown Avian,23-5,0,2,0,2,0.000,0.000
1,0.950,Human UTI,16-23,115,78,0,193,59.585,59.585
1,0.950,Human UTI,23-5,128,82,0,210,60.952,60.952
1,0.950,unknown,16-23,6,8,0,14,42.857,42.857
1,0.950,unknown,23-5,8,13,0,21,38.095,38.095
1,0.950,SLO Creek Water,16-23,0,0,0,0,NaN,NaN
1,0.950,SLO Creek Water,23-5,6,1,0,7,85.714,85.714
1,0.950,Pig/Swine,16-23,13,11,0,24,54.167,54.167
1,0.950,Pig/Swine,23-5,12,8,0,20,60.000,60.000
1,0.950,Klebsiella,16-23,0,0,0,0,NaN,NaN
1,0.950,Klebsiella,23-5,0,0,0,0,NaN,NaN
1,0.950,Hu Cw and Dg,16-23,11,17,0,28,39.286,39.286
1,0.950,Hu Cw and Dg,23-5,21,20,0,41,51.220,51.220
1,0.950,Ground Squirrel,16-23,114,72,0,186,61.290,61.290
1,0.950,Ground Squirrel,23-5,116,66,0,182,63.736,63.736
1,0.950,Opossum,16-23,4,1,0,5,80.000,80.000
1,0.950,Opossum,23-5,5,8,0,13,38.462,38.462
1,0.950,Cow,16-23,1573,827,0,2400,65.542,65.542
1,0.950,Cow,23-5,1552,980,0,2532,61.295,61.295
1,0.950,Deer Mouse,16-23,0,5,0,5,0.000,0.000
1,0.950,Deer Mouse,23-5,0,0,0,0,NaN,NaN
1,0.950,OVERALL,16-23,4256,2071,0,6327,67.267,67.267
1,0.950,OVERALL,23-5,4970,2620,0,7590,65.481,65.481
1,0.960,Chicken,16-23,22,29,0,51,43.137,43.137
1,0.960,Chicken,23-5,28,10,0,38,73.684,73.684
1,0.960,Sea Lion,16-23,1,1,0,2,50.000,50.000
1,0.960,Sea Lion,23-5,4,3,0,7,57.143,57.143
1,0.960,Hu and Cw,16-23,14,26,0,40,35.000,35.000
1,0.960,Hu and Cw,23-5,15,33,0,48,31.250,31.250
1,0.960,Sheep,16-23,79,64,0,143,55.245,55.245
1,0.960,Sheep,23-5,78,30,0,108,72.222,72.222
1,0.960,Hu and Dg,16-23,16,24,0,40,40.000,40.000
1,0.960,Hu and Dg,23-5,20,15,0,35,57.143,57.143
1,0.960,Common Loon,16-23,2,0,0,2,100.000,100.000
1,0.960,Common Loon,23-5,0,4,0,4,0.000,0.000
1,0.960,Red-Winged Blackbird,16-23,2,5,0,7,28.571,28.571
1,0.960,Red-Winged Blackbird,23-5,2,4,0,6,33.333,33.333
1,0.960,Cw,16-23,17,25,0,42,40.476,40.476
1,0.960,Cw,23-5,29,55,0,84,34.524,34.524
1,0.960,Cliff Sparrow,16-23,16,27,0,43,37.209,37.209
1,0.960,Cliff Sparrow,23-5,12,18,0,30,40.000,40.000
1,0.960,Pig,16-23,22,14,0,36,61.111,61.111
1,0.960,Pig,23-5,20,16,0,36,55.556,55.556
1,0.960,Barn Owl,16-23,0,0,0,0,NaN,NaN
1,0.960,Barn Owl,23-5,2,6,0,8,25.000,25.000
1,0.960,Wild Pig,16-23,7,8,0,15,46.667,46.667
1,0.960,Wild Pig,23-5,7,4,0,11,63.636,63.636
1,0.960,Pennington Creek Water,16-23,0,0,0,0,NaN,NaN
1,0.960,Pennington Creek Water,23-5,0,0,0,0,NaN,NaN
1,0.960,Guinni,16-23,0,0,0,0,NaN,NaN
1,0.960,Guinni,23-5,0,2,0,2,0.000,0.000
1,0.960,Racoon,16-23,2,3,0,5,40.000,40.000
1,0.960,Racoon,23-5,0,4,0,4,0.000,0.000
1,0.960,Hu,16-23,27,9,0,36,75.000,75.000
1,0.960,Hu,23-5,25,13,0,38,65.789,65.789
1,0.960,Cw and Dg,16-23,15,21,0,36,41.667,41.667
1,0.960,Cw and Dg,23-5,18,29,0,47,38.298,38.298
1,0.960,Red Wind Blackbird,16-23,0,0,0,0,NaN,NaN
1,0.960,Red Wind Blackbird,23-5,0,1,0,1,0.000,0.000
1,0.960,Tree Swallow,16-23,2,6,0,8,25.000,25.000
1,0.960,Tree Swallow,23-5,2,1,0,3,66.667,66.667
1,0.960,Turkey Vulture,16-23,0,2,0,2,0.000,0.000
1,0.960,Turkey Vulture,23-5,0,2,0,2,0.000,0.000
1,0.960,Dg,16-23,11,16,0,27,40.741,40.741
1,0.960,Dg,23-5,27,10,0,37,72.973,72.973
1,0.960,Western Kingbird,16-23,0,3,0,3,0.000,0.000
1,0.960,Western Kingbird,23-5,0,0,0,0,NaN,NaN
1,0.960,White Crowned Sparrow,16-23,13,5,0,18,72.222,72.222
1,0.960,White Crowned Sparrow,23-5,8,7,0,15,53.333,53.333
1,0.960,Eared Grebe,16-23,0,0,0,0,NaN,NaN
1,0.960,Eared Grebe,23-5,2,2,0,4,50.000,50.000
1,0.960,cougar,16-23,0,1,0,1,0.000,0.000
1,0.960,cougar,23-5,0,0,0,0,NaN,NaN
1,0.960,Ocean Water,16-23,0,0,0,0,NaN,NaN
1,0.960,Ocean Water,23-5,0,0,0,0,NaN,NaN
1,0.960,Red Tailed Hawk,16-23,2,0,0,2,100.000,100.000
1,0.960,Red Tailed Hawk,23-5,0,10,0,10,0.000,0.000
1,0.960,Dog,16-23,97,72,0,169,57.396,57.396
1,0.960,Dog,23-5,157,119,0,276,56.884,56.884
1,0.960,Human,16-23,1767,353,0,2120,83.349,83.349
1,0.960,Human,23-5,2244,252,0,2496,89.904,89.904
1,0.960,Wild Turkey,16-23,18,56,0,74,24.324,24.324
1,0.960,Wild Turkey,23-5,14,66,0,80,17.500,17.500
1,0.960,Clark Grebe,16-23,0,0,0,0,NaN,NaN
1,0.960,Clark Grebe,23-5,2,3,0,5,40.000,40.000
1,0.960,Seagull,16-23,0,0,0,0,NaN,NaN
1,0.960,Seagull,23-5,55,8,0,63,87.302,87.302
1,0.960,Surf Scoter,16-23,0,0,0,0,NaN,NaN
1,0.960,Surf Scoter,23-5,2,0,0,2,100.000,100.000
1,0.960,Pigeon,16-23,153,193,0,346,44.220,44.220
1,0.960,Pigeon,23-5,196,372,0,568,34.507,34.507
1,0.960,Pacific Ocean Water,16-23,0,0,0,0,NaN,NaN
1,0.960,Pacific Ocean Water,23-5,0,0,0,0,NaN,NaN
1,0.960,Cat,16-23,41,21,0,62,66.129,66.129
1,0.960,Cat,23-5,46,25,0,71,64.789,64.789
1,0.960,Horse,16-23,21,42,0,63,33.333,33.333
1,0.960,Horse,23-5,51,237,0,288,17.708,17.708
1,0.960,orangutan,16-23,0,0,0,0,NaN,NaN
1,0.960,orangutan,23-5,0,0,0,0,NaN,NaN
1,0.960,Bat,16-23,36,7,0,43,83.721,83.721
1,0.960,Bat,23-5,37,16,0,53,69.811,69.811
1,0.960,Deer,16-23,17,13,0,30,56.667,56.667
1,0.960,Deer,23-5,18,46,0,64,28.125,28.125
1,0.960,Great Horned Owl,16-23,0,2,0,2,0.000,0.000
1,0.960,Great Horned Owl,23-5,1,9,0,10,10.000,10.000
1,0.960,Freshwater Lagoon,16-23,0,0,0,0,NaN,NaN
1,0.960,Freshwater Lagoon,23-5,0,0,0,0,NaN,NaN
1,0.960,Unknown Avian,16-23,0,2,0,2,0.000,0.000
1,0.960,Unknown Avian,23-5,0,2,0,2,0.000,0.000
1,0.960,Human UTI,16-23,115,78,0,193,59.585,59.585
1,0.960,Human UTI,23-5,128,82,0,210,60.952,60.952
1,0.960,unknown,16-23,6,8,0,14,42.857,42.857
1,0.960,unknown,23-5,8,13,0,21,38.095,38.095
1,0.960,SLO Creek Water,16-23,0,0,0,0,NaN,NaN
1,0.960,SLO Creek Water,23-5,6,1,0,7,85.714,85.714
1,0.960,Pig/Swine,16-23,13,11,0,24,54.167,54.167
1,0.960,Pig/Swine,23-5,12,7,0,19,63.158,63.158
1,0.960,Klebsiella,16-23,0,0,0,0,NaN,NaN
1,0.960,Klebsiella,23-5,0,0,0,0,NaN,NaN
1,0.960,Hu Cw and Dg,16-23,11,17,0,28,39.286,39.286
1,0.960,Hu Cw and Dg,23-5,21,20,0,41,51.220,51.220
1,0.960,Ground Squirrel,16-23,114,72,0,186,61.290,61.290
1,0.960,Ground Squirrel,23-5,116,66,0,182,63.736,63.736
1,0.960,Opossum,16-23,4,1,0,5,80.000,80.000
1,0.960,Opossum,23-5,5,8,0,13,38.462,38.462
1,0.960,Cow,16-23,1571,820,0,2391,65.705,65.705
1,0.960,Cow,23-5,1552,979,0,2531,61.320,61.320
1,0.960,Deer Mouse,16-23,0,5,0,5,0.000,0.000
1,0.960,Deer Mouse,23-5,0,0,0,0,NaN,NaN
1,0.960,OVERALL,16-23,4254,2062,0,6316,67.353,67.353
1,0.960,OVERALL,23-5,4970,2610,0,7580,65.567,65.567
1,0.970,Chicken,16-23,22,29,0,51,43.137,43.137
1,0.970,Chicken,23-5,28,10,0,38,73.684,73.684
1,0.970,Sea Lion,16-23,1,1,0,2,50.000,50.000
1,0.970,Sea Lion,23-5,4,3,0,7,57.143,57.143
1,0.970,Hu and Cw,16-23,14,26,0,40,35.000,35.000
1,0.970,Hu and Cw,23-5,15,33,0,48,31.250,31.250
1,0.970,Sheep,16-23,79,64,0,143,55.245,55.245
1,0.970,Sheep,23-5,78,30,0,108,72.222,72.222
1,0.970,Hu and Dg,16-23,16,24,0,40,40.000,40.000
1,0.970,Hu and Dg,23-5,20,15,0,35,57.143,57.143
1,0.970,Common Loon,16-23,2,0,0,2,100.000,100.000
1,0.970,Common Loon,23-5,0,4,0,4,0.000,0.000
1,0.970,Red-Winged Blackbird,16-23,2,5,0,7,28.571,28.571
1,0.970,Red-Winged Blackbird,23-5,2,4,0,6,33.333,33.333
1,0.970,Cw,16-23,17,25,0,42,40.476,40.476
1,0.970,Cw,23-5,29,55,0,84,34.524,34.524
1,0.970,Cliff Sparrow,16-23,16,27,0,43,37.209,37.209
1,0.970,Cliff Sparrow,23-5,12,18,0,30,40.000,40.000
1,0.970,Pig,16-23,22,14,0,36,61.111,61.111
1,0.970,Pig,23-5,20,16,0,36,55.556,55.556
1,0.970,Barn Owl,16-23,0,0,0,0,NaN,NaN
1,0.970,Barn Owl,23-5,2,6,0,8,25.000,25.000
1,0.970,Wild Pig,16-23,7,8,0,15,46.667,46.667
1,0.970,Wild Pig,23-5,7,4,0,11,63.636,63.636
1,0.970,Pennington Creek Water,16-23,0,0,0,0,NaN,NaN
1,0.970,Pennington Creek Water,23-5,0,0,0,0,NaN,NaN
1,0.970,Guinni,16-23,0,0,0,0,NaN,NaN
1,0.970,Guinni,23-5,0,2,0,2,0.000,0.000
1,0.970,Racoon,16-23,2,3,0,5,40.000,40.000
1,0.970,Racoon,23-5,0,4,0,4,0.000,0.000
1,0.970,Hu,16-23,27,9,0,36,75.000,75.000
1,0.970,Hu,23-5,25,13,0,38,65.789,65.789
1,0.970,Cw and Dg,16-23,15,21,0,36,41.667,41.667
1,0.970,Cw and Dg,23-5,18,29,0,47,38.298,38.298
1,0.970,Red Wind Blackbird,16-23,0,0,0,0,NaN,NaN
1,0.970,Red Wind Blackbird,23-5,0,1,0,1,0.000,0.000
1,0.970,Tree Swallow,16-23,2,6,0,8,25.000,25.000
1,0.970,Tree Swallow,23-5,2,1,0,3,66.667,66.667
1,0.970,Turkey Vulture,16-23,0,2,0,2,0.000,0.000
1,0.970,Turkey Vulture,23-5,0,2,0,2,0.000,0.000
1,0.970,Dg,16-23,11,16,0,27,40.741,40.741
1,0.970,Dg,23-5,27,10,0,37,72.973,72.973
1,0.970,Western Kingbird,16-23,0,3,0,3,0.000,0.000
1,0.970,Western Kingbird,23-5,0,0,0,0,NaN,NaN
1,0.970,White Crowned Sparrow,16-23,13,5,0,18,72.222,72.222
1,0.970,White Crowned Sparrow,23-5,8,7,0,15,53.333,53.333
1,0.970,Eared Grebe,16-23,0,0,0,0,NaN,NaN
1,0.970,Eared Grebe,23-5,2,2,0,4,50.000,50.000
1,0.970,cougar,16-23,0,1,0,1,0.000,0.000
1,0.970,cougar,23-5,0,0,0,0,NaN,NaN
1,0.970,Ocean Water,16-23,0,0,0,0,NaN,NaN
1,0.970,Ocean Water,23-5,0,0,0,0,NaN,NaN
1,0.970,Red Tailed Hawk,16-23,2,0,0,2,100.000,100.000
1,0.970,Red Tailed Hawk,23-5,0,10,0,10,0.000,0.000
1,0.970,Dog,16-23,97,72,0,169,57.396,57.396
1,0.970,Dog,23-5,157,118,0,275,57.091,57.091
1,0.970,Human,16-23,1767,351,0,2118,83.428,83.428
1,0.970,Human,23-5,2243,250,0,2493,89.972,89.972
1,0.970,Wild Turkey,16-23,18,56,0,74,24.324,24.324
1,0.970,Wild Turkey,23-5,14,66,0,80,17.500,17.500
1,0.970,Clark Grebe,16-23,0,0,0,0,NaN,NaN
1,0.970,Clark Grebe,23-5,2,3,0,5,40.000,40.000
1,0.970,Seagull,16-23,0,0,0,0,NaN,NaN
1,0.970,Seagull,23-5,55,8,0,63,87.302,87.302
1,0.970,Surf Scoter,16-23,0,0,0,0,NaN,NaN
1,0.970,Surf Scoter,23-5,2,0,0,2,100.000,100.000
1,0.970,Pigeon,16-23,152,193,0,345,44.058,44.058
1,0.970,Pigeon,23-5,196,372,0,568,34.507,34.507
1,0.970,Pacific Ocean Water,16-23,0,0,0,0,NaN,NaN
1,0.970,Pacific Ocean Water,23-5,0,0,0,0,NaN,NaN
1,0.970,Cat,16-23,41,21,0,62,66.129,66.129
1,0.970,Cat,23-5,46,25,0,71,64.789,64.789
1,0.970,Horse,16-23,21,42,0,63,33.333,33.333
1,0.970,Horse,23-5,51,237,0,288,17.708,17.708
1,0.970,orangutan,16-23,0,0,0,0,NaN,NaN
1,0.970,orangutan,23-5,0,0,0,0,NaN,NaN
1,0.970,Bat,16-23,36,7,0,43,83.721,83.721
1,0.970,Bat,23-5,37,16,0,53,69.811,69.811
1,0.970,Deer,16-23,17,13,0,30,56.667,56.667
1,0.970,Deer,23-5,18,46,0,64,28.125,28.125
1,0.970,Great Horned Owl,16-23,0,2,0,2,0.000,0.000
1,0.970,Great Horned Owl,23-5,1,9,0,10,10.000,10.000
1,0.970,Freshwater Lagoon,16-23,0,0,0,0,NaN,NaN
1,0.970,Freshwater Lagoon,23-5,0,0,0,0,NaN,NaN
1,0.970,Unknown Avian,16-23,0,2,0,2,0.000,0.000
1,0.970,Unknown Avian,23-5,0,2,0,2,0.000,0.000
1,0.970,Human UTI,16-23,115,78,0,193,59.585,59.585
1,0.970,Human UTI,23-5,126,81,0,207,60.870,60.870
1,0.970,unknown,16-23,6,8,0,14,42.857,42.857
1,0.970,unknown,23-5,8,13,0,21,38.095,38.095
1,0.970,SLO Creek Water,16-23,0,0,0,0,NaN,NaN
1,0.970,SLO Creek Water,23-5,6,1,0,7,85.714,85.714
1,0.970,Pig/Swine,16-23,13,11,0,24,54.167,54.167
1,0.970,Pig/Swine,23-5,12,7,0,19,63.158,63.158
1,0.970,Klebsiella,16-23,0,0,0,0,NaN,NaN
1,0.970,Klebsiella,23-5,0,0,0,0,NaN,NaN
1,0.970,Hu Cw and Dg,16-23,11,17,0,28,39.286,39.286
1,0.970,Hu Cw and Dg,23-5,21,20,0,41,51.220,51.220
1,0.970,Ground Squirrel,16-23,113,70,0,183,61.749,61.749
1,0.970,Ground Squirrel,23-5,116,63,0,179,64.804,64.804
1,0.970,Opossum,16-23,4,1,0,5,80.000,80.000
1,0.970,Opossum,23-5,5,8,0,13,38.462,38.462
1,0.970,Cow,16-23,1567,820,0,2387,65.647,65.647
1,0.970,Cow,23-5,1551,971,0,2522,61.499,61.499
1,0.970,Deer Mouse,16-23,0,5,0,5,0.000,0.000
1,0.970,Deer Mouse,23-5,0,0,0,0,NaN,NaN
1,0.970,OVERALL,16-23,4248,2058,0,6306,67.364,67.364
1,0.970,OVERALL,23-5,4966,2595,0,7561,65.679,65.679
1,0.980,Chicken,16-23,22,29,0,51,43.137,43.137
1,0.980,Chicken,23-5,28,10,0,38,73.684,73.684
1,0.980,Sea Lion,16-23,1,1,0,2,50.000,50.000
1,0.980,Sea Lion,23-5,4,3,0,7,57.143,57.143
1,0.980,Hu and Cw,16-23,14,26,0,40,35.000,35.000
1,0.980,Hu and Cw,23-5,15,33,0,48,31.250,31.250
1,0.980,Sheep,16-23,79,63,0,142,55.634,55.634
1,0.980,Sheep,23-5,77,30,0,107,71.963,71.963
1,0.980,Hu and Dg,16-23,16,24,0,40,40.000,40.000
1,0.980,Hu and Dg,23-5,20,15,0,35,57.143,57.143
1,0.980,Common Loon,16-23,2,0,0,2,100.000,100.000
1,0.980,Common Loon,23-5,0,3,0,3,0.000,0.000
1,0.980,Red-Winged Blackbird,16-23,2,5,0,7,28.571,28.571
1,0.980,Red-Winged Blackbird,23-5,2,4,0,6,33.333,33.333
1,0.980,Cw,16-23,17,24,0,41,41.463,41.463
1,0.980,Cw,23-5,29,54,0,83,34.940,34.940
1,0.980,Cliff Sparrow,16-23,16,25,0,41,39.024,39.024
1,0.980,Cliff Sparrow,23-5,12,18,0,30,40.000,40.000
1,0.980,Pig,16-23,22,14,0,36,61.111,61.111
1,0.980,Pig,23-5,20,16,0,36,55.556,55.556
1,0.980,Barn Owl,16-23,0,0,0,0,NaN,NaN
1,0.980,Barn Owl,23-5,2,6,0,8,25.000,25.000
1,0.980,Wild Pig,16-23,7,8,0,15,46.667,46.667
1,0.980,Wild Pig,23-5,7,4,0,11,63.636,63.636
1,0.980,Pennington Creek Water,16-23,0,0,0,0,NaN,NaN
1,0.980,Pennington Creek Water,23-5,0,0,0,0,NaN,NaN
1,0.980,Guinni,16-23,0,0,0,0,NaN,NaN
1,0.980,Guinni,23-5,0,2,0,2,0.000,0.000
1,0.980,Racoon,16-23,2,3,0,5,40.000,40.000
1,0.980,Racoon,23-5,0,4,0,4,0.000,0.000
1,0.980,Hu,16-23,27,9,0,36,75.000,75.000
1,0.980,Hu,23-5,25,13,0,38,65.789,65.789
1,0.980,Cw and Dg,16-23,15,21,0,36,41.667,41.667
1,0.980,Cw and Dg,23-5,18,29,0,47,38.298,38.298
1,0.980,Red Wind Blackbird,16-23,0,0,0,0,NaN,NaN
1,0.980,Red Wind Blackbird,23-5,0,1,0,1,0.000,0.000
1,0.980,Tree Swallow,16-23,2,6,0,8,25.000,25.000
1,0.980,Tree Swallow,23-5,2,1,0,3,66.667,66.667
1,0.980,Turkey Vulture,16-23,0,2,0,2,0.000,0.000
1,0.980,Turkey Vulture,23-5,0,2,0,2,0.000,0.000
1,0.980,Dg,16-23,11,16,0,27,40.741,40.741
1,0.980,Dg,23-5,27,10,0,37,72.973,72.973
1,0.980,Western Kingbird,16-23,0,3,0,3,0.000,0.000
1,0.980,Western Kingbird,23-5,0,0,0,0,NaN,NaN
1,0.980,White Crowned Sparrow,16-23,13,5,0,18,72.222,72.222
1,0.980,White Crowned Sparrow,23-5,8,7,0,15,53.333,53.333
1,0.980,Eared Grebe,16-23,0,0,0,0,NaN,NaN
1,0.980,Eared Grebe,23-5,2,2,0,4,50.000,50.000
1,0.980,cougar,16-23,0,1,0,1,0.000,0.000
1,0.980,cougar,23-5,0,0,0,0,NaN,NaN
1,0.980,Ocean Water,16-23,0,0,0,0,NaN,NaN
1,0.980,Ocean Water,23-5,0,0,0,0,NaN,NaN
1,0.980,Red Tailed Hawk,16-23,2,0,0,2,100.000,100.000
1,0.980,Red Tailed Hawk,23-5,0,10,0,10,0.000,0.000
1,0.980,Dog,16-23,96,72,0,168,57.143,57.143
1,0.980,Dog,23-5,157,116,0,273,57.509,57.509
1,0.980,Human,16-23,1766,345,0,2111,83.657,83.657
1,0.980,Human,23-5,2243,248,0,2491,90.044,90.044
1,0.980,Wild Turkey,16-23,18,56,0,74,24.324,24.324
1,0.980,Wild Turkey,23-5,14,65,0,79,17.722,17.722
1,0.980,Clark Grebe,16-23,0,0,0,0,NaN,NaN
1,0.980,Clark Grebe,23-5,2,3,0,5,40.000,40.000
1,0.980,Seagull,16-23,0,0,0,0,NaN,NaN
1,0.980,Seagull,23-5,55,7,0,62,88.710,88.710
1,0.980,Surf Scoter,16-23,0,0,0,0,NaN,NaN
1,0.980,Surf Scoter,23-5,2,0,0,2,100.000,100.000
1,0.980,Pigeon,16-23,151,192,0,343,44.023,44.023
1,0.980,Pigeon,23-5,195,368,0,563,34.636,34.636
1,0.980,Pacific Ocean Water,16-23,0,0,0,0,NaN,NaN
1,0.980,Pacific Ocean Water,23-5,0,0,0,0,NaN,NaN
1,0.980,Cat,16-23,41,21,0,62,66.129,66.129
1,0.980,Cat,23-5,46,24,0,70,65.714,65.714
1,0.980,Horse,16-23,21,42,0,63,33.333,33.333
1,0.980,Horse,23-5,51,236,0,287,17.770,17.770
1,0.980,orangutan,16-23,0,0,0,0,NaN,NaN
1,0.980,orangutan,23-5,0,0,0,0,NaN,NaN
1,0.980,Bat,16-23,36,7,0,43,83.721,83.721
1,0.980,Bat,23-5,37,15,0,52,71.154,71.154
1,0.980,Deer,16-23,17,13,0,30,56.667,56.667
1,0.980,Deer,23-5,18,46,0,64,28.125,28.125
1,0.980,Great Horned Owl,16-23,0,2,0,2,0.000,0.000
1,0.980,Great Horned Owl,23-5,1,9,0,10,10.000,10.000
1,0.980,Freshwater Lagoon,16-23,0,0,0,0,NaN,NaN
1,0.980,Freshwater Lagoon,23-5,0,0,0,0,NaN,NaN
1,0.980,Unknown Avian,16-23,0,2,0,2,0.000,0.000
1,0.980,Unknown Avian,23-5,0,2,0,2,0.000,0.000
1,0.980,Human UTI,16-23,115,75,0,190,60.526,60.526
1,0.980,Human UTI,23-5,126,78,0,204,61.765,61.765
1,0.980,unknown,16-23,6,8,0,14,42.857,42.857
1,0.980,unknown,23-5,8,13,0,21,38.095,38.095
1,0.980,SLO Creek Water,16-23,0,0,0,0,NaN,NaN
1,0.980,SLO Creek Water,23-5,6,1,0,7,85.714,85.714
1,0.980,Pig/Swine,16-23,13,11,0,24,54.167,54.167
1,0.980,Pig/Swine,23-5,12,7,0,19,63.158,63.158
1,0.980,Klebsiella,16-23,0,0,0,0,NaN,NaN
1,0.980,Klebsiella,23-5,0,0,0,0,NaN,NaN
1,0.980,Hu Cw and Dg,16-23,11,17,0,28,39.286,39.286
1,0.980,Hu Cw and Dg,23-5,21,20,0,41,51.220,51.220
1,0.980,Ground Squirrel,16-23,113,70,0,183,61.749,61.749
1,0.980,Ground Squirrel,23-5,116,63,0,179,64.804,64.804
1,0.980,Opossum,16-23,4,1,0,5,80.000,80.000
1,0.980,Opossum,23-5,5,8,0,13,38.462,38.462
1,0.980,Cow,16-23,1564,812,0,2376,65.825,65.825
1,0.980,Cow,23-5,1541,962,0,2503,61.566,61.566
1,0.980,Deer Mouse,16-23,0,5,0,5,0.000,0.000
1,0.980,Deer Mouse,23-5,0,0,0,0,NaN,NaN
1,0.980,OVERALL,16-23,4242,2036,0,6278,67.569,67.569
1,0.980,OVERALL,23-5,4954,2568,0,7522,65.860,65.860
1,0.990,Chicken,16-23,22,27,0,49,44.898,44.898
1,0.990,Chicken,23-5,28,9,0,37,75.676,75.676
1,0.990,Sea Lion,16-23,1,1,0,2,50.000,50.000
1,0.990,Sea Lion,23-5,4,3,0,7,57.143,57.143
1,0.990,Hu and Cw,16-23,14,26,0,40,35.000,35.000
1,0.990,Hu and Cw,23-5,15,31,0,46,32.609,32.609
1,0.990,Sheep,16-23,78,61,0,139,56.115,56.115
1,0.990,Sheep,23-5,77,30,0,107,71.963,71.963
1,0.990,Hu and Dg,16-23,16,24,0,40,40.000,40.000
1,0.990,Hu and Dg,23-5,20,15,0,35,57.143,57.143
1,0.990,Common Loon,16-23,2,0,0,2,100.000,100.000
1,0.990,Common Loon,23-5,0,3,0,3,0.000,0.000
1,0.990,Red-Winged Blackbird,16-23,2,4,0,6,33.333,33.333
1,0.990,Red-Winged Blackbird,23-5,2,4,0,6,33.333,33.333
1,0.990,Cw,16-23,17,24,0,41,41.463,41.463
1,0.990,Cw,23-5,29,52,0,81,35.802,35.802
1,0.990,Cliff Sparrow,16-23,16,25,0,41,39.024,39.024
1,0.990,Cliff Sparrow,23-5,12,18,0,30,40.000,40.000
1,0.990,Pig,16-23,22,14,0,36,61.111,61.111
1,0.990,Pig,23-5,20,16,0,36,55.556,55.556
1,0.990,Barn Owl,16-23,0,0,0,0,NaN,NaN
1,0.990,Barn Owl,23-5,2,5,0,7,28.571,28.571
1,0.990,Wild Pig,16-23,7,7,0,14,50.000,50.000
1,0.990,Wild Pig,23-5,7,4,0,11,63.636,63.636
1,0.990,Pennington Creek Water,16-23,0,0,0,0,NaN,NaN
1,0.990,Pennington Creek Water,23-5,0,0,0,0,NaN,NaN
1,0.990,Guinni,16-23,0,0,0,0,NaN,NaN
1,0.990,Guinni,23-5,0,1,0,1,0.000,0.000
1,0.990,Racoon,16-23,2,3,0,5,40.000,40.000
1,0.990,Racoon,23-5,0,4,0,4,0.000,0.000
1,0.990,Hu,16-23,27,9,0,36,75.000,75.000
1,0.990,Hu,23-5,25,11,0,36,69.444,69.444
1,0.990,Cw and Dg,16-23,15,21,0,36,41.667,41.667
1,0.990,Cw and Dg,23-5,18,24,0,42,42.857,42.857
1,0.990,Red Wind Blackbird,16-23,0,0,0,0,NaN,NaN
1,0.990,Red Wind Blackbird,23-5,0,1,0,1,0.000,0.000
1,0.990,Tree Swallow,16-23,2,6,0,8,25.000,25.000
1,0.990,Tree Swallow,23-5,2,1,0,3,66.667,66.667
1,0.990,Turkey Vulture,16-23,0,2,0,2,0.000,0.000
1,0.990,Turkey Vulture,23-5,0,2,0,2,0.000,0.000
1,0.990,Dg,16-23,11,16,0,27,40.741,40.741
1,0.990,Dg,23-5,27,10,0,37,72.973,72.973
1,0.990,Western Kingbird,16-23,0,3,0,3,0.000,0.000
1,0.990,Western Kingbird,23-5,0,0,0,0,NaN,NaN
1,0.990,White Crowned Sparrow,16-23,13,5,0,18,72.222,72.222
1,0.990,White Crowned Sparrow,23-5,8,7,0,15,53.333,53.333
1,0.990,Eared Grebe,16-23,0,0,0,0,NaN,NaN
1,0.990,Eared Grebe,23-5,2,2,0,4,50.000,50.000
1,0.990,cougar,16-23,0,1,0,1,0.000,0.000
1,0.990,cougar,23-5,0,0,0,0,NaN,NaN
1,0.990,Ocean Water,16-23,0,0,0,0,NaN,NaN
1,0.990,Ocean Water,23-5,0,0,0,0,NaN,NaN
1,0.990,Red Tailed Hawk,16-23,2,0,0,2,100.000,100.000
1,0.990,Red Tailed Hawk,23-5,0,10,0,10,0.000,0.000
1,0.990,Dog,16-23,96,70,0,166,57.831,57.831
1,0.990,Dog,23-5,157,111,0,268,58.582,58.582
1,0.990,Human,16-23,1752,330,0,2082,84.150,84.150
1,0.990,Human,23-5,2237,235,0,2472,90.494,90.494
1,0.990,Wild Turkey,16-23,18,52,0,70,25.714,25.714
1,0.990,Wild Turkey,23-5,12,54,0,66,18.182,18.182
1,0.990,Clark Grebe,16-23,0,0,0,0,NaN,NaN
1,0.990,Clark Grebe,23-5,2,3,0,5,40.000,40.000
1,0.990,Seagull,16-23,0,0,0,0,NaN,NaN
1,0.990,Seagull,23-5,55,7,0,62,88.710,88.710
1,0.990,Surf Scoter,16-23,0,0,0,0,NaN,NaN
1,0.990,Surf Scoter,23-5,2,0,0,2,100.000,100.000
1,0.990,Pigeon,16-23,149,182,0,331,45.015,45.015
1,0.990,Pigeon,23-5,193,344,0,537,35.940,35.940
1,0.990,Pacific Ocean Water,16-23,0,0,0,0,NaN,NaN
1,0.990,Pacific Ocean Water,23-5,0,0,0,0,NaN,NaN
1,0.990,Cat,16-23,41,19,0,60,68.333,68.333
1,0.990,Cat,23-5,46,21,0,67,68.657,68.657
1,0.990,Horse,16-23,21,39,0,60,35.000,35.000
1,0.990,Horse,23-5,50,228,0,278,17.986,17.986
1,0.990,orangutan,16-23,0,0,0,0,NaN,NaN
1,0.990,orangutan,23-5,0,0,0,0,NaN,NaN
1,0.990,Bat,16-23,36,7,0,43,83.721,83.721
1,0.990,Bat,23-5,37,15,0,52,71.154,71.154
1,0.990,Deer,16-23,17,13,0,30,56.667,56.667
1,0.990,Deer,23-5,18,45,0,63,28.571,28.571
1,0.990,Great Horned Owl,16-23,0,2,0,2,0.000,0.000
1,0.990,Great Horned Owl,23-5,1,9,0,10,10.000,10.000
1,0.990,Freshwater Lagoon,16-23,0,0,0,0,NaN,NaN
1,0.990,Freshwater Lagoon,23-5,0,0,0,0,NaN,NaN
1,0.990,Unknown Avian,16-23,0,2,0,2,0.000,0.000
1,0.990,Unknown Avian,23-5,0,2,0,2,0.000,0.000
1,0.990,Human UTI,16-23,115,72,0,187,61.497,61.497
1,0.990,Human UTI,23-5,126,63,0,189,66.667,66.667
1,0.990,unknown,16-23,6,8,0,14,42.857,42.857
1,0.990,unknown,23-5,8,13,0,21,38.095,38.095
1,0.990,SLO Creek Water,16-23,0,0,0,0,NaN,NaN
1,0.990,SLO Creek Water,23-5,6,1,0,7,85.714,85.714
1,0.990,Pig/Swine,16-23,12,8,0,20,60.000,60.000
1,0.990,Pig/Swine,23-5,12,7,0,19,63.158,63.158
1,0.990,Klebsiella,16-23,0,0,0,0,NaN,NaN
1,0.990,Klebsiella,23-5,0,0,0,0,NaN,NaN
1,0.990,Hu Cw and Dg,16-23,11,17,0,28,39.286,39.286
1,0.990,Hu Cw and Dg,23-5,21,20,0,41,51.220,51.220
1,0.990,Ground Squirrel,16-23,113,65,0,178,63.483,63.483
1,0.990,Ground Squirrel,23-5,114,58,0,172,66.279,66.279
1,0.990,Opossum,16-23,4,1,0,5,80.000,80.000
1,0.990,Opossum,23-5,5,8,0,13,38.462,38.462
1,0.990,Cow,16-23,1527,767,0,2294,66.565,66.565
1,0.990,Cow,23-5,1517,902,0,2419,62.712,62.712
1,0.990,Deer Mouse,16-23,0,5,0,5,0.000,0.000
1,0.990,Deer Mouse,23-5,0,0,0,0,NaN,NaN
1,0.990,OVERALL,16-23,4187,1938,0,6125,68.359,68.359
1,0.990,OVERALL,23-5,4917,2409,0,7326,67.117,67.117
1,1.000,Chicken,16-23,0,0,0,0,NaN,NaN
1,1.000,Chicken,23-5,0,0,0,0,NaN,NaN
1,1.000,Sea Lion,16-23,0,0,0,0,NaN,NaN
1,1.000,Sea Lion,23-5,0,0,0,0,NaN,NaN
1,1.000,Hu and Cw,16-23,0,0,0,0,NaN,NaN
1,1.000,Hu and Cw,23-5,0,0,0,0,NaN,NaN
1,1.000,Sheep,16-23,0,0,0,0,NaN,NaN
1,1.000,Sheep,23-5,0,0,0,0,NaN,NaN
1,1.000,Hu and Dg,16-23,0,0,0,0,NaN,NaN
1,1.000,Hu and Dg,23-5,0,0,0,0,NaN,NaN
1,1.000,Common Loon,16-23,0,0,0,0,NaN,NaN
1,1.000,Common Loon,23-5,0,0,0,0,NaN,NaN
1,1.000,Red-Winged Blackbird,16-23,0,0,0,0,NaN,NaN
1,1.000,Red-Winged Blackbird,23-5,0,0,0,0,NaN,NaN
1,1.000,Cw,16-23,0,0,0,0,NaN,NaN
1,1.000,Cw,23-5,0,0,0,0,NaN,NaN
1,1.000,Cliff Sparrow,16-23,0,0,0,0,NaN,NaN
1,1.000,Cliff Sparrow,23-5,0,0,0,0,NaN,NaN
1,1.000,Pig,16-23,0,0,0,0,NaN,NaN
1,1.000,Pig,23-5,0,0,0,0,NaN,NaN
1,1.000,Barn Owl,16-23,0,0,0,0,NaN,NaN
1,1.000,Barn Owl,23-5,0,0,0,0,NaN,NaN
1,1.000,Wild Pig,16-23,0,0,0,0,NaN,NaN
1,1.000,Wild Pig,23-5,0,0,0,0,NaN,NaN
1,1.000,Pennington Creek Water,16-23,0,0,0,0,NaN,NaN
1,1.000,Pennington Creek Water,23-5,0,0,0,0,NaN,NaN
1,1.000,Guinni,16-23,0,0,0,0,NaN,NaN
1,1.000,Guinni,23-5,0,0,0,0,NaN,NaN
1,1.000,Racoon,16-23,0,0,0,0,NaN,NaN
1,1.000,Racoon,23-5,0,0,0,0,NaN,NaN
1,1.000,Hu,16-23,0,0,0,0,NaN,NaN
1,1.000,Hu,23-5,0,0,0,0,NaN,NaN
1,1.000,Cw and Dg,16-23,0,0,0,0,NaN,NaN
1,1.000,Cw and Dg,23-5,0,0,0,0,NaN,NaN
1,1.000,Red Wind Blackbird,16-23,0,0,0,0,NaN,NaN
1,1.000,Red Wind Blackbird,23-5,0,0,0,0,NaN,NaN
1,1.000,Tree Swallow,16-23,0,0,0,0,NaN,NaN
1,1.000,Tree Swallow,23-5,0,0,0,0,NaN,NaN
1,1.000,Turkey Vulture,16-23,0,0,0,0,NaN,NaN
1,1.000,Turkey Vulture,23-5,0,0,0,0,NaN,NaN
1,1.000,Dg,16-23,0,0,0,0,NaN,NaN
1,1.000,Dg,23-5,0,0,0,0,NaN,NaN
1,1.000,Western Kingbird,16-23,0,0,0,0,NaN,NaN
1,1.000,Western Kingbird,23-5,0,0,0,0,NaN,NaN
1,1.000,White Crowned Sparrow,16-23,0,0,0,0,NaN,NaN
1,1.000,White Crowned Sparrow,23-5,0,0,0,0,NaN,NaN
1,1.000,Eared Grebe,16-23,0,0,0,0,NaN,NaN
1,1.000,Eared Grebe,23-5,0,0,0,0,NaN,NaN
1,1.000,cougar,16-23,0,0,0,0,NaN,NaN
1,1.000,cougar,23-5,0,0,0,0,NaN,NaN
1,1.000,Ocean Water,16-23,0,0,0,0,NaN,NaN
1,1.000,Ocean Water,23-5,0,0,0,0,NaN,NaN
1,1.000,Red Tailed Hawk,16-23,0,0,0,0,NaN,NaN
1,1.000,Red Tailed Hawk,23-5,0,0,0,0,NaN,NaN
1,1.000,Dog,16-23,0,0,0,0,NaN,NaN
1,1.000,Dog,23-5,0,0,0,0,NaN,NaN
1,1.000,Human,16-23,68,0,0,68,100.000,100.000
1,1.000,Human,23-5,90,0,0,90,100.000,100.000
1,1.000,Wild Turkey,16-23,0,0,0,0,NaN,NaN
1,1.000,Wild Turkey,23-5,0,0,0,0,NaN,NaN
1,1.000,Clark Grebe,16-23,0,0,0,0,NaN,NaN
1,1.000,Clark Grebe,23-5,0,0,0,0,NaN,NaN
1,1.000,Seagull,16-23,0,0,0,0,NaN,NaN
1,1.000,Seagull,23-5,0,0,0,0,NaN,NaN
1,1.000,Surf Scoter,16-23,0,0,0,0,NaN,NaN
1,1.000,Surf Scoter,23-5,0,0,0,0,NaN,NaN
1,1.000,Pigeon,16-23,0,0,0,0,NaN,NaN
1,1.000,Pigeon,23-5,0,0,0,0,NaN,NaN
1,1.000,Pacific Ocean Water,16-23,0,0,0,0,NaN,NaN
1,1.000,Pacific Ocean Water,23-5,0,0,0,0,NaN,NaN
1,1.000,Cat,16-23,0,0,0,0,NaN,NaN
1,1.000,Cat,23-5,0,0,0,0,NaN,NaN
1,1.000,Horse,16-23,0,0,0,0,NaN,NaN
1,1.000,Horse,23-5,0,0,0,0,NaN,NaN
1,1.000,orangutan,16-23,0,0,0,0,NaN,NaN
1,1.000,orangutan,23-5,0,0,0,0,NaN,NaN
1,1.000,Bat,16-23,0,0,0,0,NaN,NaN
1,1.000,Bat,23-5,0,0,0,0,NaN,NaN
1,1.000,Deer,16-23,0,0,0,0,NaN,NaN
1,1.000,Deer,23-5,0,0,0,0,NaN,NaN
1,1.000,Great Horned Owl,16-23,0,0,0,0,NaN,NaN
1,1.000,Great Horned Owl,23-5,0,0,0,0,NaN,NaN
1,1.000,Freshwater Lagoon,16-23,0,0,0,0,NaN,NaN
1,1.000,Freshwater Lagoon,23-5,0,0,0,0,NaN,NaN
1,1.000,Unknown Avian,16-23,0,0,0,0,NaN,NaN
1,1.000,Unknown Avian,23-5,0,0,0,0,NaN,NaN
1,1.000,Human UTI,16-23,0,0,0,0,NaN,NaN
1,1.000,Human UTI,23-5,0,0,0,0,NaN,NaN
1,1.000,unknown,16-23,0,0,0,0,NaN,NaN
1,1.000,unknown,23-5,0,0,0,0,NaN,NaN
1,1.000,SLO Creek Water,16-23,0,0,0,0,NaN,NaN
1,1.000,SLO Creek Water,23-5,0,0,0,0,NaN,NaN
1,1.000,Pig/Swine,16-23,0,0,0,0,NaN,NaN
1,1.000,Pig/Swine,23-5,0,0,0,0,NaN,NaN
1,1.000,Klebsiella,16-23,0,0,0,0,NaN,NaN
1,1.000,Klebsiella,23-5,0,0,0,0,NaN,NaN
1,1.000,Hu Cw and Dg,16-23,0,0,0,0,NaN,NaN
1,1.000,Hu Cw and Dg,23-5,0,0,0,0,NaN,NaN
1,1.000,Ground Squirrel,16-23,0,0,0,0,NaN,NaN
1,1.000,Ground Squirrel,23-5,0,0,0,0,NaN,NaN
1,1.000,Opossum,16-23,0,0,0,0,NaN,NaN
1,1.000,Opossum,23-5,0,0,0,0,NaN,NaN
1,1.000,Cow,16-23,0,0,0,0,NaN,NaN
1,1.000,Cow,23-5,0,0,0,0,NaN,NaN
1,1.000,Deer Mouse,16-23,0,0,0,0,NaN,NaN
1,1.000,Deer Mouse,23-5,0,0,0,0,NaN,NaN
1,1.000,OVERALL,16-23,68,0,0,68,100.000,100.000
1,1.000,OVERALL,23-5,90,0,0,90,100.000,100.000
2,0.000,Chicken,16-23,20,45,0,65,30.769,30.769
2,0.000,Chicken,23-5,27,26,0,53,50.943,50.943
2,0.000,Sea Lion,16-23,2,1,0,3,66.667,66.667
2,0.000,Sea Lion,23-5,4,5,0,9,44.444,44.444
2,0.000,Hu and Cw,16-23,24,37,0,61,39.344,39.344
2,0.000,Hu and Cw,23-5,15,49,0,64,23.438,23.438
2,0.000,Sheep,16-23,83,101,0,184,45.109,45.109
2,0.000,Sheep,23-5,76,54,0,130,58.462,58.462
2,0.000,Hu and Dg,16-23,8,23,0,31,25.806,25.806
2,0.000,Hu and Dg,23-5,18,15,0,33,54.545,54.545
2,0.000,Common Loon,16-23,0,0,0,0,NaN,NaN
2,0.000,Common Loon,23-5,0,6,0,6,0.000,0.000
2,0.000,Red-Winged Blackbird,16-23,2,6,0,8,25.000,25.000
2,0.000,Red-Winged Blackbird,23-5,1,8,0,9,11.111,11.111
2,0.000,Cw,16-23,14,20,0,34,41.176,41.176
2,0.000,Cw,23-5,35,55,0,90,38.889,38.889
2,0.000,Cliff Sparrow,16-23,20,45,0,65,30.769,30.769
2,0.000,Cliff Sparrow,23-5,14,35,0,49,28.571,28.571
2,0.000,Pig,16-23,21,21,0,42,50.000,50.000
2,0.000,Pig,23-5,19,23,0,42,45.238,45.238
2,0.000,Barn Owl,16-23,0,0,0,0,NaN,NaN
2,0.000,Barn Owl,23-5,0,3,0,3,0.000,0.000
2,0.000,Wild Pig,16-23,10,15,0,25,40.000,40.000
2,0.000,Wild Pig,23-5,11,10,0,21,52.381,52.381
2,0.000,Pennington Creek Water,16-23,0,0,0,0,NaN,NaN
2,0.000,Pennington Creek Water,23-5,0,0,0,0,NaN,NaN
2,0.000,Guinni,16-23,0,0,0,0,NaN,NaN
2,0.000,Guinni,23-5,0,2,0,2,0.000,0.000
2,0.000,Racoon,16-23,2,3,0,5,40.000,40.000
2,0.000,Racoon,23-5,0,7,0,7,0.000,0.000
2,0.000,Hu,16-23,15,7,0,22,68.182,68.182
2,0.000,Hu,23-5,21,5,0,26,80.769,80.769
2,0.000,Cw and Dg,16-23,5,6,0,11,45.455,45.455
2,0.000,Cw and Dg,23-5,14,8,0,22,63.636,63.636
2,0.000,Red Wind Blackbird,16-23,0,1,0,1,0.000,0.000
2,0.000,Red Wind Blackbird,23-5,0,2,0,2,0.000,0.000
2,0.000,Tree Swallow,16-23,2,6,0,8,25.000,25.000
2,0.000,Tree Swallow,23-5,0,2,0,2,0.000,0.000
2,0.000,Turkey Vulture,16-23,0,4,0,4,0.000,0.000
2,0.000,Turkey Vulture,23-5,0,4,0,4,0.000,0.000
2,0.000,Dg,16-23,13,21,0,34,38.235,38.235
2,0.000,Dg,23-5,29,20,0,49,59.184,59.184
2,0.000,Western Kingbird,16-23,0,3,0,3,0.000,0.000
2,0.000,Western Kingbird,23-5,0,2,0,2,0.000,0.000
2,0.000,White Crowned Sparrow,16-23,13,10,0,23,56.522,56.522
2,0.000,White Crowned Sparrow,23-5,8,18,0,26,30.769,30.769
2,0.000,Eared Grebe,16-23,0,0,0,0,NaN,NaN
2,0.000,Eared Grebe,23-5,3,12,0,15,20.000,20.000
2,0.000,cougar,16-23,0,1,0,1,0.000,0.000
2,0.000,cougar,23-5,0,0,0,0,NaN,NaN
2,0.000,Ocean Water,16-23,0,0,0,0,NaN,NaN
2,0.000,Ocean Water,23-5,0,0,0,0,NaN,NaN
2,0.000,Red Tailed Hawk,16-23,2,2,0,4,50.000,50.000
2,0.000,Red Tailed Hawk,23-5,0,14,0,14,0.000,0.000
2,0.000,Dog,16-23,89,106,0,195,45.641,45.641
2,0.000,Dog,23-5,144,162,0,306,47.059,47.059
2,0.000,Human,16-23,1768,544,0,2312,76.471,76.471
2,0.000,Human,23-5,2232,413,0,2645,84.386,84.386
2,0.000,Wild Turkey,16-23,15,85,0,100,15.000,15.000
2,0.000,Wild Turkey,23-5,17,87,0,104,16.346,16.346
2,0.000,Clark Grebe,16-23,0,0,0,0,NaN,NaN
2,0.000,Clark Grebe,23-5,0,3,0,3,0.000,0.000
2,0.000,Seagull,16-23,0,0,0,0,NaN,NaN
2,0.000,Seagull,23-5,47,10,0,57,82.456,82.456
2,0.000,Surf Scoter,16-23,0,0,0,0,NaN,NaN
2,0.000,Surf Scoter,23-5,0,2,0,2,0.000,0.000
2,0.000,Pigeon,16-23,142,218,0,360,39.444,39.444
2,0.000,Pigeon,23-5,181,436,0,617,29.335,29.335
2,0.000,Pacific Ocean Water,16-23,0,0,0,0,NaN,NaN
2,0.000,Pacific Ocean Water,23-5,0,0,0,0,NaN,NaN
2,0.000,Cat,16-23,46,40,0,86,53.488,53.488
2,0.000,Cat,23-5,50,49,0,99,50.505,50.505
2,0.000,Horse,16-23,23,72,0,95,24.211,24.211
2,0.000,Horse,23-5,54,358,0,412,13.107,13.107
2,0.000,orangutan,16-23,0,0,0,0,NaN,NaN
2,0.000,orangutan,23-5,0,0,0,0,NaN,NaN
2,0.000,Bat,16-23,36,11,0,47,76.596,76.596
2,0.000,Bat,23-5,37,20,0,57,64.912,64.912
2,0.000,Deer,16-23,15,29,0,44,34.091,34.091
2,0.000,Deer,23-5,18,69,0,87,20.690,20.690
2,0.000,Great Horned Owl,16-23,0,3,0,3,0.000,0.000
2,0.000,Great Horned Owl,23-5,1,14,0,15,6.667,6.667
2,0.000,Freshwater Lagoon,16-23,0,0,0,0,NaN,NaN
2,0.000,Freshwater Lagoon,23-5,0,0,0,0,NaN,NaN
2,0.000,Unknown Avian,16-23,0,0,0,0,NaN,NaN
2,0.000,Unknown Avian,23-5,0,2,0,2,0.000,0.000
2,0.000,Human UTI,16-23,97,87,0,184,52.717,52.717
2,0.000,Human UTI,23-5,114,83,0,197,57.868,57.868
2,0.000,unknown,16-23,1,16,0,17,5.882,5.882
2,0.000,unknown,23-5,5,17,0,22,22.727,22.727
2,0.000,SLO Creek Water,16-23,0,0,0,0,NaN,NaN
2,0.000,SLO Creek Water,23-5,8,1,0,9,88.889,88.889
2,0.000,Pig/Swine,16-23,13,19,0,32,40.625,40.625
2,0.000,Pig/Swine,23-5,7,9,0,16,43.750,43.750
2,0.000,Klebsiella,16-23,0,0,0,0,NaN,NaN
2,0.000,Klebsiella,23-5,0,0,0,0,NaN,NaN
2,0.000,Hu Cw and Dg,16-23,19,27,0,46,41.304,41.304
2,0.000,Hu Cw and Dg,23-5,35,33,0,68,51.471,51.471
2,0.000,Ground Squirrel,16-23,122,132,0,254,48.031,48.031
2,0.000,Ground Squirrel,23-5,116,140,0,256,45.313,45.313
2,0.000,Opossum,16-23,2,1,0,3,66.667,66.667
2,0.000,Opossum,23-5,2,9,0,11,18.182,18.182
2,0.000,Cow,16-23,1361,575,0,1936,70.300,70.300
2,0.000,Cow,23-5,1347,598,0,1945,69.254,69.254
2,0.000,Deer Mouse,16-23,0,0,0,0,NaN,NaN
2,0.000,Deer Mouse,23-5,0,0,0,0,NaN,NaN
2,0.000,OVERALL,16-23,4005,2343,0,6348,63.091,63.091
2,0.000,OVERALL,23-5,4710,2900,0,7610,61.892,61.892
2,0.500,Chicken,16-23,20,45,0,65,30.769,30.769
2,0.500,Chicken,23-5,27,26,0,53,50.943,50.943
2,0.500,Sea Lion,16-23,2,1,0,3,66.667,66.667
2,0.500,Sea Lion,23-5,4,5,0,9,44.444,44.444
2,0.500,Hu and Cw,16-23,24,37,0,61,39.344,39.344
2,0.500,Hu and Cw,23-5,15,49,0,64,23.438,23.438
2,0.500,Sheep,16-23,83,101,0,184,45.109,45.109
2,0.500,Sheep,23-5,76,54,0,130,58.462,58.462
2,0.500,Hu and Dg,16-23,8,23,0,31,25.806,25.806
2,0.500,Hu and Dg,23-5,18,15,0,33,54.545,54.545
2,0.500,Common Loon,16-23,0,0,0,0,NaN,NaN
2,0.500,Common Loon,23-5,0,6,0,6,0.000,0.000
2,0.500,Red-Winged Blackbird,16-23,2,6,0,8,25.000,25.000
2,0.500,Red-Winged Blackbird,23-5,1,8,0,9,11.111,11.111
2,0.500,Cw,16-23,14,20,0,34,41.176,41.176
2,0.500,Cw,23-5,35,55,0,90,38.889,38.889
2,0.500,Cliff Sparrow,16-23,20,45,0,65,30.769,30.769
2,0.500,Cliff Sparrow,23-5,14,35,0,49,28.571,28.571
2,0.500,Pig,16-23,21,21,0,42,50.000,50.000
2,0.500,Pig,23-5,19,23,0,42,45.238,45.238
2,0.500,Barn Owl,16-23,0,0,0,0,NaN,NaN
2,0.500,Barn Owl,23-5,0,3,0,3,0.000,0.000
2,0.500,Wild Pig,16-23,10,15,0,25,40.000,40.000
2,0.500,Wild Pig,23-5,11,10,0,21,52.381,52.381
2,0.500,Pennington Creek Water,16-23,0,0,0,0,NaN,NaN
2,0.500,Pennington Creek Water,23-5,0,0,0,0,NaN,NaN
2,0.500,Guinni,16-23,0,0,0,0,NaN,NaN
2,0.500,Guinni,23-5,0,2,0,2,0.000,0.000
2,0.500,Racoon,16-23,2,3,0,5,40.000,40.000
2,0.500,Racoon,23-5,0,7,0,7,0.000,0.000
2,0.500,Hu,16-23,15,7,0,22,68.182,68.182
2,0.500,Hu,23-5,21,5,0,26,80.769,80.769
2,0.500,Cw and Dg,16-23,5,6,0,11,45.455,45.455
2,0.500,Cw and Dg,23-5,14,8,0,22,63.636,63.636
2,0.500,Red Wind Blackbird,16-23,0,1,0,1,0.000,0.000
2,0.500,Red Wind Blackbird,23-5,0,2,0,2,0.000,0.000
2,0.500,Tree Swallow,16-23,2,6,0,8,25.000,25.000
2,0.500,Tree Swallow,23-5,0,2,0,2,0.000,0.000
2,0.500,Turkey Vulture,16-23,0,4,0,4,0.000,0.000
2,0.500,Turkey Vulture,23-5,0,4,0,4,0.000,0.000
2,0.500,Dg,16-23,13,21,0,34,38.235,38.235
2,0.500,Dg,23-5,29,20,0,49,59.184,59.184
2,0.500,Western Kingbird,16-23,0,3,0,3,0.000,0.000
2,0.500,Western Kingbird,23-5,0,2,0,2,0.000,0.000
2,0.500,White Crowned Sparrow,16-23,13,10,0,23,56.522,56.522
2,0.500,White Crowned Sparrow,23-5,8,18,0,26,30.769,30.769
2,0.500,Eared Grebe,16-23,0,0,0,0,NaN,NaN
2,0.500,Eared Grebe,23-5,3,12,0,15,20.000,20.000
2,0.500,cougar,16-23,0,1,0,1,0.000,0.000
2,0.500,cougar,23-5,0,0,0,0,NaN,NaN
2,0.500,Ocean Water,16-23,0,0,0,0,NaN,NaN
2,0.500,Ocean Water,23-5,0,0,0,0,NaN,NaN
2,0.500,Red Tailed Hawk,16-23,2,2,0,4,50.000,50.000
2,0.500,Red Tailed Hawk,23-5,0,14,0,14,0.000,0.000
2,0.500,Dog,16-23,89,106,0,195,45.641,45.641
2,0.500,Dog,23-5,144,162,0,306,47.059,47.059
2,0.500,Human,16-23,1768,544,0,2312,76.471,76.471
2,0.500,Human,23-5,2232,413,0,2645,84.386,84.386
2,0.500,Wild Turkey,16-23,15,85,0,100,15.000,15.000
2,0.500,Wild Turkey,23-5,17,87,0,104,16.346,16.346
2,0.500,Clark Grebe,16-23,0,0,0,0,NaN,NaN
2,0.500,Clark Grebe,23-5,0,3,0,3,0.000,0.000
2,0.500,Seagull,16-23,0,0,0,0,NaN,NaN
2,0.500,Seagull,23-5,47,10,0,57,82.456,82.456
2,0.500,Surf Scoter,16-23,0,0,0,0,NaN,NaN
2,0.500,Surf Scoter,23-5,0,2,0,2,0.000,0.000
2,0.500,Pigeon,16-23,142,218,0,360,39.444,39.444
2,0.500,Pigeon,23-5,181,436,0,617,29.335,29.335
2,0.500,Pacific Ocean Water,16-23,0,0,0,0,NaN,NaN
2,0.500,Pacific Ocean Water,23-5,0,0,0,0,NaN,NaN
2,0.500,Cat,16-23,46,40,0,86,53.488,53.488
2,0.500,Cat,23-5,50,49,0,99,50.505,50.505
2,0.500,Horse,16-23,23,72,0,95,24.211,24.211
2,0.500,Horse,23-5,54,358,0,412,13.107,13.107
2,0.500,orangutan,16-23,0,0,0,0,NaN,NaN
2,0.500,orangutan,23-5,0,0,0,0,NaN,NaN
2,0.500,Bat,16-23,36,11,0,47,76.596,76.596
2,0.500,Bat,23-5,37,20,0,57,64.912,64.912
2,0.500,Deer,16-23,15,29,0,44,34.091,34.091
2,0.500,Deer,23-5,18,69,0,87,20.690,20.690
2,0.500,Great Horned Owl,16-23,0,3,0,3,0.000,0.000
2,0.500,Great Horned Owl,23-5,1,14,0,15,6.667,6.667
2,0.500,Freshwater Lagoon,16-23,0,0,0,0,NaN,NaN
2,0.500,Freshwater Lagoon,23-5,0,0,0,0,NaN,NaN
2,0.500,Unknown Avian,16-23,0,0,0,0,NaN,NaN
2,0.500,Unknown Avian,23-5,0,2,0,2,0.000,0.000
2,0.500,Human UTI,16-23,97,87,0,184,52.717,52.717
2,0.500,Human UTI,23-5,114,83,0,197,57.868,57.868
2,0.500,unknown,16-23,1,16,0,17,5.882,5.882
2,0.500,unknown,23-5,5,17,0,22,22.727,22.727
2,0.500,SLO Creek Water,16-23,0,0,0,0,NaN,NaN
2,0.500,SLO Creek Water,23-5,8,1,0,9,88.889,88.889
2,0.500,Pig/Swine,16-23,13,19,0,32,40.625,40.625
2,0.500,Pig/Swine,23-5,7,9,0,16,43.750,43.750
2,0.500,Klebsiella,16-23,0,0,0,0,NaN,NaN
2,0.500,Klebsiella,23-5,0,0,0,0,NaN,NaN
2,0.500,Hu Cw and Dg,16-23,19,27,0,46,41.304,41.304
2,0.500,Hu Cw and Dg,23-5,35,33,0,68,51.471,51.471
2,0.500,Ground Squirrel,16-23,122,132,0,254,48.031,48.031
2,0.500,Ground Squirrel,23-5,116,140,0,256,45.313,45.313
2,0.500,Opossum,16-23,2,1,0,3,66.667,66.667
2,0.500,Opossum,23-5,2,9,0,11,18.182,18.182
2,0.500,Cow,16-23,1361,575,0,1936,70.300,70.300
2,0.500,Cow,23-5,1347,598,0,1945,69.254,69.254
2,0.500,Deer Mouse,16-23,0,0,0,0,NaN,NaN
2,0.500,Deer Mouse,23-5,0,0,0,0,NaN,NaN
2,0.500,OVERALL,16-23,4005,2343,0,6348,63.091,63.091
2,0.500,OVERALL,23-5,4710,2900,0,7610,61.892,61.892
2,0.900,Chicken,16-23,20,45,0,65,30.769,30.769
2,0.900,Chicken,23-5,27,26,0,53,50.943,50.943
2,0.900,Sea Lion,16-23,2,1,0,3,66.667,66.667
2,0.900,Sea Lion,23-5,4,5,0,9,44.444,44.444
2,0.900,Hu and Cw,16-23,24,37,0,61,39.344,39.344
2,0.900,Hu and Cw,23-5,15,49,0,64,23.438,23.438
2,0.900,Sheep,16-23,83,101,0,184,45.109,45.109
2,0.900,Sheep,23-5,76,54,0,130,58.462,58.462
2,0.900,Hu and Dg,16-23,8,23,0,31,25.806,25.806
2,0.900,Hu and Dg,23-5,18,15,0,33,54.545,54.545
2,0.900,Common Loon,16-23,0,0,0,0,NaN,NaN
2,0.900,Common Loon,23-5,0,6,0,6,0.000,0.000
2,0.900,Red-Winged Blackbird,16-23,2,6,0,8,25.000,25.000
2,0.900,Red-Winged Blackbird,23-5,1,8,0,9,11.111,11.111
2,0.900,Cw,16-23,14,20,0,34,41.176,41.176
2,0.900,Cw,23-5,35,55,0,90,38.889,38.889
2,0.900,Cliff Sparrow,16-23,20,45,0,65,30.769,30.769
2,0.900,Cliff Sparrow,23-5,14,35,0,49,28.571,28.571
2,0.900,Pig,16-23,21,21,0,42,50.000,50.000
2,0.900,Pig,23-5,19,23,0,42,45.238,45.238
2,0.900,Barn Owl,16-23,0,0,0,0,NaN,NaN
2,0.900,Barn Owl,23-5,0,3,0,3,0.000,0.000
2,0.900,Wild Pig,16-23,10,15,0,25,40.000,40.000
2,0.900,Wild Pig,23-5,11,10,0,21,52.381,52.381
2,0.900,Pennington Creek Water,16-23,0,0,0,0,NaN,NaN
2,0.900,Pennington Creek Water,23-5,0,0,0,0,NaN,NaN
2,0.900,Guinni,16-23,0,0,0,0,NaN,NaN
2,0.900,Guinni,23-5,0,2,0,2,0.000,0.000
2,0.900,Racoon,16-23,2,3,0,5,40.000,40.000
2,0.900,Racoon,23-5,0,7,0,7,0.000,0.000
2,0.900,Hu,16-23,15,7,0,22,68.182,68.182
2,0.900,Hu,23-5,21,5,0,26,80.769,80.769
2,0.900,Cw and Dg,16-23,5,6,0,11,45.455,45.455
2,0.900,Cw and Dg,23-5,14,8,0,22,63.636,63.636
2,0.900,Red Wind Blackbird,16-23,0,1,0,1,0.000,0.000
2,0.900,Red Wind Blackbird,23-5,0,2,0,2,0.000,0.000
2,0.900,Tree Swallow,16-23,2,6,0,8,25.000,25.000
2,0.900,Tree Swallow,23-5,0,2,0,2,0.000,0.000
2,0.900,Turkey Vulture,16-23,0,4,0,4,0.000,0.000
2,0.900,Turkey Vulture,23-5,0,4,0,4,0.000,0.000
2,0.900,Dg,16-23,13,21,0,34,38.235,38.235
2,0.900,Dg,23-5,29,20,0,49,59.184,59.184
2,0.900,Western Kingbird,16-23,0,3,0,3,0.000,0.000
2,0.900,Western Kingbird,23-5,0,2,0,2,0.000,0.000
2,0.900,White Crowned Sparrow,16-23,13,10,0,23,56.522,56.522
2,0.900,White Crowned Sparrow,23-5,8,18,0,26,30.769,30.769
2,0.900,Eared Grebe,16-23,0,0,0,0,NaN,NaN
2,0.900,Eared Grebe,23-5,3,12,0,15,20.000,20.000
2,0.900,cougar,16-23,0,1,0,1,0.000,0.000
2,0.900,cougar,23-5,0,0,0,0,NaN,NaN
2,0.900,Ocean Water,16-23,0,0,0,0,NaN,NaN
2,0.900,Ocean Water,23-5,0,0,0,0,NaN,NaN
2,0.900,Red Tailed Hawk,16-23,2,2,0,4,50.000,50.000
2,0.900,Red Tailed Hawk,23-5,0,14,0,14,0.000,0.000
2,0.900,Dog,16-23,89,106,0,195,45.641,45.641
2,0.900,Dog,23-5,144,160,0,304,47.368,47.368
2,0.900,Human,16-23,1768,540,0,2308,76.603,76.603
2,0.900,Human,23-5,2232,408,0,2640,84.545,84.545
2,0.900,Wild Turkey,16-23,15,85,0,100,15.000,15.000
2,0.900,Wild Turkey,23-5,17,87,0,104,16.346,16.346
2,0.900,Clark Grebe,16-23,0,0,0,0,NaN,NaN
2,0.900,Clark Grebe,23-5,0,3,0,3,0.000,0.000
2,0.900,Seagull,16-23,0,0,0,0,NaN,NaN
2,0.900,Seagull,23-5,47,10,0,57,82.456,82.456
2,0.900,Surf Scoter,16-23,0,0,0,0,NaN,NaN
2,0.900,Surf Scoter,23-5,0,2,0,2,0.000,0.000
2,0.900,Pigeon,16-23,142,218,0,360,39.444,39.444
2,0.900,Pigeon,23-5,181,436,0,617,29.335,29.335
2,0.900,Pacific Ocean Water,16-23,0,0,0,0,NaN,NaN
2,0.900,Pacific Ocean Water,23-5,0,0,0,0,NaN,NaN
2,0.900,Cat,16-23,46,40,0,86,53.488,53.488
2,0.900,Cat,23-5,50,49,0,99,50.505,50.505
2,0.900,Horse,16-23,23,72,0,95,24.211,24.211
2,0.900,Horse,23-5,54,358,0,412,13.107,13.107
2,0.900,orangutan,16-23,0,0,0,0,NaN,NaN
2,0.900,orangutan,23-5,0,0,0,0,NaN,NaN
2,0.900,Bat,16-23,36,11,0,47,76.596,76.596
2,0.900,Bat,23-5,37,20,0,57,64.912,64.912
2,0.900,Deer,16-23,15,29,0,44,34.091,34.091
2,0.900,Deer,23-5,18,69,0,87,20.690,20.690
2,0.900,Great Horned Owl,16-23,0,3,0,3,0.000,0.000
2,0.900,Great Horned Owl,23-5,1,14,0,15,6.667,6.667
2,0.900,Freshwater Lagoon,16-23,0,0,0,0,NaN,NaN
2,0.900,Freshwater Lagoon,23-5,0,0,0,0,NaN,NaN
2,0.900,Unknown Avian,16-23,0,0,0,0,NaN,NaN
2,0.900,Unknown Avian,23-5,0,2,0,2,0.000,0.000
2,0.900,Human UTI,16-23,97,87,0,184,52.717,52.717
2,0.900,Human UTI,23-5,114,83,0,197,57.868,57.868
2,0.900,unknown,16-23,1,16,0,17,5.882,5.882
2,0.900,unknown,23-5,5,17,0,22,22.727,22.727
2,0.900,SLO Creek Water,16-23,0,0,0,0,NaN,NaN
2,0.900,SLO Creek Water,23-5,8,1,0,9,88.889,88.889
2,0.900,Pig/Swine,16-23,13,19,0,32,40.625,40.625
2,0.900,Pig/Swine,23-5,7,9,0,16,43.750,43.750
2,0.900,Klebsiella,16-23,0,0,0,0,NaN,NaN
2,0.900,Klebsiella,23-5,0,0,0,0,NaN,NaN
2,0.900,Hu Cw and Dg,16-23,19,27,0,46,41.304,41.304
2,0.900,Hu Cw and Dg,23-5,35,33,0,68,51.471,51.471
2,0.900,Ground Squirrel,16-23,122,132,0,254,48.031,48.031
2,0.900,Ground Squirrel,23-5,116,140,0,256,45.313,45.313
2,0.900,Opossum,16-23,2,1,0,3,66.667,66.667
2,0.900,Opossum,23-5,2,9,0,11,18.182,18.182
2,0.900,Cow,16-23,1361,575,0,1936,70.300,70.300
2,0.900,Cow,23-5,1347,597,0,1944,69.290,69.290
2,0.900,Deer Mouse,16-23,0,0,0,0,NaN,NaN
2,0.900,Deer Mouse,23-5,0,0,0,0,NaN,NaN
2,0.900,OVERALL,16-23,4005,2339,0,6344,63.131,63.131
2,0.900,OVERALL,23-5,4710,2892,0,7602,61.957,61.957
2,0.950,Chicken,16-23,20,45,0,65,30.769,30.769
2,0.950,Chicken,23-5,27,26,0,53,50.943,50.943
2,0.950,Sea Lion,16-23,2,1,0,3,66.667,66.667
2,0.950,Sea Lion,23-5,4,5,0,9,44.444,44.444
2,0.950,Hu and Cw,16-23,24,37,0,61,39.344,39.344
2,0.950,Hu and Cw,23-5,15,49,0,64,23.438,23.438
2,0.950,Sheep,16-23,83,101,0,184,45.109,45.109
2,0.950,Sheep,23-5,76,54,0,130,58.462,58.462
2,0.950,Hu and Dg,16-23,8,23,0,31,25.806,25.806
2,0.950,Hu and Dg,23-5,18,15,0,33,54.545,54.545
2,0.950,Common Loon,16-23,0,0,0,0,NaN,NaN
2,0.950,Common Loon,23-5,0,6,0,6,0.000,0.000
2,0.950,Red-Winged Blackbird,16-23,2,6,0,8,25.000,25.000
2,0.950,Red-Winged Blackbird,23-5,1,8,0,9,11.111,11.111
2,0.950,Cw,16-23,14,20,0,34,41.176,41.176
2,0.950,Cw,23-5,35,55,0,90,38.889,38.889
2,0.950,Cliff Sparrow,16-23,20,45,0,65,30.769,30.769
2,0.950,Cliff Sparrow,23-5,14,35,0,49,28.571,28.571
2,0.950,Pig,16-23,21,21,0,42,50.000,50.000
2,0.950,Pig,23-5,19,23,0,42,45.238,45.238
2,0.950,Barn Owl,16-23,0,0,0,0,NaN,NaN
2,0.950,Barn Owl,23-5,0,3,0,3,0.000,0.000
2,0.950,Wild Pig,16-23,10,15,0,25,40.000,40.000
2,0.950,Wild Pig,23-5,11,9,0,20,55.000,55.000
2,0.950,Pennington Creek Water,16-23,0,0,0,0,NaN,NaN
2,0.950,Pennington Creek Water,23-5,0,0,0,0,NaN,NaN
2,0.950,Guinni,16-23,0,0,0,0,NaN,NaN
2,0.950,Guinni,23-5,0,2,0,2,0.000,0.000
2,0.950,Racoon,16-23,2,3,0,5,40.000,40.000
2,0.950,Racoon,23-5,0,7,0,7,0.000,0.000
2,0.950,Hu,16-23,15,7,0,22,68.182,68.182
2,0.950,Hu,23-5,21,5,0,26,80.769,80.769
2,0.950,Cw and Dg,16-23,5,6,0,11,45.455,45.455
2,0.950,Cw and Dg,23-5,14,8,0,22,63.636,63.636
2,0.950,Red Wind Blackbird,16-23,0,1,0,1,0.000,0.000
2,0.950,Red Wind Blackbird,23-5,0,2,0,2,0.000,0.000
2,0.950,Tree Swallow,16-23,2,6,0,8,25.000,25.000
2,0.950,Tree Swallow,23-5,0,2,0,2,0.000,0.000
2,0.950,Turkey Vulture,16-23,0,4,0,4,0.000,0.000
2,0.950,Turkey Vulture,23-5,0,4,0,4,0.000,0.000
2,0.950,Dg,16-23,13,21,0,34,38.235,38.235
2,0.950,Dg,23-5,29,20,0,49,59.184,59.184
2,0.950,Western Kingbird,16-23,0,3,0,3,0.000,0.000
2,0.950,Western Kingbird,23-5,0,2,0,2,0.000,0.000
2,0.950,White Crowned Sparrow,16-23,13,10,0,23,56.522,56.522
2,0.950,White Crowned Sparrow,23-5,8,18,0,26,30.769,30.769
2,0.950,Eared Grebe,16-23,0,0,0,0,NaN,NaN
2,0.950,Eared Grebe,23-5,3,12,0,15,20.000,20.000
2,0.950,cougar,16-23,0,1,0,1,0.000,0.000
2,0.950,cougar,23-5,0,0,0,0,NaN,NaN
2,0.950,Ocean Water,16-23,0,0,0,0,NaN,NaN
2,0.950,Ocean Water,23-5,0,0,0,0,NaN,NaN
2,0.950,Red Tailed Hawk,16-23,2,2,0,4,50.000,50.000
2,0.950,Red Tailed Hawk,23-5,0,14,0,14,0.000,0.000
2,0.950,Dog,16-23,89,106,0,195,45.641,45.641
2,0.950,Dog,23-5,144,160,0,304,47.368,47.368
2,0.950,Human,16-23,1768,538,0,2306,76.670,76.670
2,0.950,Human,23-5,2233,402,0,2635,84.744,84.744
2,0.950,Wild Turkey,16-23,15,85,0,100,15.000,15.000
2,0.950,Wild Turkey,23-5,17,87,0,104,16.346,16.346
2,0.950,Clark Grebe,16-23,0,0,0,0,NaN,NaN
2,0.950,Clark Grebe,23-5,0,3,0,3,0.000,0.000
2,0.950,Seagull,16-23,0,0,0,0,NaN,NaN
2,0.950,Seagull,23-5,47,9,0,56,83.929,83.929
2,0.950,Surf Scoter,16-23,0,0,0,0,NaN,NaN
2,0.950,Surf Scoter,23-5,0,2,0,2,0.000,0.000
2,0.950,Pigeon,16-23,142,217,0,359,39.554,39.554
2,0.950,Pigeon,23-5,181,436,0,617,29.335,29.335
2,0.950,Pacific Ocean Water,16-23,0,0,0,0,NaN,NaN
2,0.950,Pacific Ocean Water,23-5,0,0,0,0,NaN,NaN
2,0.950,Cat,16-23,46,40,0,86,53.488,53.488
2,0.950,Cat,23-5,50,49,0,99,50.505,50.505
2,0.950,Horse,16-23,23,72,0,95,24.211,24.211
2,0.950,Horse,23-5,54,358,0,412,13.107,13.107
2,0.950,orangutan,16-23,0,0,0,0,NaN,NaN
2,0.950,orangutan,23-5,0,0,0,0,NaN,NaN
2,0.950,Bat,16-23,36,11,0,47,76.596,76.596
2,0.950,Bat,23-5,37,20,0,57,64.912,64.912
2,0.950,Deer,16-23,15,29,0,44,34.091,34.091
2,0.950,Deer,23-5,18,69,0,87,20.690,20.690
2,0.950,Great Horned Owl,16-23,0,3,0,3,0.000,0.000
2,0.950,Great Horned Owl,23-5,1,14,0,15,6.667,6.667
2,0.950,Freshwater Lagoon,16-23,0,0,0,0,NaN,NaN
2,0.950,Freshwater Lagoon,23-5,0,0,0,0,NaN,NaN
2,0.950,Unknown Avian,16-23,0,0,0,0,NaN,NaN
2,0.950,Unknown Avian,23-5,0,2,0,2,0.000,0.000
2,0.950,Human UTI,16-23,97,87,0,184,52.717,52.717
2,0.950,Human UTI,23-5,113,83,0,196,57.653,57.653
2,0.950,unknown,16-23,1,16,0,17,5.882,5.882
2,0.950,unknown,23-5,5,17,0,22,22.727,22.727
2,0.950,SLO Creek Water,16-23,0,0,0,0,NaN,NaN
2,0.950,SLO Creek Water,23-5,8,1,0,9,88.889,88.889
2,0.950,Pig/Swine,16-23,13,19,0,32,40.625,40.625
2,0.950,Pig/Swine,23-5,7,9,0,16,43.750,43.750
2,0.950,Klebsiella,16-23,0,0,0,0,NaN,NaN
2,0.950,Klebsiella,23-5,0,0,0,0,NaN,NaN
2,0.950,Hu Cw and Dg,16-23,19,27,0,46,41.304,41.304
2,0.950,Hu Cw and Dg,23-5,35,33,0,68,51.471,51.471
2,0.950,Ground Squirrel,16-23,122,132,0,254,48.031,48.031
2,0.950,Ground Squirrel,23-5,116,137,0,253,45.850,45.850
2,0.950,Opossum,16-23,2,1,0,3,66.667,66.667
2,0.950,Opossum,23-5,2,9,0,11,18.182,18.182
2,0.950,Cow,16-23,1361,561,0,1922,70.812,70.812
2,0.950,Cow,23-5,1346,597,0,1943,69.274,69.274
2,0.950,Deer Mouse,16-23,0,0,0,0,NaN,NaN
2,0.950,Deer Mouse,23-5,0,0,0,0,NaN,NaN
2,0.950,OVERALL,16-23,4005,2322,0,6327,63.300,63.300
2,0.950,OVERALL,23-5,4709,2881,0,7590,62.042,62.042
2,0.960,Chicken,16-23,20,45,0,65,30.769,30.769
2,0.960,Chicken,23-5,27,26,0,53,50.943,50.943
2,0.960,Sea Lion,16-23,2,1,0,3,66.667,66.667
2,0.960,Sea Lion,23-5,4,5,0,9,44.444,44.444
2,0.960,Hu and Cw,16-23,24,37,0,61,39.344,39.344
2,0.960,Hu and Cw,23-5,15,49,0,64,23.438,23.438
2,0.960,Sheep,16-23,83,101,0,184,45.109,45.109
2,0.960,Sheep,23-5,76,53,0,129,58.915,58.915
2,0.960,Hu and Dg,16-23,8,23,0,31,25.806,25.806
2,0.960,Hu and Dg,23-5,18,15,0,33,54.545,54.545
2,0.960,Common Loon,16-23,0,0,0,0,NaN,NaN
2,0.960,Common Loon,23-5,0,6,0,6,0.000,0.000
2,0.960,Red-Winged Blackbird,16-23,2,6,0,8,25.000,25.000
2,0.960,Red-Winged Blackbird,23-5,1,8,0,9,11.111,11.111
2,0.960,Cw,16-23,14,20,0,34,41.176,41.176
2,0.960,Cw,23-5,35,55,0,90,38.889,38.889
2,0.960,Cliff Sparrow,16-23,20,45,0,65,30.769,30.769
2,0.960,Cliff Sparrow,23-5,14,35,0,49,28.571,28.571
2,0.960,Pig,16-23,21,21,0,42,50.000,50.000
2,0.960,Pig,23-5,19,23,0,42,45.238,45.238
2,0.960,Barn Owl,16-23,0,0,0,0,NaN,NaN
2,0.960,Barn Owl,23-5,0,3,0,3,0.000,0.000
2,0.960,Wild Pig,16-23,10,15,0,25,40.000,40.000
2,0.960,Wild Pig,23-5,11,9,0,20,55.000,55.000
2,0.960,Pennington Creek Water,16-23,0,0,0,0,NaN,NaN
2,0.960,Pennington Creek Water,23-5,0,0,0,0,NaN,NaN
2,0.960,Guinni,16-23,0,0,0,0,NaN,NaN
2,0.960,Guinni,23-5,0,2,0,2,0.000,0.000
2,0.960,Racoon,16-23,2,3,0,5,40.000,40.000
2,0.960,Racoon,23-5,0,7,0,7,0.000,0.000
2,0.960,Hu,16-23,15,7,0,22,68.182,68.182
2,0.960,Hu,23-5,21,5,0,26,80.769,80.769
2,0.960,Cw and Dg,16-23,5,6,0,11,45.455,45.455
2,0.960,Cw and Dg,23-5,14,8,0,22,63.636,63.636
2,0.960,Red Wind Blackbird,16-23,0,1,0,1,0.000,0.000
2,0.960,Red Wind Blackbird,23-5,0,2,0,2,0.000,0.000
2,0.960,Tree Swallow,16-23,2,6,0,8,25.000,25.000
2,0.960,Tree Swallow,23-5,0,2,0,2,0.000,0.000
2,0.960,Turkey Vulture,16-23,0,4,0,4,0.000,0.000
2,0.960,Turkey Vulture,23-5,0,4,0,4,0.000,0.000
2,0.960,Dg,16-23,13,21,0,34,38.235,38.235
2,0.960,Dg,23-5,29,20,0,49,59.184,59.184
2,0.960,Western Kingbird,16-23,0,3,0,3,0.000,0.000
2,0.960,Western Kingbird,23-5,0,2,0,2,0.000,0.000
2,0.960,White Crowned Sparrow,16-23,13,10,0,23,56.522,56.522
2,0.960,White Crowned Sparrow,23-5,8,18,0,26,30.769,30.769
2,0.960,Eared Grebe,16-23,0,0,0,0,NaN,NaN
2,0.960,Eared Grebe,23-5,3,12,0,15,20.000,20.000
2,0.960,cougar,16-23,0,1,0,1,0.000,0.000
2,0.960,cougar,23-5,0,0,0,0,NaN,NaN
2,0.960,Ocean Water,16-23,0,0,0,0,NaN,NaN
2,0.960,Ocean Water,23-5,0,0,0,0,NaN,NaN
2,0.960,Red Tailed Hawk,16-23,2,2,0,4,50.000,50.000
2,0.960,Red Tailed Hawk,23-5,0,14,0,14,0.000,0.000
2,0.960,Dog,16-23,89,106,0,195,45.641,45.641
2,0.960,Dog,23-5,144,158,0,302,47.682,47.682
2,0.960,Human,16-23,1768,536,0,2304,76.736,76.736
2,0.960,Human,23-5,2235,394,0,2629,85.013,85.013
2,0.960,Wild Turkey,16-23,15,85,0,100,15.000,15.000
2,0.960,Wild Turkey,23-5,17,87,0,104,16.346,16.346
2,0.960,Clark Grebe,16-23,0,0,0,0,NaN,NaN
2,0.960,Clark Grebe,23-5,0,3,0,3,0.000,0.000
2,0.960,Seagull,16-23,0,0,0,0,NaN,NaN
2,0.960,Seagull,23-5,47,9,0,56,83.929,83.929
2,0.960,Surf Scoter,16-23,0,0,0,0,NaN,NaN
2,0.960,Surf Scoter,23-5,0,2,0,2,0.000,0.000
2,0.960,Pigeon,16-23,142,217,0,359,39.554,39.554
2,0.960,Pigeon,23-5,181,436,0,617,29.335,29.335
2,0.960,Pacific Ocean Water,16-23,0,0,0,0,NaN,NaN
2,0.960,Pacific Ocean Water,23-5,0,0,0,0,NaN,NaN
2,0.960,Cat,16-23,46,40,0,86,53.488,53.488
2,0.960,Cat,23-5,50,49,0,99,50.505,50.505
2,0.960,Horse,16-23,23,72,0,95,24.211,24.211
2,0.960,Horse,23-5,54,358,0,412,13.107,13.107
2,0.960,orangutan,16-23,0,0,0,0,NaN,NaN
2,0.960,orangutan,23-5,0,0,0,0,NaN,NaN
2,0.960,Bat,16-23,36,11,0,47,76.596,76.596
2,0.960,Bat,23-5,37,20,0,57,64.912,64.912
2,0.960,Deer,16-23,15,29,0,44,34.091,34.091
2,0.960,Deer,23-5,18,69,0,87,20.690,20.690
2,0.960,Great Horned Owl,16-23,0,3,0,3,0.000,0.000
2,0.960,Great Horned Owl,23-5,1,14,0,15,6.667,6.667
2,0.960,Freshwater Lagoon,16-23,0,0,0,0,NaN,NaN
2,0.960,Freshwater Lagoon,23-5,0,0,0,0,NaN,NaN
2,0.960,Unknown Avian,16-23,0,0,0,0,NaN,NaN
2,0.960,Unknown Avian,23-5,0,2,0,2,0.000,0.000
2,0.960,Human UTI,16-23,97,87,0,184,52.717,52.717
2,0.960,Human UTI,23-5,113,83,0,196,57.653,57.653
2,0.960,unknown,16-23,1,16,0,17,5.882,5.882
2,0.960,unknown,23-5,5,17,0,22,22.727,22.727
2,0.960,SLO Creek Water,16-23,0,0,0,0,NaN,NaN
2,0.960,SLO Creek Water,23-5,8,1,0,9,88.889,88.889
2,0.960,Pig/Swine,16-23,13,19,0,32,40.625,40.625
2,0.960,Pig/Swine,23-5,7,9,0,16,43.750,43.750
2,0.960,Klebsiella,16-23,0,0,0,0,NaN,NaN
2,0.960,Klebsiella,23-5,0,0,0,0,NaN,NaN
2,0.960,Hu Cw and Dg,16-23,19,27,0,46,41.304,41.304
2,0.960,Hu Cw and Dg,23-5,35,33,0,68,51.471,51.471
2,0.960,Ground Squirrel,16-23,122,132,0,254,48.031,48.031
2,0.960,Ground Squirrel,23-5,116,136,0,252,46.032,46.032
2,0.960,Opossum,16-23,2,1,0,3,66.667,66.667
2,0.960,Opossum,23-5,2,9,0,11,18.182,18.182
2,0.960,Cow,16-23,1359,554,0,1913,71.040,71.040
2,0.960,Cow,23-5,1346,597,0,1943,69.274,69.274
2,0.960,Deer Mouse,16-23,0,0,0,0,NaN,NaN
2,0.960,Deer Mouse,23-5,0,0,0,0,NaN,NaN
2,0.960,OVERALL,16-23,4003,2313,0,6316,63.379,63.379
2,0.960,OVERALL,23-5,4711,2869,0,7580,62.150,62.150
2,0.970,Chicken,16-23,20,45,0,65,30.769,30.769
2,0.970,Chicken,23-5,27,26,0,53,50.943,50.943
2,0.970,Sea Lion,16-23,2,1,0,3,66.667,66.667
2,0.970,Sea Lion,23-5,4,5,0,9,44.444,44.444
2,0.970,Hu and Cw,16-23,24,37,0,61,39.344,39.344
2,0.970,Hu and Cw,23-5,15,49,0,64,23.438,23.438
2,0.970,Sheep,16-23,83,101,0,184,45.109,45.109
2,0.970,Sheep,23-5,76,52,0,128,59.375,59.375
2,0.970,Hu and Dg,16-23,8,23,0,31,25.806,25.806
2,0.970,Hu and Dg,23-5,18,15,0,33,54.545,54.545
2,0.970,Common Loon,16-23,0,0,0,0,NaN,NaN
2,0.970,Common Loon,23-5,0,6,0,6,0.000,0.000
2,0.970,Red-Winged Blackbird,16-23,2,6,0,8,25.000,25.000
2,0.970,Red-Winged Blackbird,23-5,1,8,0,9,11.111,11.111
2,0.970,Cw,16-23,14,20,0,34,41.176,41.176
2,0.970,Cw,23-5,35,55,0,90,38.889,38.889
2,0.970,Cliff Sparrow,16-23,20,45,0,65,30.769,30.769
2,0.970,Cliff Sparrow,23-5,14,35,0,49,28.571,28.571
2,0.970,Pig,16-23,21,21,0,42,50.000,50.000
2,0.970,Pig,23-5,19,23,0,42,45.238,45.238
2,0.970,Barn Owl,16-23,0,0,0,0,NaN,NaN
2,0.970,Barn Owl,23-5,0,3,0,3,0.000,0.000
2,0.970,Wild Pig,16-23,10,15,0,25,40.000,40.000
2,0.970,Wild Pig,23-5,10,9,0,19,52.632,52.632
2,0.970,Pennington Creek Water,16-23,0,0,0,0,NaN,NaN
2,0.970,Pennington Creek Water,23-5,0,0,0,0,NaN,NaN
2,0.970,Guinni,16-23,0,0,0,0,NaN,NaN
2,0.970,Guinni,23-5,0,2,0,2,0.000,0.000
2,0.970,Racoon,16-23,2,3,0,5,40.000,40.000
2,0.970,Racoon,23-5,0,7,0,7,0.000,0.000
2,0.970,Hu,16-23,15,7,0,22,68.182,68.182
2,0.970,Hu,23-5,21,5,0,26,80.769,80.769
2,0.970,Cw and Dg,16-23,5,6,0,11,45.455,45.455
2,0.970,Cw and Dg,23-5,14,8,0,22,63.636,63.636
2,0.970,Red Wind Blackbird,16-23,0,1,0,1,0.000,0.000
2,0.970,Red Wind Blackbird,23-5,0,2,0,2,0.000,0.000
2,0.970,Tree Swallow,16-23,2,6,0,8,25.000,25.000
2,0.970,Tree Swallow,23-5,0,2,0,2,0.000,0.000
2,0.970,Turkey Vulture,16-23,0,4,0,4,0.000,0.000
2,0.970,Turkey Vulture,23-5,0,4,0,4,0.000,0.000
2,0.970,Dg,16-23,13,21,0,34,38.235,38.235
2,0.970,Dg,23-5,29,19,0,48,60.417,60.417
2,0.970,Western Kingbird,16-23,0,3,0,3,0.000,0.000
2,0.970,Western Kingbird,23-5,0,2,0,2,0.000,0.000
2,0.970,White Crowned Sparrow,16-23,13,10,0,23,56.522,56.522
2,0.970,White Crowned Sparrow,23-5,8,18,0,26,30.769,30.769
2,0.970,Eared Grebe,16-23,0,0,0,0,NaN,NaN
2,0.970,Eared Grebe,23-5,3,12,0,15,20.000,20.000
2,0.970,cougar,16-23,0,1,0,1,0.000,0.000
2,0.970,cougar,23-5,0,0,0,0,NaN,NaN
2,0.970,Ocean Water,16-23,0,0,0,0,NaN,NaN
2,0.970,Ocean Water,23-5,0,0,0,0,NaN,NaN
2,0.970,Red Tailed Hawk,16-23,2,2,0,4,50.000,50.000
2,0.970,Red Tailed Hawk,23-5,0,14,0,14,0.000,0.000
2,0.970,Dog,16-23,89,106,0,195,45.641,45.641
2,0.970,Dog,23-5,144,157,0,301,47.841,47.841
2,0.970,Human,16-23,1768,532,0,2300,76.870,76.870
2,0.970,Human,23-5,2233,393,0,2626,85.034,85.034
2,0.970,Wild Turkey,16-23,15,85,0,100,15.000,15.000
2,0.970,Wild Turkey,23-5,17,83,0,100,17.000,17.000
2,0.970,Clark Grebe,16-23,0,0,0,0,NaN,NaN
2,0.970,Clark Grebe,23-5,0,3,0,3,0.000,0.000
2,0.970,Seagull,16-23,0,0,0,0,NaN,NaN
2,0.970,Seagull,23-5,47,9,0,56,83.929,83.929
2,0.970,Surf Scoter,16-23,0,0,0,0,NaN,NaN
2,0.970,Surf Scoter,23-5,0,2,0,2,0.000,0.000
2,0.970,Pigeon,16-23,140,217,0,357,39.216,39.216
2,0.970,Pigeon,23-5,181,436,0,617,29.335,29.335
2,0.970,Pacific Ocean Water,16-23,0,0,0,0,NaN,NaN
2,0.970,Pacific Ocean Water,23-5,0,0,0,0,NaN,NaN
2,0.970,Cat,16-23,46,39,0,85,54.118,54.118
2,0.970,Cat,23-5,50,49,0,99,50.505,50.505
2,0.970,Horse,16-23,23,72,0,95,24.211,24.211
2,0.970,Horse,23-5,54,358,0,412,13.107,13.107
2,0.970,orangutan,16-23,0,0,0,0,NaN,NaN
2,0.970,orangutan,23-5,0,0,0,0,NaN,NaN
2,0.970,Bat,16-23,36,11,0,47,76.596,76.596
2,0.970,Bat,23-5,37,20,0,57,64.912,64.912
2,0.970,Deer,16-23,15,29,0,44,34.091,34.091
2,0.970,Deer,23-5,18,69,0,87,20.690,20.690
2,0.970,Great Horned Owl,16-23,0,3,0,3,0.000,0.000
2,0.970,Great Horned Owl,23-5,1,14,0,15,6.667,6.667
2,0.970,Freshwater Lagoon,16-23,0,0,0,0,NaN,NaN
2,0.970,Freshwater Lagoon,23-5,0,0,0,0,NaN,NaN
2,0.970,Unknown Avian,16-23,0,0,0,0,NaN,NaN
2,0.970,Unknown Avian,23-5,0,2,0,2,0.000,0.000
2,0.970,Human UTI,16-23,98,87,0,185,52.973,52.973
2,0.970,Human UTI,23-5,111,84,0,195,56.923,56.923
2,0.970,unknown,16-23,1,16,0,17,5.882,5.882
2,0.970,unknown,23-5,5,17,0,22,22.727,22.727
2,0.970,SLO Creek Water,16-23,0,0,0,0,NaN,NaN
2,0.970,SLO Creek Water,23-5,8,1,0,9,88.889,88.889
2,0.970,Pig/Swine,16-23,13,19,0,32,40.625,40.625
2,0.970,Pig/Swine,23-5,7,9,0,16,43.750,43.750
2,0.970,Klebsiella,16-23,0,0,0,0,NaN,NaN
2,0.970,Klebsiella,23-5,0,0,0,0,NaN,NaN
2,0.970,Hu Cw and Dg,16-23,19,27,0,46,41.304,41.304
2,0.970,Hu Cw and Dg,23-5,35,33,0,68,51.471,51.471
2,0.970,Ground Squirrel,16-23,121,130,0,251,48.207,48.207
2,0.970,Ground Squirrel,23-5,116,134,0,250,46.400,46.400
2,0.970,Opossum,16-23,2,1,0,3,66.667,66.667
2,0.970,Opossum,23-5,2,9,0,11,18.182,18.182
2,0.970,Cow,16-23,1356,556,0,1912,70.921,70.921
2,0.970,Cow,23-5,1345,593,0,1938,69.401,69.401
2,0.970,Deer Mouse,16-23,0,0,0,0,NaN,NaN
2,0.970,Deer Mouse,23-5,0,0,0,0,NaN,NaN
2,0.970,OVERALL,16-23,3998,2308,0,6306,63.400,63.400
2,0.970,OVERALL,23-5,4705,2856,0,7561,62.227,62.227
2,0.980,Chicken,16-23,20,45,0,65,30.769,30.769
2,0.980,Chicken,23-5,27,26,0,53,50.943,50.943
2,0.980,Sea Lion,16-23,2,1,0,3,66.667,66.667
2,0.980,Sea Lion,23-5,4,5,0,9,44.444,44.444
2,0.980,Hu and Cw,16-23,24,37,0,61,39.344,39.344
2,0.980,Hu and Cw,23-5,15,49,0,64,23.438,23.438
2,0.980,Sheep,16-23,83,99,0,182,45.604,45.604
2,0.980,Sheep,23-5,75,51,0,126,59.524,59.524
2,0.980,Hu and Dg,16-23,8,23,0,31,25.806,25.806
2,0.980,Hu and Dg,23-5,18,15,0,33,54.545,54.545
2,0.980,Common Loon,16-23,0,0,0,0,NaN,NaN
2,0.980,Common Loon,23-5,0,5,0,5,0.000,0.000
2,0.980,Red-Winged Blackbird,16-23,2,6,0,8,25.000,25.000
2,0.980,Red-Winged Blackbird,23-5,1,8,0,9,11.111,11.111
2,0.980,Cw,16-23,14,19,0,33,42.424,42.424
2,0.980,Cw,23-5,35,54,0,89,39.326,39.326
2,0.980,Cliff Sparrow,16-23,20,43,0,63,31.746,31.746
2,0.980,Cliff Sparrow,23-5,14,35,0,49,28.571,28.571
2,0.980,Pig,16-23,21,21,0,42,50.000,50.000
2,0.980,Pig,23-5,19,23,0,42,45.238,45.238
2,0.980,Barn Owl,16-23,0,0,0,0,NaN,NaN
2,0.980,Barn Owl,23-5,0,3,0,3,0.000,0.000
2,0.980,Wild Pig,16-23,10,15,0,25,40.000,40.000
2,0.980,Wild Pig,23-5,10,9,0,19,52.632,52.632
2,0.980,Pennington Creek Water,16-23,0,0,0,0,NaN,NaN
2,0.980,Pennington Creek Water,23-5,0,0,0,0,NaN,NaN
2,0.980,Guinni,16-23,0,0,0,0,NaN,NaN
2,0.980,Guinni,23-5,0,2,0,2,0.000,0.000
2,0.980,Racoon,16-23,2,3,0,5,40.000,40.000
2,0.980,Racoon,23-5,0,7,0,7,0.000,0.000
2,0.980,Hu,16-23,15,7,0,22,68.182,68.182
2,0.980,Hu,23-5,21,5,0,26,80.769,80.769
2,0.980,Cw and Dg,16-23,5,6,0,11,45.455,45.455
2,0.980,Cw and Dg,23-5,14,8,0,22,63.636,63.636
2,0.980,Red Wind Blackbird,16-23,0,1,0,1,0.000,0.000
2,0.980,Red Wind Blackbird,23-5,0,2,0,2,0.000,0.000
2,0.980,Tree Swallow,16-23,2,6,0,8,25.000,25.000
2,0.980,Tree Swallow,23-5,0,2,0,2,0.000,0.000
2,0.980,Turkey Vulture,16-23,0,4,0,4,0.000,0.000
2,0.980,Turkey Vulture,23-5,0,4,0,4,0.000,0.000
2,0.980,Dg,16-23,13,21,0,34,38.235,38.235
2,0.980,Dg,23-5,29,19,0,48,60.417,60.417
2,0.980,Western Kingbird,16-23,0,3,0,3,0.000,0.000
2,0.980,Western Kingbird,23-5,0,2,0,2,0.000,0.000
2,0.980,White Crowned Sparrow,16-23,13,10,0,23,56.522,56.522
2,0.980,White Crowned Sparrow,23-5,8,18,0,26,30.769,30.769
2,0.980,Eared Grebe,16-23,0,0,0,0,NaN,NaN
2,0.980,Eared Grebe,23-5,3,12,0,15,20.000,20.000
2,0.980,cougar,16-23,0,1,0,1,0.000,0.000
2,0.980,cougar,23-5,0,0,0,0,NaN,NaN
2,0.980,Ocean Water,16-23,0,0,0,0,NaN,NaN
2,0.980,Ocean Water,23-5,0,0,0,0,NaN,NaN
2,0.980,Red Tailed Hawk,16-23,2,2,0,4,50.000,50.000
2,0.980,Red Tailed Hawk,23-5,0,13,0,13,0.000,0.000
2,0.980,Dog,16-23,88,106,0,194,45.361,45.361
2,0.980,Dog,23-5,144,155,0,299,48.161,48.161
2,0.980,Human,16-23,1767,524,0,2291,77.128,77.128
2,0.980,Human,23-5,2234,385,0,2619,85.300,85.300
2,0.980,Wild Turkey,16-23,15,85,0,100,15.000,15.000
2,0.980,Wild Turkey,23-5,17,83,0,100,17.000,17.000
2,0.980,Clark Grebe,16-23,0,0,0,0,NaN,NaN
2,0.980,Clark Grebe,23-5,0,3,0,3,0.000,0.000
2,0.980,Seagull,16-23,0,0,0,0,NaN,NaN
2,0.980,Seagull,23-5,49,7,0,56,87.500,87.500
2,0.980,Surf Scoter,16-23,0,0,0,0,NaN,NaN
2,0.980,Surf Scoter,23-5,2,0,0,2,100.000,100.000
2,0.980,Pigeon,16-23,140,215,0,355,39.437,39.437
2,0.980,Pigeon,23-5,180,431,0,611,29.460,29.460
2,0.980,Pacific Ocean Water,16-23,0,0,0,0,NaN,NaN
2,0.980,Pacific Ocean Water,23-5,0,0,0,0,NaN,NaN
2,0.980,Cat,16-23,46,39,0,85,54.118,54.118
2,0.980,Cat,23-5,50,47,0,97,51.546,51.546
2,0.980,Horse,16-23,23,72,0,95,24.211,24.211
2,0.980,Horse,23-5,54,354,0,408,13.235,13.235
2,0.980,orangutan,16-23,0,0,0,0,NaN,NaN
2,0.980,orangutan,23-5,0,0,0,0,NaN,NaN
2,0.980,Bat,16-23,36,11,0,47,76.596,76.596
2,0.980,Bat,23-5,37,20,0,57,64.912,64.912
2,0.980,Deer,16-23,15,29,0,44,34.091,34.091
2,0.980,Deer,23-5,18,69,0,87,20.690,20.690
2,0.980,Great Horned Owl,16-23,0,3,0,3,0.000,0.000
2,0.980,Great Horned Owl,23-5,1,14,0,15,6.667,6.667
2,0.980,Freshwater Lagoon,16-23,0,0,0,0,NaN,NaN
2,0.980,Freshwater Lagoon,23-5,0,0,0,0,NaN,NaN
2,0.980,Unknown Avian,16-23,0,0,0,0,NaN,NaN
2,0.980,Unknown Avian,23-5,0,2,0,2,0.000,0.000
2,0.980,Human UTI,16-23,98,85,0,183,53.552,53.552
2,0.980,Human UTI,23-5,111,81,0,192,57.813,57.813
2,0.980,unknown,16-23,1,16,0,17,5.882,5.882
2,0.980,unknown,23-5,5,17,0,22,22.727,22.727
2,0.980,SLO Creek Water,16-23,0,0,0,0,NaN,NaN
2,0.980,SLO Creek Water,23-5,8,1,0,9,88.889,88.889
2,0.980,Pig/Swine,16-23,13,18,0,31,41.935,41.935
2,0.980,Pig/Swine,23-5,7,9,0,16,43.750,43.750
2,0.980,Klebsiella,16-23,0,0,0,0,NaN,NaN
2,0.980,Klebsiella,23-5,0,0,0,0,NaN,NaN
2,0.980,Hu Cw and Dg,16-23,19,27,0,46,41.304,41.304
2,0.980,Hu Cw and Dg,23-5,35,33,0,68,51.471,51.471
2,0.980,Ground Squirrel,16-23,119,130,0,249,47.791,47.791
2,0.980,Ground Squirrel,23-5,117,131,0,248,47.177,47.177
2,0.980,Opossum,16-23,2,1,0,3,66.667,66.667
2,0.980,Opossum,23-5,2,9,0,11,18.182,18.182
2,0.980,Cow,16-23,1355,551,0,1906,71.091,71.091
2,0.980,Cow,23-5,1340,590,0,1930,69.430,69.430
2,0.980,Deer Mouse,16-23,0,0,0,0,NaN,NaN
2,0.980,Deer Mouse,23-5,0,0,0,0,NaN,NaN
2,0.980,OVERALL,16-23,3993,2285,0,6278,63.603,63.603
2,0.980,OVERALL,23-5,4704,2818,0,7522,62.537,62.537
2,0.990,Chicken,16-23,20,42,0,62,32.258,32.258
2,0.990,Chicken,23-5,27,24,0,51,52.941,52.941
2,0.990,Sea Lion,16-23,2,1,0,3,66.667,66.667
2,0.990,Sea Lion,23-5,4,5,0,9,44.444,44.444
2,0.990,Hu and Cw,16-23,23,37,0,60,38.333,38.333
2,0.990,Hu and Cw,23-5,15,46,0,61,24.590,24.590
2,0.990,Sheep,16-23,82,94,0,176,46.591,46.591
2,0.990,Sheep,23-5,75,51,0,126,59.524,59.524
2,0.990,Hu and Dg,16-23,8,23,0,31,25.806,25.806
2,0.990,Hu and Dg,23-5,18,14,0,32,56.250,56.250
2,0.990,Common Loon,16-23,0,0,0,0,NaN,NaN
2,0.990,Common Loon,23-5,0,5,0,5,0.000,0.000
2,0.990,Red-Winged Blackbird,16-23,2,5,0,7,28.571,28.571
2,0.990,Red-Winged Blackbird,23-5,1,8,0,9,11.111,11.111
2,0.990,Cw,16-23,14,19,0,33,42.424,42.424
2,0.990,Cw,23-5,35,51,0,86,40.698,40.698
2,0.990,Cliff Sparrow,16-23,20,41,0,61,32.787,32.787
2,0.990,Cliff Sparrow,23-5,14,35,0,49,28.571,28.571
2,0.990,Pig,16-23,21,20,0,41,51.220,51.220
2,0.990,Pig,23-5,19,23,0,42,45.238,45.238
2,0.990,Barn Owl,16-23,0,0,0,0,NaN,NaN
2,0.990,Barn Owl,23-5,0,2,0,2,0.000,0.000
2,0.990,Wild Pig,16-23,10,14,0,24,41.667,41.667
2,0.990,Wild Pig,23-5,10,9,0,19,52.632,52.632
2,0.990,Pennington Creek Water,16-23,0,0,0,0,NaN,NaN
2,0.990,Pennington Creek Water,23-5,0,0,0,0,NaN,NaN
2,0.990,Guinni,16-23,0,0,0,0,NaN,NaN
2,0.990,Guinni,23-5,0,1,0,1,0.000,0.000
2,0.990,Racoon,16-23,2,3,0,5,40.000,40.000
2,0.990,Racoon,23-5,0,6,0,6,0.000,0.000
2,0.990,Hu,16-23,15,6,0,21,71.429,71.429
2,0.990,Hu,23-5,21,4,0,25,84.000,84.000
2,0.990,Cw and Dg,16-23,5,6,0,11,45.455,45.455
2,0.990,Cw and Dg,23-5,14,8,0,22,63.636,63.636
2,0.990,Red Wind Blackbird,16-23,0,1,0,1,0.000,0.000
2,0.990,Red Wind Blackbird,23-5,0,2,0,2,0.000,0.000
2,0.990,Tree Swallow,16-23,2,6,0,8,25.000,25.000
2,0.990,Tree Swallow,23-5,0,2,0,2,0.000,0.000
2,0.990,Turkey Vulture,16-23,0,4,0,4,0.000,0.000
2,0.990,Turkey Vulture,23-5,0,4,0,4,0.000,0.000
2,0.990,Dg,16-23,13,21,0,34,38.235,38.235
2,0.990,Dg,23-5,29,19,0,48,60.417,60.417
2,0.990,Western Kingbird,16-23,0,3,0,3,0.000,0.000
2,0.990,Western Kingbird,23-5,0,2,0,2,0.000,0.000
2,0.990,White Crowned Sparrow,16-23,13,9,0,22,59.091,59.091
2,0.990,White Crowned Sparrow,23-5,8,17,0,25,32.000,32.000
2,0.990,Eared Grebe,16-23,0,0,0,0,NaN,NaN
2,0.990,Eared Grebe,23-5,3,11,0,14,21.429,21.429
2,0.990,cougar,16-23,0,1,0,1,0.000,0.000
2,0.990,cougar,23-5,0,0,0,0,NaN,NaN
2,0.990,Ocean Water,16-23,0,0,0,0,NaN,NaN
2,0.990,Ocean Water,23-5,0,0,0,0,NaN,NaN
2,0.990,Red Tailed Hawk,16-23,2,2,0,4,50.000,50.000
2,0.990,Red Tailed Hawk,23-5,0,13,0,13,0.000,0.000
2,0.990,Dog,16-23,88,100,0,188,46.809,46.809
2,0.990,Dog,23-5,144,149,0,293,49.147,49.147
2,0.990,Human,16-23,1755,496,0,2251,77.965,77.965
2,0.990,Human,23-5,2228,369,0,2597,85.791,85.791
2,0.990,Wild Turkey,16-23,16,74,0,90,17.778,17.778
2,0.990,Wild Turkey,23-5,14,62,0,76,18.421,18.421
2,0.990,Clark Grebe,16-23,0,0,0,0,NaN,NaN
2,0.990,Clark Grebe,23-5,2,4,0,6,33.333,33.333
2,0.990,Seagull,16-23,0,0,0,0,NaN,NaN
2,0.990,Seagull,23-5,49,7,0,56,87.500,87.500
2,0.990,Surf Scoter,16-23,0,0,0,0,NaN,NaN
2,0.990,Surf Scoter,23-5,2,0,0,2,100.000,100.000
2,0.990,Pigeon,16-23,139,206,0,345,40.290,40.290
2,0.990,Pigeon,23-5,181,400,0,581,31.153,31.153
2,0.990,Pacific Ocean Water,16-23,0,0,0,0,NaN,NaN
2,0.990,Pacific Ocean Water,23-5,0,0,0,0,NaN,NaN
2,0.990,Cat,16-23,46,36,0,82,56.098,56.098
2,0.990,Cat,23-5,49,44,0,93,52.688,52.688
2,0.990,Horse,16-23,23,69,0,92,25.000,25.000
2,0.990,Horse,23-5,53,341,0,394,13.452,13.452
2,0.990,orangutan,16-23,0,0,0,0,NaN,NaN
2,0.990,orangutan,23-5,0,0,0,0,NaN,NaN
2,0.990,Bat,16-23,36,11,0,47,76.596,76.596
2,0.990,Bat,23-5,37,19,0,56,66.071,66.071
2,0.990,Deer,16-23,15,29,0,44,34.091,34.091
2,0.990,Deer,23-5,18,68,0,86,20.930,20.930
2,0.990,Great Horned Owl,16-23,0,3,0,3,0.000,0.000
2,0.990,Great Horned Owl,23-5,1,14,0,15,6.667,6.667
2,0.990,Freshwater Lagoon,16-23,0,0,0,0,NaN,NaN
2,0.990,Freshwater Lagoon,23-5,0,0,0,0,NaN,NaN
2,0.990,Unknown Avian,16-23,0,0,0,0,NaN,NaN
2,0.990,Unknown Avian,23-5,0,2,0,2,0.000,0.000
2,0.990,Human UTI,16-23,99,78,0,177,55.932,55.932
2,0.990,Human UTI,23-5,111,66,0,177,62.712,62.712
2,0.990,unknown,16-23,1,16,0,17,5.882,5.882
2,0.990,unknown,23-5,5,15,0,20,25.000,25.000
2,0.990,SLO Creek Water,16-23,0,0,0,0,NaN,NaN
2,0.990,SLO Creek Water,23-5,8,1,0,9,88.889,88.889
2,0.990,Pig/Swine,16-23,12,16,0,28,42.857,42.857
2,0.990,Pig/Swine,23-5,7,8,0,15,46.667,46.667
2,0.990,Klebsiella,16-23,0,0,0,0,NaN,NaN
2,0.990,Klebsiella,23-5,0,0,0,0,NaN,NaN
2,0.990,Hu Cw and Dg,16-23,19,27,0,46,41.304,41.304
2,0.990,Hu Cw and Dg,23-5,35,31,0,66,53.030,53.030
2,0.990,Ground Squirrel,16-23,118,122,0,240,49.167,49.167
2,0.990,Ground Squirrel,23-5,115,122,0,237,48.523,48.523
2,0.990,Opossum,16-23,2,1,0,3,66.667,66.667
2,0.990,Opossum,23-5,4,9,0,13,30.769,30.769
2,0.990,Cow,16-23,1339,521,0,1860,71.989,71.989
2,0.990,Cow,23-5,1323,554,0,1877,70.485,70.485
2,0.990,Deer Mouse,16-23,0,0,0,0,NaN,NaN
2,0.990,Deer Mouse,23-5,0,0,0,0,NaN,NaN
2,0.990,OVERALL,16-23,3962,2163,0,6125,64.686,64.686
2,0.990,OVERALL,23-5,4679,2647,0,7326,63.868,63.868
2,1.000,Chicken,16-23,0,0,0,0,NaN,NaN
2,1.000,Chicken,23-5,0,0,0,0,NaN,NaN
2,1.000,Sea Lion,16-23,0,0,0,0,NaN,NaN
2,1.000,Sea Lion,23-5,0,0,0,0,NaN,NaN
2,1.000,Hu and Cw,16-23,0,0,0,0,NaN,NaN
2,1.000,Hu and Cw,23-5,0,0,0,0,NaN,NaN
2,1.000,Sheep,16-23,0,0,0,0,NaN,NaN
2,1.000,Sheep,23-5,0,0,0,0,NaN,NaN
2,1.000,Hu and Dg,16-23,0,0,0,0,NaN,NaN
2,1.000,Hu and Dg,23-5,0,0,0,0,NaN,NaN
2,1.000,Common Loon,16-23,0,0,0,0,NaN,NaN
2,1.000,Common Loon,23-5,0,0,0,0,NaN,NaN
2,1.000,Red-Winged Blackbird,16-23,0,0,0,0,NaN,NaN
2,1.000,Red-Winged Blackbird,23-5,0,0,0,0,NaN,NaN
2,1.000,Cw,16-23,0,0,0,0,NaN,NaN
2,1.000,Cw,23-5,0,0,0,0,NaN,NaN
2,1.000,Cliff Sparrow,16-23,0,0,0,0,NaN,NaN
2,1.000,Cliff Sparrow,23-5,0,0,0,0,NaN,NaN
2,1.000,Pig,16-23,0,0,0,0,NaN,NaN
2,1.000,Pig,23-5,0,0,0,0,NaN,NaN
2,1.000,Barn Owl,16-23,0,0,0,0,NaN,NaN
2,1.000,Barn Owl,23-5,0,0,0,0,NaN,NaN
2,1.000,Wild Pig,16-23,0,0,0,0,NaN,NaN
2,1.000,Wild Pig,23-5,0,0,0,0,NaN,NaN
2,1.000,Pennington Creek Water,16-23,0,0,0,0,NaN,NaN
2,1.000,Pennington Creek Water,23-5,0,0,0,0,NaN,NaN
2,1.000,Guinni,16-23,0,0,0,0,NaN,NaN
2,1.000,Guinni,23-5,0,0,0,0,NaN,NaN
2,1.000,Racoon,16-23,0,0,0,0,NaN,NaN
2,1.000,Racoon,23-5,0,0,0,0,NaN,NaN
2,1.000,Hu,16-23,0,0,0,0,NaN,NaN
2,1.000,Hu,23-5,0,0,0,0,NaN,NaN
2,1.000,Cw and Dg,16-23,0,0,0,0,NaN,NaN
2,1.000,Cw and Dg,23-5,0,0,0,0,NaN,NaN
2,1.000,Red Wind Blackbird,16-23,0,0,0,0,NaN,NaN
2,1.000,Red Wind Blackbird,23-5,0,0,0,0,NaN,NaN
2,1.000,Tree Swallow,16-23,0,0,0,0,NaN,NaN
2,1.000,Tree Swallow,23-5,0,0,0,0,NaN,NaN
2,1.000,Turkey Vulture,16-23,0,0,0,0,NaN,NaN
2,1.000,Turkey Vulture,23-5,0,0,0,0,NaN,NaN
2,1.000,Dg,16-23,0,0,0,0,NaN,NaN
2,1.000,Dg,23-5,0,0,0,0,NaN,NaN
2,1.000,Western Kingbird,16-23,0,0,0,0,NaN,NaN
2,1.000,Western Kingbird,23-5,0,0,0,0,NaN,NaN
2,1.000,White Crowned Sparrow,16-23,0,0,0,0,NaN,NaN
2,1.000,White Crowned Sparrow,23-5,0,0,0,0,NaN,NaN
2,1.000,Eared Grebe,16-23,0,0,0,0,NaN,NaN
2,1.000,Eared Grebe,23-5,0,0,0,0,NaN,NaN
2,1.000,cougar,16-23,0,0,0,0,NaN,NaN
2,1.000,cougar,23-5,0,0,0,0,NaN,NaN
2,1.000,Ocean Water,16-23,0,0,0,0,NaN,NaN
2,1.000,Ocean Water,23-5,0,0,0,0,NaN,NaN
2,1.000,Red Tailed Hawk,16-23,0,0,0,0,NaN,NaN
2,1.000,Red Tailed Hawk,23-5,0,0,0,0,NaN,NaN
2,1.000,Dog,16-23,0,0,0,0,NaN,NaN
2,1.000,Dog,23-5,0,0,0,0,NaN,NaN
2,1.000,Human,16-23,68,0,0,68,100.000,100.000
2,1.000,Human,23-5,90,0,0,90,100.000,100.000
2,1.000,Wild Turkey,16-23,0,0,0,0,NaN,NaN
2,1.000,Wild Turkey,23-5,0,0,0,0,NaN,NaN
2,1.000,Clark Grebe,16-23,0,0,0,0,NaN,NaN
2,1.000,Clark Grebe,23-5,0,0,0,0,NaN,NaN
2,1.000,Seagull,16-23,0,0,0,0,NaN,NaN
2,1.000,Seagull,23-5,0,0,0,0,NaN,NaN
2,1.000,Surf Scoter,16-23,0,0,0,0,NaN,NaN
2,1.000,Surf Scoter,23-5,0,0,0,0,NaN,NaN
2,1.000,Pigeon,16-23,0,0,0,0,NaN,NaN
2,1.000,Pigeon,23-5,0,0,0,0,NaN,NaN
2,1.000,Pacific Ocean Water,16-23,0,0,0,0,NaN,NaN
2,1.000,Pacific Ocean Water,23-5,0,0,0,0,NaN,NaN
2,1.000,Cat,16-23,0,0,0,0,NaN,NaN
2,1.000,Cat,23-5,0,0,0,0,NaN,NaN
2,1.000,Horse,16-23,0,0,0,0,NaN,NaN
2,1.000,Horse,23-5,0,0,0,0,NaN,NaN
2,1.000,orangutan,16-23,0,0,0,0,NaN,NaN
2,1.000,orangutan,23-5,0,0,0,0,NaN,NaN
2,1.000,Bat,16-23,0,0,0,0,NaN,NaN
2,1.000,Bat,23-5,0,0,0,0,NaN,NaN
2,1.000,Deer,16-23,0,0,0,0,NaN,NaN
2,1.000,Deer,23-5,0,0,0,0,NaN,NaN
2,1.000,Great Horned Owl,16-23,0,0,0,0,NaN,NaN
2,1.000,Great Horned Owl,23-5,0,0,0,0,NaN,NaN
2,1.000,Freshwater Lagoon,16-23,0,0,0,0,NaN,NaN
2,1.000,Freshwater Lagoon,23-5,0,0,0,0,NaN,NaN
2,1.000,Unknown Avian,16-23,0,0,0,0,NaN,NaN
2,1.000,Unknown Avian,23-5,0,0,0,0,NaN,NaN
2,1.000,Human UTI,16-23,0,0,0,0,NaN,NaN
2,1.000,Human UTI,23-5,0,0,0,0,NaN,NaN
2,1.000,unknown,16-23,0,0,0,0,NaN,NaN
2,1.000,unknown,23-5,0,0,0,0,NaN,NaN
2,1.000,SLO Creek Water,16-23,0,0,0,0,NaN,NaN
2,1.000,SLO Creek Water,23-5,0,0,0,0,NaN,NaN
2,1.000,Pig/Swine,16-23,0,0,0,0,NaN,NaN
2,1.000,Pig/Swine,23-5,0,0,0,0,NaN,NaN
2,1.000,Klebsiella,16-23,0,0,0,0,NaN,NaN
2,1.000,Klebsiella,23-5,0,0,0,0,NaN,NaN
2,1.000,Hu Cw and Dg,16-23,0,0,0,0,NaN,NaN
2,1.000,Hu Cw and Dg,23-5,0,0,0,0,NaN,NaN
2,1.000,Ground Squirrel,16-23,0,0,0,0,NaN,NaN
2,1.000,Ground Squirrel,23-5,0,0,0,0,NaN,NaN
2,1.000,Opossum,16-23,0,0,0,0,NaN,NaN
2,1.000,Opossum,23-5,0,0,0,0,NaN,NaN
2,1.000,Cow,16-23,0,0,0,0,NaN,NaN
2,1.000,Cow,23-5,0,0,0,0,NaN,NaN
2,1.000,Deer Mouse,16-23,0,0,0,0,NaN,NaN
2,1.000,Deer Mouse,23-5,0,0,0,0,NaN,NaN
2,1.000,OVERALL,16-23,68,0,0,68,100.000,100.000
2,1.000,OVERALL,23-5,90,0,0,90,100.000,100.000
3,0.000,Chicken,16-23,9,27,0,36,25.000,25.000
3,0.000,Chicken,23-5,17,18,0,35,48.571,48.571
3,0.000,Sea Lion,16-23,1,1,0,2,50.000,50.000
3,0.000,Sea Lion,23-5,4,5,0,9,44.444,44.444
3,0.000,Hu and Cw,16-23,15,25,0,40,37.500,37.500
3,0.000,Hu and Cw,23-5,17,40,0,57,29.825,29.825
3,0.000,Sheep,16-23,68,72,0,140,48.571,48.571
3,0.000,Sheep,23-5,72,38,0,110,65.455,65.455
3,0.000,Hu and Dg,16-23,11,18,0,29,37.931,37.931
3,0.000,Hu and Dg,23-5,18,7,0,25,72.000,72.000
3,0.000,Common Loon,16-23,0,2,0,2,0.000,0.000
3,0.000,Common Loon,23-5,0,4,0,4,0.000,0.000
3,0.000,Red-Winged Blackbird,16-23,0,8,0,8,0.000,0.000
3,0.000,Red-Winged Blackbird,23-5,0,3,0,3,0.000,0.000
3,0.000,Cw,16-23,11,13,0,24,45.833,45.833
3,0.000,Cw,23-5,20,31,0,51,39.216,39.216
3,0.000,Cliff Sparrow,16-23,12,40,0,52,23.077,23.077
3,0.000,Cliff Sparrow,23-5,5,35,0,40,12.500,12.500
3,0.000,Pig,16-23,15,19,0,34,44.118,44.118
3,0.000,Pig,23-5,8,10,0,18,44.444,44.444
3,0.000,Barn Owl,16-23,0,0,0,0,NaN,NaN
3,0.000,Barn Owl,23-5,0,5,0,5,0.000,0.000
3,0.000,Wild Pig,16-23,7,12,0,19,36.842,36.842
3,0.000,Wild Pig,23-5,11,9,0,20,55.000,55.000
3,0.000,Pennington Creek Water,16-23,0,0,0,0,NaN,NaN
3,0.000,Pennington Creek Water,23-5,0,0,0,0,NaN,NaN
3,0.000,Guinni,16-23,0,0,0,0,NaN,NaN
3,0.000,Guinni,23-5,0,2,0,2,0.000,0.000
3,0.000,Racoon,16-23,2,3,0,5,40.000,40.000
3,0.000,Racoon,23-5,0,2,0,2,0.000,0.000
3,0.000,Hu,16-23,20,9,0,29,68.966,68.966
3,0.000,Hu,23-5,20,8,0,28,71.429,71.429
3,0.000,Cw and Dg,16-23,12,17,0,29,41.379,41.379
3,0.000,Cw and Dg,23-5,19,18,0,37,51.351,51.351
3,0.000,Red Wind Blackbird,16-23,0,2,0,2,0.000,0.000
3,0.000,Red Wind Blackbird,23-5,0,3,0,3,0.000,0.000
3,0.000,Tree Swallow,16-23,0,2,0,2,0.000,0.000
3,0.000,Tree Swallow,23-5,0,2,0,2,0.000,0.000
3,0.000,Turkey Vulture,16-23,0,1,0,1,0.000,0.000
3,0.000,Turkey Vulture,23-5,0,2,0,2,0.000,0.000
3,0.000,Dg,16-23,9,14,0,23,39.130,39.130
3,0.000,Dg,23-5,29,24,0,53,54.717,54.717
3,0.000,Western Kingbird,16-23,0,1,0,1,0.000,0.000
3,0.000,Western Kingbird,23-5,0,1,0,1,0.000,0.000
3,0.000,White Crowned Sparrow,16-23,12,9,0,21,57.143,57.143
3,0.000,White Crowned Sparrow,23-5,5,20,0,25,20.000,20.000
3,0.000,Eared Grebe,16-23,0,0,0,0,NaN,NaN
3,0.000,Eared Grebe,23-5,4,14,0,18,22.222,22.222
3,0.000,cougar,16-23,0,0,0,0,NaN,NaN
3,0.000,cougar,23-5,0,0,0,0,NaN,NaN
3,0.000,Ocean Water,16-23,0,0,0,0,NaN,NaN
3,0.000,Ocean Water,23-5,0,0,0,0,NaN,NaN
3,0.000,Red Tailed Hawk,16-23,0,2,0,2,0.000,0.000
3,0.000,Red Tailed Hawk,23-5,0,18,0,18,0.000,0.000
3,0.000,Dog,16-23,77,97,0,174,44.253,44.253
3,0.000,Dog,23-5,135,142,0,277,48.736,48.736
3,0.000,Human,16-23,1738,511,0,2249,77.279,77.279
3,0.000,Human,23-5,2224,406,0,2630,84.563,84.563
3,0.000,Wild Turkey,16-23,10,33,0,43,23.256,23.256
3,0.000,Wild Turkey,23-5,6,50,0,56,10.714,10.714
3,0.000,Clark Grebe,16-23,0,0,0,0,NaN,NaN
3,0.000,Clark Grebe,23-5,0,2,0,2,0.000,0.000
3,0.000,Seagull,16-23,0,0,0,0,NaN,NaN
3,0.000,Seagull,23-5,48,6,0,54,88.889,88.889
3,0.000,Surf Scoter,16-23,0,0,0,0,NaN,NaN
3,0.000,Surf Scoter,23-5,0,4,0,4,0.000,0.000
3,0.000,Pigeon,16-23,131,143,0,274,47.810,47.810
3,0.000,Pigeon,23-5,162,276,0,438,36.986,36.986
3,0.000,Pacific Ocean Water,16-23,0,0,0,0,NaN,NaN
3,0.000,Pacific Ocean Water,23-5,0,0,0,0,NaN,NaN
3,0.000,Cat,16-23,34,41,0,75,45.333,45.333
3,0.000,Cat,23-5,42,39,0,81,51.852,51.852
3,0.000,Horse,16-23,21,51,0,72,29.167,29.167
3,0.000,Horse,23-5,41,297,0,338,12.130,12.130
3,0.000,orangutan,16-23,0,0,0,0,NaN,NaN
3,0.000,orangutan,23-5,0,0,0,0,NaN,NaN
3,0.000,Bat,16-23,36,11,0,47,76.596,76.596
3,0.000,Bat,23-5,37,18,0,55,67.273,67.273
3,0.000,Deer,16-23,15,20,0,35,42.857,42.857
3,0.000,Deer,23-5,17,51,0,68,25.000,25.000
3,0.000,Great Horned Owl,16-23,0,4,0,4,0.000,0.000
3,0.000,Great Horned Owl,23-5,1,17,0,18,5.556,5.556
3,0.000,Freshwater Lagoon,16-23,0,0,0,0,NaN,NaN
3,0.000,Freshwater Lagoon,23-5,0,0,0,0,NaN,NaN
3,0.000,Unknown Avian,16-23,0,0,0,0,NaN,NaN
3,0.000,Unknown Avian,23-5,0,0,0,0,NaN,NaN
3,0.000,Human UTI,16-23,92,83,0,175,52.571,52.571
3,0.000,Human UTI,23-5,110,96,0,206,53.398,53.398
3,0.000,unknown,16-23,0,4,0,4,0.000,0.000
3,0.000,unknown,23-5,3,13,0,16,18.750,18.750
3,0.000,SLO Creek Water,16-23,0,0,0,0,NaN,NaN
3,0.000,SLO Creek Water,23-5,1,0,0,1,100.000,100.000
3,0.000,Pig/Swine,16-23,17,9,0,26,65.385,65.385
3,0.000,Pig/Swine,23-5,10,6,0,16,62.500,62.500
3,0.000,Klebsiella,16-23,0,0,0,0,NaN,NaN
3,0.000,Klebsiella,23-5,0,0,0,0,NaN,NaN
3,0.000,Hu Cw and Dg,16-23,11,33,0,44,25.000,25.000
3,0.000,Hu Cw and Dg,23-5,28,33,0,61,45.902,45.902
3,0.000,Ground Squirrel,16-23,114,92,0,206,55.340,55.340
3,0.000,Ground Squirrel,23-5,101,107,0,208,48.558,48.558
3,0.000,Opossum,16-23,0,1,0,1,0.000,0.000
3,0.000,Opossum,23-5,0,9,0,9,0.000,0.000
3,0.000,Cow,16-23,1545,873,0,2418,63.896,63.896
3,0.000,Cow,23-5,1500,1004,0,2504,59.904,59.904
3,0.000,Deer Mouse,16-23,0,0,0,0,NaN,NaN
3,0.000,Deer Mouse,23-5,0,0,0,0,NaN,NaN
3,0.000,OVERALL,16-23,4045,2303,0,6348,63.721,63.721
3,0.000,OVERALL,23-5,4715,2895,0,7610,61.958,61.958
3,0.500,Chicken,16-23,9,27,0,36,25.000,25.000
3,0.500,Chicken,23-5,17,18,0,35,48.571,48.571
3,0.500,Sea Lion,16-23,1,1,0,2,50.000,50.000
3,0.500,Sea Lion,23-5,4,5,0,9,44.444,44.444
3,0.500,Hu and Cw,16-23,15,25,0,40,37.500,37.500
3,0.500,Hu and Cw,23-5,17,40,0,57,29.825,29.825
3,0.500,Sheep,16-23,68,72,0,140,48.571,48.571
3,0.500,Sheep,23-5,72,38,0,110,65.455,65.455
3,0.500,Hu and Dg,16-23,11,18,0,29,37.931,37.931
3,0.500,Hu and Dg,23-5,18,7,0,25,72.000,72.000
3,0.500,Common Loon,16-23,0,2,0,2,0.000,0.000
3,0.500,Common Loon,23-5,0,4,0,4,0.000,0.000
3,0.500,Red-Winged Blackbird,16-23,0,8,0,8,0.000,0.000
3,0.500,Red-Winged Blackbird,23-5,0,3,0,3,0.000,0.000
3,0.500,Cw,16-23,11,13,0,24,45.833,45.833
3,0.500,Cw,23-5,20,31,0,51,39.216,39.216
3,0.500,Cliff Sparrow,16-23,12,40,0,52,23.077,23.077
3,0.500,Cliff Sparrow,23-5,5,35,0,40,12.500,12.500
3,0.500,Pig,16-23,15,19,0,34,44.118,44.118
3,0.500,Pig,23-5,8,10,0,18,44.444,44.444
3,0.500,Barn Owl,16-23,0,0,0,0,NaN,NaN
3,0.500,Barn Owl,23-5,0,5,0,5,0.000,0.000
3,0.500,Wild Pig,16-23,7,12,0,19,36.842,36.842
3,0.500,Wild Pig,23-5,11,9,0,20,55.000,55.000
3,0.500,Pennington Creek Water,16-23,0,0,0,0,NaN,NaN
3,0.500,Pennington Creek Water,23-5,0,0,0,0,NaN,NaN
3,0.500,Guinni,16-23,0,0,0,0,NaN,NaN
3,0.500,Guinni,23-5,0,2,0,2,0.000,0.000
3,0.500,Racoon,16-23,2,3,0,5,40.000,40.000
3,0.500,Racoon,23-5,0,2,0,2,0.000,0.000
3,0.500,Hu,16-23,20,9,0,29,68.966,68.966
3,0.500,Hu,23-5,20,8,0,28,71.429,71.429
3,0.500,Cw and Dg,16-23,12,17,0,29,41.379,41.379
3,0.500,Cw and Dg,23-5,19,18,0,37,51.351,51.351
3,0.500,Red Wind Blackbird,16-23,0,2,0,2,0.000,0.000
3,0.500,Red Wind Blackbird,23-5,0,3,0,3,0.000,0.000
3,0.500,Tree Swallow,16-23,0,2,0,2,0.000,0.000
3,0.500,Tree Swallow,23-5,0,2,0,2,0.000,0.000
3,0.500,Turkey Vulture,16-23,0,1,0,1,0.000,0.000
3,0.500,Turkey Vulture,23-5,0,2,0,2,0.000,0.000
3,0.500,Dg,16-23,9,14,0,23,39.130,39.130
3,0.500,Dg,23-5,29,24,0,53,54.717,54.717
3,0.500,Western Kingbird,16-23,0,1,0,1,0.000,0.000
3,0.500,Western Kingbird,23-5,0,1,0,1,0.000,0.000
3,0.500,White Crowned Sparrow,16-23,12,9,0,21,57.143,57.143
3,0.500,White Crowned Sparrow,23-5,5,20,0,25,20.000,20.000
3,0.500,Eared Grebe,16-23,0,0,0,0,NaN,NaN
3,0.500,Eared Grebe,23-5,4,14,0,18,22.222,22.222
3,0.500,cougar,16-23,0,0,0,0,NaN,NaN
3,0.500,cougar,23-5,0,0,0,0,NaN,NaN
3,0.500,Ocean Water,16-23,0,0,0,0,NaN,NaN
3,0.500,Ocean Water,23-5,0,0,0,0,NaN,NaN
3,0.500,Red Tailed Hawk,16-23,0,2,0,2,0.000,0.000
3,0.500,Red Tailed Hawk,23-5,0,18,0,18,0.000,0.000
3,0.500,Dog,16-23,77,97,0,174,44.253,44.253
3,0.500,Dog,23-5,135,142,0,277,48.736,48.736
3,0.500,Human,16-23,1738,511,0,2249,77.279,77.279
3,0.500,Human,23-5,2224,406,0,2630,84.563,84.563
3,0.500,Wild Turkey,16-23,10,33,0,43,23.256,23.256
3,0.500,Wild Turkey,23-5,6,50,0,56,10.714,10.714
3,0.500,Clark Grebe,16-23,0,0,0,0,NaN,NaN
3,0.500,Clark Grebe,23-5,0,2,0,2,0.000,0.000
3,0.500,Seagull,16-23,0,0,0,0,NaN,NaN
3,0.500,Seagull,23-5,48,6,0,54,88.889,88.889
3,0.500,Surf Scoter,16-23,0,0,0,0,NaN,NaN
3,0.500,Surf Scoter,23-5,0,4,0,4,0.000,0.000
3,0.500,Pigeon,16-23,131,143,0,274,47.810,47.810
3,0.500,Pigeon,23-5,162,276,0,438,36.986,36.986
3,0.500,Pacific Ocean Water,16-23,0,0,0,0,NaN,NaN
3,0.500,Pacific Ocean Water,23-5,0,0,0,0,NaN,NaN
3,0.500,Cat,16-23,34,41,0,75,45.333,45.333
3,0.500,Cat,23-5,42,39,0,81,51.852,51.852
3,0.500,Horse,16-23,21,51,0,72,29.167,29.167
3,0.500,Horse,23-5,41,297,0,338,12.130,12.130
3,0.500,orangutan,16-23,0,0,0,0,NaN,NaN
3,0.500,orangutan,23-5,0,0,0,0,NaN,NaN
3,0.500,Bat,16-23,36,11,0,47,76.596,76.596
3,0.500,Bat,23-5,37,18,0,55,67.273,67.273
3,0.500,Deer,16-23,15,20,0,35,42.857,42.857
3,0.500,Deer,23-5,17,51,0,68,25.000,25.000
3,0.500,Great Horned Owl,16-23,0,4,0,4,0.000,0.000
3,0.500,Great Horned Owl,23-5,1,17,0,18,5.556,5.556
3,0.500,Freshwater Lagoon,16-23,0,0,0,0,NaN,NaN
3,0.500,Freshwater Lagoon,23-5,0,0,0,0,NaN,NaN
3,0.500,Unknown Avian,16-23,0,0,0,0,NaN,NaN
3,0.500,Unknown Avian,23-5,0,0,0,0,NaN,NaN
3,0.500,Human UTI,16-23,92,83,0,175,52.571,52.571
3,0.500,Human UTI,23-5,110,96,0,206,53.398,53.398
3,0.500,unknown,16-23,0,4,0,4,0.000,0.000
3,0.500,unknown,23-5,3,13,0,16,18.750,18.750
3,0.500,SLO Creek Water,16-23,0,0,0,0,NaN,NaN
3,0.500,SLO Creek Water,23-5,1,0,0,1,100.000,100.000
3,0.500,Pig/Swine,16-23,17,9,0,26,65.385,65.385
3,0.500,Pig/Swine,23-5,10,6,0,16,62.500,62.500
3,0.500,Klebsiella,16-23,0,0,0,0,NaN,NaN
3,0.500,Klebsiella,23-5,0,0,0,0,NaN,NaN
3,0.500,Hu Cw and Dg,16-23,11,33,0,44,25.000,25.000
3,0.500,Hu Cw and Dg,23-5,28,33,0,61,45.902,45.902
3,0.500,Ground Squirrel,16-23,114,92,0,206,55.340,55.340
3,0.500,Ground Squirrel,23-5,101,107,0,208,48.558,48.558
3,0.500,Opossum,16-23,0,1,0,1,0.000,0.000
3,0.500,Opossum,23-5,0,9,0,9,0.000,0.000
3,0.500,Cow,16-23,1545,873,0,2418,63.896,63.896
3,0.500,Cow,23-5,1500,1004,0,2504,59.904,59.904
3,0.500,Deer Mouse,16-23,0,0,0,0,NaN,NaN
3,0.500,Deer Mouse,23-5,0,0,0,0,NaN,NaN
3,0.500,OVERALL,16-23,4045,2303,0,6348,63.721,63.721
3,0.500,OVERALL,23-5,4715,2895,0,7610,61.958,61.958
3,0.900,Chicken,16-23,9,27,0,36,25.000,25.000
3,0.900,Chicken,23-5,17,18,0,35,48.571,48.571
3,0.900,Sea Lion,16-23,1,1,0,2,50.000,50.000
3,0.900,Sea Lion,23-5,4,5,0,9,44.444,44.444
3,0.900,Hu and Cw,16-23,15,25,0,40,37.500,37.500
3,0.900,Hu and Cw,23-5,17,40,0,57,29.825,29.825
3,0.900,Sheep,16-23,68,72,0,140,48.571,48.571
3,0.900,Sheep,23-5,72,38,0,110,65.455,65.455
3,0.900,Hu and Dg,16-23,11,18,0,29,37.931,37.931
3,0.900,Hu and Dg,23-5,18,7,0,25,72.000,72.000
3,0.900,Common Loon,16-23,0,2,0,2,0.000,0.000
3,0.900,Common Loon,23-5,0,4,0,4,0.000,0.000
3,0.900,Red-Winged Blackbird,16-23,0,8,0,8,0.000,0.000
3,0.900,Red-Winged Blackbird,23-5,0,3,0,3,0.000,0.000
3,0.900,Cw,16-23,11,13,0,24,45.833,45.833
3,0.900,Cw,23-5,20,31,0,51,39.216,39.216
3,0.900,Cliff Sparrow,16-23,12,40,0,52,23.077,23.077
3,0.900,Cliff Sparrow,23-5,5,35,0,40,12.500,12.500
3,0.900,Pig,16-23,15,19,0,34,44.118,44.118
3,0.900,Pig,23-5,8,10,0,18,44.444,44.444
3,0.900,Barn Owl,16-23,0,0,0,0,NaN,NaN
3,0.900,Barn Owl,23-5,0,5,0,5,0.000,0.000
3,0.900,Wild Pig,16-23,7,12,0,19,36.842,36.842
3,0.900,Wild Pig,23-5,11,9,0,20,55.000,55.000
3,0.900,Pennington Creek Water,16-23,0,0,0,0,NaN,NaN
3,0.900,Pennington Creek Water,23-5,0,0,0,0,NaN,NaN
3,0.900,Guinni,16-23,0,0,0,0,NaN,NaN
3,0.900,Guinni,23-5,0,2,0,2,0.000,0.000
3,0.900,Racoon,16-23,2,3,0,5,40.000,40.000
3,0.900,Racoon,23-5,0,2,0,2,0.000,0.000
3,0.900,Hu,16-23,20,9,0,29,68.966,68.966
3,0.900,Hu,23-5,20,8,0,28,71.429,71.429
3,0.900,Cw and Dg,16-23,12,17,0,29,41.379,41.379
3,0.900,Cw and Dg,23-5,19,18,0,37,51.351,51.351
3,0.900,Red Wind Blackbird,16-23,0,2,0,2,0.000,0.000
3,0.900,Red Wind Blackbird,23-5,0,3,0,3,0.000,0.000
3,0.900,Tree Swallow,16-23,0,2,0,2,0.000,0.000
3,0.900,Tree Swallow,23-5,0,2,0,2,0.000,0.000
3,0.900,Turkey Vulture,16-23,0,1,0,1,0.000,0.000
3,0.900,Turkey Vulture,23-5,0,2,0,2,0.000,0.000
3,0.900,Dg,16-23,9,14,0,23,39.130,39.130
3,0.900,Dg,23-5,29,24,0,53,54.717,54.717
3,0.900,Western Kingbird,16-23,0,1,0,1,0.000,0.000
3,0.900,Western Kingbird,23-5,0,1,0,1,0.000,0.000
3,0.900,White Crowned Sparrow,16-23,12,9,0,21,57.143,57.143
3,0.900,White Crowned Sparrow,23-5,5,20,0,25,20.000,20.000
3,0.900,Eared Grebe,16-23,0,0,0,0,NaN,NaN
3,0.900,Eared Grebe,23-5,4,14,0,18,22.222,22.222
3,0.900,cougar,16-23,0,0,0,0,NaN,NaN
3,0.900,cougar,23-5,0,0,0,0,NaN,NaN
3,0.900,Ocean Water,16-23,0,0,0,0,NaN,NaN
3,0.900,Ocean Water,23-5,0,0,0,0,NaN,NaN
3,0.900,Red Tailed Hawk,16-23,0,2,0,2,0.000,0.000
3,0.900,Red Tailed Hawk,23-5,0,18,0,18,0.000,0.000
3,0.900,Dog,16-23,77,97,0,174,44.253,44.253
3,0.900,Dog,23-5,135,140,0,275,49.091,49.091
3,0.900,Human,16-23,1738,507,0,2245,77.416,77.416
3,0.900,Human,23-5,2224,402,0,2626,84.692,84.692
3,0.900,Wild Turkey,16-23,10,33,0,43,23.256,23.256
3,0.900,Wild Turkey,23-5,6,50,0,56,10.714,10.714
3,0.900,Clark Grebe,16-23,0,0,0,0,NaN,NaN
3,0.900,Clark Grebe,23-5,0,2,0,2,0.000,0.000
3,0.900,Seagull,16-23,0,0,0,0,NaN,NaN
3,0.900,Seagull,23-5,48,6,0,54,88.889,88.889
3,0.900,Surf Scoter,16-23,0,0,0,0,NaN,NaN
3,0.900,Surf Scoter,23-5,0,4,0,4,0.000,0.000
3,0.900,Pigeon,16-23,131,143,0,274,47.810,47.810
3,0.900,Pigeon,23-5,162,276,0,438,36.986,36.986
3,0.900,Pacific Ocean Water,16-23,0,0,0,0,NaN,NaN
3,0.900,Pacific Ocean Water,23-5,0,0,0,0,NaN,NaN
3,0.900,Cat,16-23,34,41,0,75,45.333,45.333
3,0.900,Cat,23-5,42,39,0,81,51.852,51.852
3,0.900,Horse,16-23,21,51,0,72,29.167,29.167
3,0.900,Horse,23-5,41,297,0,338,12.130,12.130
3,0.900,orangutan,16-23,0,0,0,0,NaN,NaN
3,0.900,orangutan,23-5,0,0,0,0,NaN,NaN
3,0.900,Bat,16-23,36,11,0,47,76.596,76.596
3,0.900,Bat,23-5,37,18,0,55,67.273,67.273
3,0.900,Deer,16-23,15,20,0,35,42.857,42.857
3,0.900,Deer,23-5,17,51,0,68,25.000,25.000
3,0.900,Great Horned Owl,16-23,0,4,0,4,0.000,0.000
3,0.900,Great Horned Owl,23-5,1,17,0,18,5.556,5.556
3,0.900,Freshwater Lagoon,16-23,0,0,0,0,NaN,NaN
3,0.900,Freshwater Lagoon,23-5,0,0,0,0,NaN,NaN
3,0.900,Unknown Avian,16-23,0,0,0,0,NaN,NaN
3,0.900,Unknown Avian,23-5,0,0,0,0,NaN,NaN
3,0.900,Human UTI,16-23,92,83,0,175,52.571,52.571
3,0.900,Human UTI,23-5,110,96,0,206,53.398,53.398
3,0.900,unknown,16-23,0,4,0,4,0.000,0.000
3,0.900,unknown,23-5,3,13,0,16,18.750,18.750
3,0.900,SLO Creek Water,16-23,0,0,0,0,NaN,NaN
3,0.900,SLO Creek Water,23-5,1,0,0,1,100.000,100.000
3,0.900,Pig/Swine,16-23,17,9,0,26,65.385,65.385
3,0.900,Pig/Swine,23-5,10,6,0,16,62.500,62.500
3,0.900,Klebsiella,16-23,0,0,0,0,NaN,NaN
3,0.900,Klebsiella,23-5,0,0,0,0,NaN,NaN
3,0.900,Hu Cw and Dg,16-23,11,33,0,44,25.000,25.000
3,0.900,Hu Cw and Dg,23-5,28,33,0,61,45.902,45.902
3,0.900,Ground Squirrel,16-23,114,92,0,206,55.340,55.340
3,0.900,Ground Squirrel,23-5,101,107,0,208,48.558,48.558
3,0.900,Opossum,16-23,0,1,0,1,0.000,0.000
3,0.900,Opossum,23-5,0,9,0,9,0.000,0.000
3,0.900,Cow,16-23,1545,873,0,2418,63.896,63.896
3,0.900,Cow,23-5,1500,1002,0,2502,59.952,59.952
3,0.900,Deer Mouse,16-23,0,0,0,0,NaN,NaN
3,0.900,Deer Mouse,23-5,0,0,0,0,NaN,NaN
3,0.900,OVERALL,16-23,4045,2299,0,6344,63.761,63.761
3,0.900,OVERALL,23-5,4715,2887,0,7602,62.023,62.023
3,0.950,Chicken,16-23,9,27,0,36,25.000,25.000
3,0.950,Chicken,23-5,17,18,0,35,48.571,48.571
3,0.950,Sea Lion,16-23,1,1,0,2,50.000,50.000
3,0.950,Sea Lion,23-5,4,5,0,9,44.444,44.444
3,0.950,Hu and Cw,16-23,15,25,0,40,37.500,37.500
3,0.950,Hu and Cw,23-5,17,40,0,57,29.825,29.825
3,0.950,Sheep,16-23,68,72,0,140,48.571,48.571
3,0.950,Sheep,23-5,72,38,0,110,65.455,65.455
3,0.950,Hu and Dg,16-23,11,18,0,29,37.931,37.931
3,0.950,Hu and Dg,23-5,18,7,0,25,72.000,72.000
3,0.950,Common Loon,16-23,0,2,0,2,0.000,0.000
3,0.950,Common Loon,23-5,0,4,0,4,0.000,0.000
3,0.950,Red-Winged Blackbird,16-23,0,8,0,8,0.000,0.000
3,0.950,Red-Winged Blackbird,23-5,0,3,0,3,0.000,0.000
3,0.950,Cw,16-23,11,13,0,24,45.833,45.833
3,0.950,Cw,23-5,20,31,0,51,39.216,39.216
3,0.950,Cliff Sparrow,16-23,12,40,0,52,23.077,23.077
3,0.950,Cliff Sparrow,23-5,5,35,0,40,12.500,12.500
3,0.950,Pig,16-23,15,19,0,34,44.118,44.118
3,0.950,Pig,23-5,8,10,0,18,44.444,44.444
3,0.950,Barn Owl,16-23,0,0,0,0,NaN,NaN
3,0.950,Barn Owl,23-5,0,5,0,5,0.000,0.000
3,0.950,Wild Pig,16-23,7,12,0,19,36.842,36.842
3,0.950,Wild Pig,23-5,11,8,0,19,57.895,57.895
3,0.950,Pennington Creek Water,16-23,0,0,0,0,NaN,NaN
3,0.950,Pennington Creek Water,23-5,0,0,0,0,NaN,NaN
3,0.950,Guinni,16-23,0,0,0,0,NaN,NaN
3,0.950,Guinni,23-5,0,2,0,2,0.000,0.000
3,0.950,Racoon,16-23,2,3,0,5,40.000,40.000
3,0.950,Racoon,23-5,0,2,0,2,0.000,0.000
3,0.950,Hu,16-23,20,9,0,29,68.966,68.966
3,0.950,Hu,23-5,20,8,0,28,71.429,71.429
3,0.950,Cw and Dg,16-23,12,17,0,29,41.379,41.379
3,0.950,Cw and Dg,23-5,19,18,0,37,51.351,51.351
3,0.950,Red Wind Blackbird,16-23,0,2,0,2,0.000,0.000
3,0.950,Red Wind Blackbird,23-5,0,3,0,3,0.000,0.000
3,0.950,Tree Swallow,16-23,0,2,0,2,0.000,0.000
3,0.950,Tree Swallow,23-5,0,2,0,2,0.000,0.000
3,0.950,Turkey Vulture,16-23,0,1,0,1,0.000,0.000
3,0.950,Turkey Vulture,23-5,0,2,0,2,0.000,0.000
3,0.950,Dg,16-23,9,14,0,23,39.130,39.130
3,0.950,Dg,23-5,29,24,0,53,54.717,54.717
3,0.950,Western Kingbird,16-23,0,1,0,1,0.000,0.000
3,0.950,Western Kingbird,23-5,0,1,0,1,0.000,0.000
3,0.950,White Crowned Sparrow,16-23,12,9,0,21,57.143,57.143
3,0.950,White Crowned Sparrow,23-5,5,20,0,25,20.000,20.000
3,0.950,Eared Grebe,16-23,0,0,0,0,NaN,NaN
3,0.950,Eared Grebe,23-5,4,14,0,18,22.222,22.222
3,0.950,cougar,16-23,0,0,0,0,NaN,NaN
3,0.950,cougar,23-5,0,0,0,0,NaN,NaN
3,0.950,Ocean Water,16-23,0,0,0,0,NaN,NaN
3,0.950,Ocean Water,23-5,0,0,0,0,NaN,NaN
3,0.950,Red Tailed Hawk,16-23,0,2,0,2,0.000,0.000
3,0.950,Red Tailed Hawk,23-5,0,18,0,18,0.000,0.000
3,0.950,Dog,16-23,77,97,0,174,44.253,44.253
3,0.950,Dog,23-5,135,140,0,275,49.091,49.091
3,0.950,Human,16-23,1738,506,0,2244,77.451,77.451
3,0.950,Human,23-5,2226,396,0,2622,84.897,84.897
3,0.950,Wild Turkey,16-23,10,33,0,43,23.256,23.256
3,0.950,Wild Turkey,23-5,6,50,0,56,10.714,10.714
3,0.950,Clark Grebe,16-23,0,0,0,0,NaN,NaN
3,0.950,Clark Grebe,23-5,0,2,0,2,0.000,0.000
3,0.950,Seagull,16-23,0,0,0,0,NaN,NaN
3,0.950,Seagull,23-5,48,5,0,53,90.566,90.566
3,0.950,Surf Scoter,16-23,0,0,0,0,NaN,NaN
3,0.950,Surf Scoter,23-5,0,2,0,2,0.000,0.000
3,0.950,Pigeon,16-23,131,143,0,274,47.810,47.810
3,0.950,Pigeon,23-5,162,276,0,438,36.986,36.986
3,0.950,Pacific Ocean Water,16-23,0,0,0,0,NaN,NaN
3,0.950,Pacific Ocean Water,23-5,0,0,0,0,NaN,NaN
3,0.950,Cat,16-23,34,41,0,75,45.333,45.333
3,0.950,Cat,23-5,42,39,0,81,51.852,51.852
3,0.950,Horse,16-23,21,51,0,72,29.167,29.167
3,0.950,Horse,23-5,41,297,0,338,12.130,12.130
3,0.950,orangutan,16-23,0,0,0,0,NaN,NaN
3,0.950,orangutan,23-5,0,0,0,0,NaN,NaN
3,0.950,Bat,16-23,36,11,0,47,76.596,76.596
3,0.950,Bat,23-5,37,18,0,55,67.273,67.273
3,0.950,Deer,16-23,15,20,0,35,42.857,42.857
3,0.950,Deer,23-5,17,51,0,68,25.000,25.000
3,0.950,Great Horned Owl,16-23,0,4,0,4,0.000,0.000
3,0.950,Great Horned Owl,23-5,1,17,0,18,5.556,5.556
3,0.950,Freshwater Lagoon,16-23,0,0,0,0,NaN,NaN
3,0.950,Freshwater Lagoon,23-5,0,0,0,0,NaN,NaN
3,0.950,Unknown Avian,16-23,0,0,0,0,NaN,NaN
3,0.950,Unknown Avian,23-5,0,0,0,0,NaN,NaN
3,0.950,Human UTI,16-23,92,83,0,175,52.571,52.571
3,0.950,Human UTI,23-5,109,96,0,205,53.171,53.171
3,0.950,unknown,16-23,0,4,0,4,0.000,0.000
3,0.950,unknown,23-5,3,13,0,16,18.750,18.750
3,0.950,SLO Creek Water,16-23,0,0,0,0,NaN,NaN
3,0.950,SLO Creek Water,23-5,1,0,0,1,100.000,100.000
3,0.950,Pig/Swine,16-23,17,9,0,26,65.385,65.385
3,0.950,Pig/Swine,23-5,10,6,0,16,62.500,62.500
3,0.950,Klebsiella,16-23,0,0,0,0,NaN,NaN
3,0.950,Klebsiella,23-5,0,0,0,0,NaN,NaN
3,0.950,Hu Cw and Dg,16-23,11,33,0,44,25.000,25.000
3,0.950,Hu Cw and Dg,23-5,28,33,0,61,45.902,45.902
3,0.950,Ground Squirrel,16-23,114,92,0,206,55.340,55.340
3,0.950,Ground Squirrel,23-5,101,105,0,206,49.029,49.029
3,0.950,Opossum,16-23,0,1,0,1,0.000,0.000
3,0.950,Opossum,23-5,0,9,0,9,0.000,0.000
3,0.950,Cow,16-23,1545,857,0,2402,64.321,64.321
3,0.950,Cow,23-5,1499,1002,0,2501,59.936,59.936
3,0.950,Deer Mouse,16-23,0,0,0,0,NaN,NaN
3,0.950,Deer Mouse,23-5,0,0,0,0,NaN,NaN
3,0.950,OVERALL,16-23,4045,2282,0,6327,63.932,63.932
3,0.950,OVERALL,23-5,4715,2875,0,7590,62.121,62.121
3,0.960,Chicken,16-23,9,27,0,36,25.000,25.000
3,0.960,Chicken,23-5,17,18,0,35,48.571,48.571
3,0.960,Sea Lion,16-23,1,1,0,2,50.000,50.000
3,0.960,Sea Lion,23-5,4,5,0,9,44.444,44.444
3,0.960,Hu and Cw,16-23,15,25,0,40,37.500,37.500
3,0.960,Hu and Cw,23-5,17,40,0,57,29.825,29.825
3,0.960,Sheep,16-23,68,72,0,140,48.571,48.571
3,0.960,Sheep,23-5,72,37,0,109,66.055,66.055
3,0.960,Hu and Dg,16-23,11,18,0,29,37.931,37.931
3,0.960,Hu and Dg,23-5,18,7,0,25,72.000,72.000
3,0.960,Common Loon,16-23,0,2,0,2,0.000,0.000
3,0.960,Common Loon,23-5,0,4,0,4,0.000,0.000
3,0.960,Red-Winged Blackbird,16-23,0,8,0,8,0.000,0.000
3,0.960,Red-Winged Blackbird,23-5,0,3,0,3,0.000,0.000
3,0.960,Cw,16-23,11,13,0,24,45.833,45.833
3,0.960,Cw,23-5,20,31,0,51,39.216,39.216
3,0.960,Cliff Sparrow,16-23,12,40,0,52,23.077,23.077
3,0.960,Cliff Sparrow,23-5,5,35,0,40,12.500,12.500
3,0.960,Pig,16-23,15,19,0,34,44.118,44.118
3,0.960,Pig,23-5,8,10,0,18,44.444,44.444
3,0.960,Barn Owl,16-23,0,0,0,0,NaN,NaN
3,0.960,Barn Owl,23-5,0,5,0,5,0.000,0.000
3,0.960,Wild Pig,16-23,7,12,0,19,36.842,36.842
3,0.960,Wild Pig,23-5,11,8,0,19,57.895,57.895
3,0.960,Pennington Creek Water,16-23,0,0,0,0,NaN,NaN
3,0.960,Pennington Creek Water,23-5,0,0,0,0,NaN,NaN
3,0.960,Guinni,16-23,0,0,0,0,NaN,NaN
3,0.960,Guinni,23-5,0,2,0,2,0.000,0.000
3,0.960,Racoon,16-23,2,3,0,5,40.000,40.000
3,0.960,Racoon,23-5,0,2,0,2,0.000,0.000
3,0.960,Hu,16-23,20,9,0,29,68.966,68.966
3,0.960,Hu,23-5,20,8,0,28,71.429,71.429
3,0.960,Cw and Dg,16-23,12,17,0,29,41.379,41.379
3,0.960,Cw and Dg,23-5,19,18,0,37,51.351,51.351
3,0.960,Red Wind Blackbird,16-23,0,2,0,2,0.000,0.000
3,0.960,Red Wind Blackbird,23-5,0,3,0,3,0.000,0.000
3,0.960,Tree Swallow,16-23,0,2,0,2,0.000,0.000
3,0.960,Tree Swallow,23-5,0,2,0,2,0.000,0.000
3,0.960,Turkey Vulture,16-23,0,1,0,1,0.000,0.000
3,0.960,Turkey Vulture,23-5,0,2,0,2,0.000,0.000
3,0.960,Dg,16-23,9,14,0,23,39.130,39.130
3,0.960,Dg,23-5,29,24,0,53,54.717,54.717
3,0.960,Western Kingbird,16-23,0,1,0,1,0.000,0.000
3,0.960,Western Kingbird,23-5,0,1,0,1,0.000,0.000
3,0.960,White Crowned Sparrow,16-23,12,9,0,21,57.143,57.143
3,0.960,White Crowned Sparrow,23-5,5,20,0,25,20.000,20.000
3,0.960,Eared Grebe,16-23,0,0,0,0,NaN,NaN
3,0.960,Eared Grebe,23-5,4,14,0,18,22.222,22.222
3,0.960,cougar,16-23,0,0,0,0,NaN,NaN
3,0.960,cougar,23-5,0,0,0,0,NaN,NaN
3,0.960,Ocean Water,16-23,0,0,0,0,NaN,NaN
3,0.960,Ocean Water,23-5,0,0,0,0,NaN,NaN
3,0.960,Red Tailed Hawk,16-23,0,2,0,2,0.000,0.000
3,0.960,Red Tailed Hawk,23-5,0,18,0,18,0.000,0.000
3,0.960,Dog,16-23,77,97,0,174,44.253,44.253
3,0.960,Dog,23-5,135,138,0,273,49.451,49.451
3,0.960,Human,16-23,1738,505,0,2243,77.486,77.486
3,0.960,Human,23-5,2227,387,0,2614,85.195,85.195
3,0.960,Wild Turkey,16-23,10,33,0,43,23.256,23.256
3,0.960,Wild Turkey,23-5,6,51,0,57,10.526,10.526
3,0.960,Clark Grebe,16-23,0,0,0,0,NaN,NaN
3,0.960,Clark Grebe,23-5,0,2,0,2,0.000,0.000
3,0.960,Seagull,16-23,0,0,0,0,NaN,NaN
3,0.960,Seagull,23-5,48,5,0,53,90.566,90.566
3,0.960,Surf Scoter,16-23,0,0,0,0,NaN,NaN
3,0.960,Surf Scoter,23-5,0,2,0,2,0.000,0.000
3,0.960,Pigeon,16-23,131,143,0,274,47.810,47.810
3,0.960,Pigeon,23-5,163,276,0,439,37.130,37.130
3,0.960,Pacific Ocean Water,16-23,0,0,0,0,NaN,NaN
3,0.960,Pacific Ocean Water,23-5,0,0,0,0,NaN,NaN
3,0.960,Cat,16-23,34,41,0,75,45.333,45.333
3,0.960,Cat,23-5,42,39,0,81,51.852,51.852
3,0.960,Horse,16-23,21,51,0,72,29.167,29.167
3,0.960,Horse,23-5,41,297,0,338,12.130,12.130
3,0.960,orangutan,16-23,0,0,0,0,NaN,NaN
3,0.960,orangutan,23-5,0,0,0,0,NaN,NaN
3,0.960,Bat,16-23,36,11,0,47,76.596,76.596
3,0.960,Bat,23-5,37,18,0,55,67.273,67.273
3,0.960,Deer,16-23,15,20,0,35,42.857,42.857
3,0.960,Deer,23-5,17,51,0,68,25.000,25.000
3,0.960,Great Horned Owl,16-23,0,4,0,4,0.000,0.000
3,0.960,Great Horned Owl,23-5,1,17,0,18,5.556,5.556
3,0.960,Freshwater Lagoon,16-23,0,0,0,0,NaN,NaN
3,0.960,Freshwater Lagoon,23-5,0,0,0,0,NaN,NaN
3,0.960,Unknown Avian,16-23,0,0,0,0,NaN,NaN
3,0.960,Unknown Avian,23-5,0,0,0,0,NaN,NaN
3,0.960,Human UTI,16-23,92,83,0,175,52.571,52.571
3,0.960,Human UTI,23-5,109,96,0,205,53.171,53.171
3,0.960,unknown,16-23,0,4,0,4,0.000,0.000
3,0.960,unknown,23-5,3,13,0,16,18.750,18.750
3,0.960,SLO Creek Water,16-23,0,0,0,0,NaN,NaN
3,0.960,SLO Creek Water,23-5,1,0,0,1,100.000,100.000
3,0.960,Pig/Swine,16-23,17,9,0,26,65.385,65.385
3,0.960,Pig/Swine,23-5,10,6,0,16,62.500,62.500
3,0.960,Klebsiella,16-23,0,0,0,0,NaN,NaN
3,0.960,Klebsiella,23-5,0,0,0,0,NaN,NaN
3,0.960,Hu Cw and Dg,16-23,11,33,0,44,25.000,25.000
3,0.960,Hu Cw and Dg,23-5,28,33,0,61,45.902,45.902
3,0.960,Ground Squirrel,16-23,114,92,0,206,55.340,55.340
3,0.960,Ground Squirrel,23-5,101,105,0,206,49.029,49.029
3,0.960,Opossum,16-23,0,1,0,1,0.000,0.000
3,0.960,Opossum,23-5,0,9,0,9,0.000,0.000
3,0.960,Cow,16-23,1543,849,0,2392,64.507,64.507
3,0.960,Cow,23-5,1499,1001,0,2500,59.960,59.960
3,0.960,Deer Mouse,16-23,0,0,0,0,NaN,NaN
3,0.960,Deer Mouse,23-5,0,0,0,0,NaN,NaN
3,0.960,OVERALL,16-23,4043,2273,0,6316,64.012,64.012
3,0.960,OVERALL,23-5,4717,2863,0,7580,62.230,62.230
3,0.970,Chicken,16-23,9,27,0,36,25.000,25.000
3,0.970,Chicken,23-5,17,18,0,35,48.571,48.571
3,0.970,Sea Lion,16-23,1,1,0,2,50.000,50.000
3,0.970,Sea Lion,23-5,4,5,0,9,44.444,44.444
3,0.970,Hu and Cw,16-23,15,25,0,40,37.500,37.500
3,0.970,Hu and Cw,23-5,17,40,0,57,29.825,29.825
3,0.970,Sheep,16-23,68,72,0,140,48.571,48.571
3,0.970,Sheep,23-5,72,36,0,108,66.667,66.667
3,0.970,Hu and Dg,16-23,11,18,0,29,37.931,37.931
3,0.970,Hu and Dg,23-5,18,7,0,25,72.000,72.000
3,0.970,Common Loon,16-23,0,2,0,2,0.000,0.000
3,0.970,Common Loon,23-5,0,4,0,4,0.000,0.000
3,0.970,Red-Winged Blackbird,16-23,0,8,0,8,0.000,0.000
3,0.970,Red-Winged Blackbird,23-5,0,3,0,3,0.000,0.000
3,0.970,Cw,16-23,11,14,0,25,44.000,44.000
3,0.970,Cw,23-5,20,31,0,51,39.216,39.216
3,0.970,Cliff Sparrow,16-23,12,40,0,52,23.077,23.077
3,0.970,Cliff Sparrow,23-5,5,35,0,40,12.500,12.500
3,0.970,Pig,16-23,15,19,0,34,44.118,44.118
3,0.970,Pig,23-5,8,10,0,18,44.444,44.444
3,0.970,Barn Owl,16-23,0,0,0,0,NaN,NaN
3,0.970,Barn Owl,23-5,0,5,0,5,0.000,0.000
3,0.970,Wild Pig,16-23,7,12,0,19,36.842,36.842
3,0.970,Wild Pig,23-5,10,8,0,18,55.556,55.556
3,0.970,Pennington Creek Water,16-23,0,0,0,0,NaN,NaN
3,0.970,Pennington Creek Water,23-5,0,0,0,0,NaN,NaN
3,0.970,Guinni,16-23,0,0,0,0,NaN,NaN
3,0.970,Guinni,23-5,0,2,0,2,0.000,0.000
3,0.970,Racoon,16-23,2,3,0,5,40.000,40.000
3,0.970,Racoon,23-5,0,2,0,2,0.000,0.000
3,0.970,Hu,16-23,20,9,0,29,68.966,68.966
3,0.970,Hu,23-5,20,8,0,28,71.429,71.429
3,0.970,Cw and Dg,16-23,12,17,0,29,41.379,41.379
3,0.970,Cw and Dg,23-5,19,18,0,37,51.351,51.351
3,0.970,Red Wind Blackbird,16-23,0,2,0,2,0.000,0.000
3,0.970,Red Wind Blackbird,23-5,0,3,0,3,0.000,0.000
3,0.970,Tree Swallow,16-23,0,2,0,2,0.000,0.000
3,0.970,Tree Swallow,23-5,0,2,0,2,0.000,0.000
3,0.970,Turkey Vulture,16-23,0,1,0,1,0.000,0.000
3,0.970,Turkey Vulture,23-5,0,2,0,2,0.000,0.000
3,0.970,Dg,16-23,9,14,0,23,39.130,39.130
3,0.970,Dg,23-5,29,23,0,52,55.769,55.769
3,0.970,Western Kingbird,16-23,0,1,0,1,0.000,0.000
3,0.970,Western Kingbird,23-5,0,1,0,1,0.000,0.000
3,0.970,White Crowned Sparrow,16-23,12,9,0,21,57.143,57.143
3,0.970,White Crowned Sparrow,23-5,5,20,0,25,20.000,20.000
3,0.970,Eared Grebe,16-23,0,0,0,0,NaN,NaN
3,0.970,Eared Grebe,23-5,4,14,0,18,22.222,22.222
3,0.970,cougar,16-23,0,0,0,0,NaN,NaN
3,0.970,cougar,23-5,0,0,0,0,NaN,NaN
3,0.970,Ocean Water,16-23,0,0,0,0,NaN,NaN
3,0.970,Ocean Water,23-5,0,0,0,0,NaN,NaN
3,0.970,Red Tailed Hawk,16-23,0,2,0,2,0.000,0.000
3,0.970,Red Tailed Hawk,23-5,0,18,0,18,0.000,0.000
3,0.970,Dog,16-23,77,97,0,174,44.253,44.253
3,0.970,Dog,23-5,135,137,0,272,49.632,49.632
3,0.970,Human,16-23,1738,501,0,2239,77.624,77.624
3,0.970,Human,23-5,2225,386,0,2611,85.216,85.216
3,0.970,Wild Turkey,16-23,10,34,0,44,22.727,22.727
3,0.970,Wild Turkey,23-5,6,50,0,56,10.714,10.714
3,0.970,Clark Grebe,16-23,0,0,0,0,NaN,NaN
3,0.970,Clark Grebe,23-5,0,2,0,2,0.000,0.000
3,0.970,Seagull,16-23,0,0,0,0,NaN,NaN
3,0.970,Seagull,23-5,48,6,0,54,88.889,88.889
3,0.970,Surf Scoter,16-23,0,0,0,0,NaN,NaN
3,0.970,Surf Scoter,23-5,0,2,0,2,0.000,0.000
3,0.970,Pigeon,16-23,129,143,0,272,47.426,47.426
3,0.970,Pigeon,23-5,163,278,0,441,36.961,36.961
3,0.970,Pacific Ocean Water,16-23,0,0,0,0,NaN,NaN
3,0.970,Pacific Ocean Water,23-5,0,0,0,0,NaN,NaN
3,0.970,Cat,16-23,34,40,0,74,45.946,45.946
3,0.970,Cat,23-5,42,39,0,81,51.852,51.852
3,0.970,Horse,16-23,21,51,0,72,29.167,29.167
3,0.970,Horse,23-5,41,297,0,338,12.130,12.130
3,0.970,orangutan,16-23,0,0,0,0,NaN,NaN
3,0.970,orangutan,23-5,0,0,0,0,NaN,NaN
3,0.970,Bat,16-23,36,11,0,47,76.596,76.596
3,0.970,Bat,23-5,37,18,0,55,67.273,67.273
3,0.970,Deer,16-23,15,20,0,35,42.857,42.857
3,0.970,Deer,23-5,17,51,0,68,25.000,25.000
3,0.970,Great Horned Owl,16-23,0,4,0,4,0.000,0.000
3,0.970,Great Horned Owl,23-5,1,17,0,18,5.556,5.556
3,0.970,Freshwater Lagoon,16-23,0,0,0,0,NaN,NaN
3,0.970,Freshwater Lagoon,23-5,0,0,0,0,NaN,NaN
3,0.970,Unknown Avian,16-23,0,0,0,0,NaN,NaN
3,0.970,Unknown Avian,23-5,0,0,0,0,NaN,NaN
3,0.970,Human UTI,16-23,93,83,0,176,52.841,52.841
3,0.970,Human UTI,23-5,107,95,0,202,52.970,52.970
3,0.970,unknown,16-23,0,4,0,4,0.000,0.000
3,0.970,unknown,23-5,3,13,0,16,18.750,18.750
3,0.970,SLO Creek Water,16-23,0,0,0,0,NaN,NaN
3,0.970,SLO Creek Water,23-5,1,0,0,1,100.000,100.000
3,0.970,Pig/Swine,16-23,17,9,0,26,65.385,65.385
3,0.970,Pig/Swine,23-5,10,6,0,16,62.500,62.500
3,0.970,Klebsiella,16-23,0,0,0,0,NaN,NaN
3,0.970,Klebsiella,23-5,0,0,0,0,NaN,NaN
3,0.970,Hu Cw and Dg,16-23,11,33,0,44,25.000,25.000
3,0.970,Hu Cw and Dg,23-5,28,33,0,61,45.902,45.902
3,0.970,Ground Squirrel,16-23,114,90,0,204,55.882,55.882
3,0.970,Ground Squirrel,23-5,101,103,0,204,49.510,49.510
3,0.970,Opossum,16-23,0,1,0,1,0.000,0.000
3,0.970,Opossum,23-5,0,9,0,9,0.000,0.000
3,0.970,Cow,16-23,1539,849,0,2388,64.447,64.447
3,0.970,Cow,23-5,1497,994,0,2491,60.096,60.096
3,0.970,Deer Mouse,16-23,0,0,0,0,NaN,NaN
3,0.970,Deer Mouse,23-5,0,0,0,0,NaN,NaN
3,0.970,OVERALL,16-23,4038,2268,0,6306,64.034,64.034
3,0.970,OVERALL,23-5,4710,2851,0,7561,62.293,62.293
3,0.980,Chicken,16-23,9,27,0,36,25.000,25.000
3,0.980,Chicken,23-5,17,18,0,35,48.571,48.571
3,0.980,Sea Lion,16-23,1,1,0,2,50.000,50.000
3,0.980,Sea Lion,23-5,4,5,0,9,44.444,44.444
3,0.980,Hu and Cw,16-23,15,25,0,40,37.500,37.500
3,0.980,Hu and Cw,23-5,17,40,0,57,29.825,29.825
3,0.980,Sheep,16-23,68,71,0,139,48.921,48.921
3,0.980,Sheep,23-5,71,36,0,107,66.355,66.355
3,0.980,Hu and Dg,16-23,11,18,0,29,37.931,37.931
3,0.980,Hu and Dg,23-5,18,7,0,25,72.000,72.000
3,0.980,Common Loon,16-23,0,2,0,2,0.000,0.000
3,0.980,Common Loon,23-5,0,3,0,3,0.000,0.000
3,0.980,Red-Winged Blackbird,16-23,0,8,0,8,0.000,0.000
3,0.980,Red-Winged Blackbird,23-5,0,3,0,3,0.000,0.000
3,0.980,Cw,16-23,11,13,0,24,45.833,45.833
3,0.980,Cw,23-5,20,31,0,51,39.216,39.216
3,0.980,Cliff Sparrow,16-23,12,38,0,50,24.000,24.000
3,0.980,Cliff Sparrow,23-5,5,35,0,40,12.500,12.500
3,0.980,Pig,16-23,15,19,0,34,44.118,44.118
3,0.980,Pig,23-5,8,10,0,18,44.444,44.444
3,0.980,Barn Owl,16-23,0,0,0,0,NaN,NaN
3,0.980,Barn Owl,23-5,0,5,0,5,0.000,0.000
3,0.980,Wild Pig,16-23,7,12,0,19,36.842,36.842
3,0.980,Wild Pig,23-5,10,8,0,18,55.556,55.556
3,0.980,Pennington Creek Water,16-23,0,0,0,0,NaN,NaN
3,0.980,Pennington Creek Water,23-5,0,0,0,0,NaN,NaN
3,0.980,Guinni,16-23,0,0,0,0,NaN,NaN
3,0.980,Guinni,23-5,0,2,0,2,0.000,0.000
3,0.980,Racoon,16-23,2,3,0,5,40.000,40.000
3,0.980,Racoon,23-5,0,2,0,2,0.000,0.000
3,0.980,Hu,16-23,20,9,0,29,68.966,68.966
3,0.980,Hu,23-5,20,8,0,28,71.429,71.429
3,0.980,Cw and Dg,16-23,12,17,0,29,41.379,41.379
3,0.980,Cw and Dg,23-5,19,17,0,36,52.778,52.778
3,0.980,Red Wind Blackbird,16-23,0,2,0,2,0.000,0.000
3,0.980,Red Wind Blackbird,23-5,0,3,0,3,0.000,0.000
3,0.980,Tree Swallow,16-23,0,2,0,2,0.000,0.000
3,0.980,Tree Swallow,23-5,0,2,0,2,0.000,0.000
3,0.980,Turkey Vulture,16-23,0,1,0,1,0.000,0.000
3,0.980,Turkey Vulture,23-5,0,2,0,2,0.000,0.000
3,0.980,Dg,16-23,9,14,0,23,39.130,39.130
3,0.980,Dg,23-5,29,23,0,52,55.769,55.769
3,0.980,Western Kingbird,16-23,0,1,0,1,0.000,0.000
3,0.980,Western Kingbird,23-5,0,1,0,1,0.000,0.000
3,0.980,White Crowned Sparrow,16-23,12,9,0,21,57.143,57.143
3,0.980,White Crowned Sparrow,23-5,5,20,0,25,20.000,20.000
3,0.980,Eared Grebe,16-23,0,0,0,0,NaN,NaN
3,0.980,Eared Grebe,23-5,4,14,0,18,22.222,22.222
3,0.980,cougar,16-23,0,0,0,0,NaN,NaN
3,0.980,cougar,23-5,0,0,0,0,NaN,NaN
3,0.980,Ocean Water,16-23,0,0,0,0,NaN,NaN
3,0.980,Ocean Water,23-5,0,0,0,0,NaN,NaN
3,0.980,Red Tailed Hawk,16-23,0,2,0,2,0.000,0.000
3,0.980,Red Tailed Hawk,23-5,0,17,0,17,0.000,0.000
3,0.980,Dog,16-23,76,99,0,175,43.429,43.429
3,0.980,Dog,23-5,135,135,0,270,50.000,50.000
3,0.980,Human,16-23,1739,494,0,2233,77.877,77.877
3,0.980,Human,23-5,2227,377,0,2604,85.522,85.522
3,0.980,Wild Turkey,16-23,10,33,0,43,23.256,23.256
3,0.980,Wild Turkey,23-5,8,52,0,60,13.333,13.333
3,0.980,Clark Grebe,16-23,0,0,0,0,NaN,NaN
3,0.980,Clark Grebe,23-5,0,2,0,2,0.000,0.000
3,0.980,Seagull,16-23,0,0,0,0,NaN,NaN
3,0.980,Seagull,23-5,50,4,0,54,92.593,92.593
3,0.980,Surf Scoter,16-23,0,0,0,0,NaN,NaN
3,0.980,Surf Scoter,23-5,2,0,0,2,100.000,100.000
3,0.980,Pigeon,16-23,128,143,0,271,47.232,47.232
3,0.980,Pigeon,23-5,162,284,0,446,36.323,36.323
3,0.980,Pacific Ocean Water,16-23,0,0,0,0,NaN,NaN
3,0.980,Pacific Ocean Water,23-5,0,0,0,0,NaN,NaN
3,0.980,Cat,16-23,34,39,0,73,46.575,46.575
3,0.980,Cat,23-5,42,37,0,79,53.165,53.165
3,0.980,Horse,16-23,21,51,0,72,29.167,29.167
3,0.980,Horse,23-5,41,292,0,333,12.312,12.312
3,0.980,orangutan,16-23,0,0,0,0,NaN,NaN
3,0.980,orangutan,23-5,0,0,0,0,NaN,NaN
3,0.980,Bat,16-23,36,11,0,47,76.596,76.596
3,0.980,Bat,23-5,37,18,0,55,67.273,67.273
3,0.980,Deer,16-23,15,20,0,35,42.857,42.857
3,0.980,Deer,23-5,17,51,0,68,25.000,25.000
3,0.980,Great Horned Owl,16-23,0,4,0,4,0.000,0.000
3,0.980,Great Horned Owl,23-5,1,17,0,18,5.556,5.556
3,0.980,Freshwater Lagoon,16-23,0,0,0,0,NaN,NaN
3,0.980,Freshwater Lagoon,23-5,0,0,0,0,NaN,NaN
3,0.980,Unknown Avian,16-23,0,0,0,0,NaN,NaN
3,0.980,Unknown Avian,23-5,0,0,0,0,NaN,NaN
3,0.980,Human UTI,16-23,93,83,0,176,52.841,52.841
3,0.980,Human UTI,23-5,107,91,0,198,54.040,54.040
3,0.980,unknown,16-23,0,4,0,4,0.000,0.000
3,0.980,unknown,23-5,3,13,0,16,18.750,18.750
3,0.980,SLO Creek Water,16-23,0,0,0,0,NaN,NaN
3,0.980,SLO Creek Water,23-5,1,0,0,1,100.000,100.000
3,0.980,Pig/Swine,16-23,17,9,0,26,65.385,65.385
3,0.980,Pig/Swine,23-5,10,6,0,16,62.500,62.500
3,0.980,Klebsiella,16-23,0,0,0,0,NaN,NaN
3,0.980,Klebsiella,23-5,0,0,0,0,NaN,NaN
3,0.980,Hu Cw and Dg,16-23,11,33,0,44,25.000,25.000
3,0.980,Hu Cw and Dg,23-5,28,33,0,61,45.902,45.902
3,0.980,Ground Squirrel,16-23,112,89,0,201,55.721,55.721
3,0.980,Ground Squirrel,23-5,101,101,0,202,50.000,50.000
3,0.980,Opossum,16-23,0,1,0,1,0.000,0.000
3,0.980,Opossum,23-5,0,9,0,9,0.000,0.000
3,0.980,Cow,16-23,1534,841,0,2375,64.589,64.589
3,0.980,Cow,23-5,1490,979,0,2469,60.348,60.348
3,0.980,Deer Mouse,16-23,0,0,0,0,NaN,NaN
3,0.980,Deer Mouse,23-5,0,0,0,0,NaN,NaN
3,0.980,OVERALL,16-23,4030,2248,0,6278,64.192,64.192
3,0.980,OVERALL,23-5,4709,2813,0,7522,62.603,62.603
3,0.990,Chicken,16-23,9,28,0,37,24.324,24.324
3,0.990,Chicken,23-5,18,17,0,35,51.429,51.429
3,0.990,Sea Lion,16-23,1,1,0,2,50.000,50.000
3,0.990,Sea Lion,23-5,4,5,0,9,44.444,44.444
3,0.990,Hu and Cw,16-23,16,25,0,41,39.024,39.024
3,0.990,Hu and Cw,23-5,18,37,0,55,32.727,32.727
3,0.990,Sheep,16-23,67,69,0,136,49.265,49.265
3,0.990,Sheep,23-5,71,36,0,107,66.355,66.355
3,0.990,Hu and Dg,16-23,11,18,0,29,37.931,37.931
3,0.990,Hu and Dg,23-5,18,6,0,24,75.000,75.000
3,0.990,Common Loon,16-23,0,2,0,2,0.000,0.000
3,0.990,Common Loon,23-5,0,4,0,4,0.000,0.000
3,0.990,Red-Winged Blackbird,16-23,0,7,0,7,0.000,0.000
3,0.990,Red-Winged Blackbird,23-5,0,3,0,3,0.000,0.000
3,0.990,Cw,16-23,11,13,0,24,45.833,45.833
3,0.990,Cw,23-5,20,31,0,51,39.216,39.216
3,0.990,Cliff Sparrow,16-23,12,37,0,49,24.490,24.490
3,0.990,Cliff Sparrow,23-5,5,36,0,41,12.195,12.195
3,0.990,Pig,16-23,15,18,0,33,45.455,45.455
3,0.990,Pig,23-5,8,10,0,18,44.444,44.444
3,0.990,Barn Owl,16-23,0,0,0,0,NaN,NaN
3,0.990,Barn Owl,23-5,0,4,0,4,0.000,0.000
3,0.990,Wild Pig,16-23,7,13,0,20,35.000,35.000
3,0.990,Wild Pig,23-5,10,7,0,17,58.824,58.824
3,0.990,Pennington Creek Water,16-23,0,0,0,0,NaN,NaN
3,0.990,Pennington Creek Water,23-5,0,0,0,0,NaN,NaN
3,0.990,Guinni,16-23,0,0,0,0,NaN,NaN
3,0.990,Guinni,23-5,0,1,0,1,0.000,0.000
3,0.990,Racoon,16-23,2,3,0,5,40.000,40.000
3,0.990,Racoon,23-5,0,2,0,2,0.000,0.000
3,0.990,Hu,16-23,20,8,0,28,71.429,71.429
3,0.990,Hu,23-5,20,5,0,25,80.000,80.000
3,0.990,Cw and Dg,16-23,12,17,0,29,41.379,41.379
3,0.990,Cw and Dg,23-5,19,13,0,32,59.375,59.375
3,0.990,Red Wind Blackbird,16-23,0,2,0,2,0.000,0.000
3,0.990,Red Wind Blackbird,23-5,0,3,0,3,0.000,0.000
3,0.990,Tree Swallow,16-23,0,2,0,2,0.000,0.000
3,0.990,Tree Swallow,23-5,0,2,0,2,0.000,0.000
3,0.990,Turkey Vulture,16-23,0,1,0,1,0.000,0.000
3,0.990,Turkey Vulture,23-5,0,2,0,2,0.000,0.000
3,0.990,Dg,16-23,9,14,0,23,39.130,39.130
3,0.990,Dg,23-5,29,22,0,51,56.863,56.863
3,0.990,Western Kingbird,16-23,0,1,0,1,0.000,0.000
3,0.990,Western Kingbird,23-5,0,1,0,1,0.000,0.000
3,0.990,White Crowned Sparrow,16-23,12,9,0,21,57.143,57.143
3,0.990,White Crowned Sparrow,23-5,5,20,0,25,20.000,20.000
3,0.990,Eared Grebe,16-23,0,0,0,0,NaN,NaN
3,0.990,Eared Grebe,23-5,4,13,0,17,23.529,23.529
3,0.990,cougar,16-23,0,1,0,1,0.000,0.000
3,0.990,cougar,23-5,0,0,0,0,NaN,NaN
3,0.990,Ocean Water,16-23,0,0,0,0,NaN,NaN
3,0.990,Ocean Water,23-5,0,0,0,0,NaN,NaN
3,0.990,Red Tailed Hawk,16-23,0,2,0,2,0.000,0.000
3,0.990,Red Tailed Hawk,23-5,0,17,0,17,0.000,0.000
3,0.990,Dog,16-23,77,93,0,170,45.294,45.294
3,0.990,Dog,23-5,136,131,0,267,50.936,50.936
3,0.990,Human,16-23,1729,469,0,2198,78.662,78.662
3,0.990,Human,23-5,2220,358,0,2578,86.113,86.113
3,0.990,Wild Turkey,16-23,12,31,0,43,27.907,27.907
3,0.990,Wild Turkey,23-5,8,45,0,53,15.094,15.094
3,0.990,Clark Grebe,16-23,0,0,0,0,NaN,NaN
3,0.990,Clark Grebe,23-5,2,3,0,5,40.000,40.000
3,0.990,Seagull,16-23,0,0,0,0,NaN,NaN
3,0.990,Seagull,23-5,50,4,0,54,92.593,92.593
3,0.990,Surf Scoter,16-23,0,0,0,0,NaN,NaN
3,0.990,Surf Scoter,23-5,2,0,0,2,100.000,100.000
3,0.990,Pigeon,16-23,130,140,0,270,48.148,48.148
3,0.990,Pigeon,23-5,162,263,0,425,38.118,38.118
3,0.990,Pacific Ocean Water,16-23,0,0,0,0,NaN,NaN
3,0.990,Pacific Ocean Water,23-5,0,0,0,0,NaN,NaN
3,0.990,Cat,16-23,34,37,0,71,47.887,47.887
3,0.990,Cat,23-5,42,34,0,76,55.263,55.263
3,0.990,Horse,16-23,21,47,0,68,30.882,30.882
3,0.990,Horse,23-5,40,284,0,324,12.346,12.346
3,0.990,orangutan,16-23,0,0,0,0,NaN,NaN
3,0.990,orangutan,23-5,0,0,0,0,NaN,NaN
3,0.990,Bat,16-23,36,11,0,47,76.596,76.596
3,0.990,Bat,23-5,37,17,0,54,68.519,68.519
3,0.990,Deer,16-23,15,20,0,35,42.857,42.857
3,0.990,Deer,23-5,17,50,0,67,25.373,25.373
3,0.990,Great Horned Owl,16-23,0,4,0,4,0.000,0.000
3,0.990,Great Horned Owl,23-5,1,16,0,17,5.882,5.882
3,0.990,Freshwater Lagoon,16-23,0,0,0,0,NaN,NaN
3,0.990,Freshwater Lagoon,23-5,0,0,0,0,NaN,NaN
3,0.990,Unknown Avian,16-23,0,0,0,0,NaN,NaN
3,0.990,Unknown Avian,23-5,0,0,0,0,NaN,NaN
3,0.990,Human UTI,16-23,97,77,0,174,55.747,55.747
3,0.990,Human UTI,23-5,108,76,0,184,58.696,58.696
3,0.990,unknown,16-23,0,4,0,4,0.000,0.000
3,0.990,unknown,23-5,3,12,0,15,20.000,20.000
3,0.990,SLO Creek Water,16-23,0,0,0,0,NaN,NaN
3,0.990,SLO Creek Water,23-5,1,0,0,1,100.000,100.000
3,0.990,Pig/Swine,16-23,16,9,0,25,64.000,64.000
3,0.990,Pig/Swine,23-5,10,7,0,17,58.824,58.824
3,0.990,Klebsiella,16-23,0,0,0,0,NaN,NaN
3,0.990,Klebsiella,23-5,0,0,0,0,NaN,NaN
3,0.990,Hu Cw and Dg,16-23,11,33,0,44,25.000,25.000
3,0.990,Hu Cw and Dg,23-5,28,33,0,61,45.902,45.902
3,0.990,Ground Squirrel,16-23,109,81,0,190,57.368,57.368
3,0.990,Ground Squirrel,23-5,100,91,0,191,52.356,52.356
3,0.990,Opossum,16-23,1,1,0,2,50.000,50.000
3,0.990,Opossum,23-5,2,9,0,11,18.182,18.182
3,0.990,Cow,16-23,1499,786,0,2285,65.602,65.602
3,0.990,Cow,23-5,1462,916,0,2378,61.480,61.480
3,0.990,Deer Mouse,16-23,0,0,0,0,NaN,NaN
3,0.990,Deer Mouse,23-5,0,0,0,0,NaN,NaN
3,0.990,OVERALL,16-23,3991,2134,0,6125,65.159,65.159
3,0.990,OVERALL,23-5,4680,2646,0,7326,63.882,63.882
3,1.000,Chicken,16-23,0,0,0,0,NaN,NaN
3,1.000,Chicken,23-5,0,0,0,0,NaN,NaN
3,1.000,Sea Lion,16-23,0,0,0,0,NaN,NaN
3,1.000,Sea Lion,23-5,0,0,0,0,NaN,NaN
3,1.000,Hu and Cw,16-23,0,0,0,0,NaN,NaN
3,1.000,Hu and Cw,23-5,0,0,0,0,NaN,NaN
3,1.000,Sheep,16-23,0,0,0,0,NaN,NaN
3,1.000,Sheep,23-5,0,0,0,0,NaN,NaN
3,1.000,Hu and Dg,16-23,0,0,0,0,NaN,NaN
3,1.000,Hu and Dg,23-5,0,0,0,0,NaN,NaN
3,1.000,Common Loon,16-23,0,0,0,0,NaN,NaN
3,1.000,Common Loon,23-5,0,0,0,0,NaN,NaN
3,1.000,Red-Winged Blackbird,16-23,0,0,0,0,NaN,NaN
3,1.000,Red-Winged Blackbird,23-5,0,0,0,0,NaN,NaN
3,1.000,Cw,16-23,0,0,0,0,NaN,NaN
3,1.000,Cw,23-5,0,0,0,0,NaN,NaN
3,1.000,Cliff Sparrow,16-23,0,0,0,0,NaN,NaN
3,1.000,Cliff Sparrow,23-5,0,0,0,0,NaN,NaN
3,1.000,Pig,16-23,0,0,0,0,NaN,NaN
3,1.000,Pig,23-5,0,0,0,0,NaN,NaN
3,1.000,Barn Owl,16-23,0,0,0,0,NaN,NaN
3,1.000,Barn Owl,23-5,0,0,0,0,NaN,NaN
3,1.000,Wild Pig,16-23,0,0,0,0,NaN,NaN
3,1.000,Wild Pig,23-5,0,0,0,0,NaN,NaN
3,1.000,Pennington Creek Water,16-23,0,0,0,0,NaN,NaN
3,1.000,Pennington Creek Water,23-5,0,0,0,0,NaN,NaN
3,1.000,Guinni,16-23,0,0,0,0,NaN,NaN
3,1.000,Guinni,23-5,0,0,0,0,NaN,NaN
3,1.000,Racoon,16-23,0,0,0,0,NaN,NaN
3,1.000,Racoon,23-5,0,0,0,0,NaN,NaN
3,1.000,Hu,16-23,0,0,0,0,NaN,NaN
3,1.000,Hu,23-5,0,0,0,0,NaN,NaN
3,1.000,Cw and Dg,16-23,0,0,0,0,NaN,NaN
3,1.000,Cw and Dg,23-5,0,0,0,0,NaN,NaN
3,1.000,Red Wind Blackbird,16-23,0,0,0,0,NaN,NaN
3,1.000,Red Wind Blackbird,23-5,0,0,0,0,NaN,NaN
3,1.000,Tree Swallow,16-23,0,0,0,0,NaN,NaN
3,1.000,Tree Swallow,23-5,0,0,0,0,NaN,NaN
3,1.000,Turkey Vulture,16-23,0,0,0,0,NaN,NaN
3,1.000,Turkey Vulture,23-5,0,0,0,0,NaN,NaN
3,1.000,Dg,16-23,0,0,0,0,NaN,NaN
3,1.000,Dg,23-5,0,0,0,0,NaN,NaN
3,1.000,Western Kingbird,16-23,0,0,0,0,NaN,NaN
3,1.000,Western Kingbird,23-5,0,0,0,0,NaN,NaN
3,1.000,White Crowned Sparrow,16-23,0,0,0,0,NaN,NaN
3,1.000,White Crowned Sparrow,23-5,0,0,0,0,NaN,NaN
3,1.000,Eared Grebe,16-23,0,0,0,0,NaN,NaN
3,1.000,Eared Grebe,23-5,0,0,0,0,NaN,NaN
3,1.000,cougar,16-23,0,0,0,0,NaN,NaN
3,1.000,cougar,23-5,0,0,0,0,NaN,NaN
3,1.000,Ocean Water,16-23,0,0,0,0,NaN,NaN
3,1.000,Ocean Water,23-5,0,0,0,0,NaN,NaN
3,1.000,Red Tailed Hawk,16-23,0,0,0,0,NaN,NaN
3,1.000,Red Tailed Hawk,23-5,0,0,0,0,NaN,NaN
3,1.000,Dog,16-23,0,0,0,0,NaN,NaN
3,1.000,Dog,23-5,0,0,0,0,NaN,NaN
3,1.000,Human,16-23,68,0,0,68,100.000,100.000
3,1.000,Human,23-5,90,0,0,90,100.000,100.000
3,1.000,Wild Turkey,16-23,0,0,0,0,NaN,NaN
3,1.000,Wild Turkey,23-5,0,0,0,0,NaN,NaN
3,1.000,Clark Grebe,16-23,0,0,0,0,NaN,NaN
3,1.000,Clark Grebe,23-5,0,0,0,0,NaN,NaN
3,1.000,Seagull,16-23,0,0,0,0,NaN,NaN
3,1.000,Seagull,23-5,0,0,0,0,NaN,NaN
3,1.000,Surf Scoter,16-23,0,0,0,0,NaN,NaN
3,1.000,Surf Scoter,23-5,0,0,0,0,NaN,NaN
3,1.000,Pigeon,16-23,0,0,0,0,NaN,NaN
3,1.000,Pigeon,23-5,0,0,0,0,NaN,NaN
3,1.000,Pacific Ocean Water,16-23,0,0,0,0,NaN,NaN
3,1.000,Pacific Ocean Water,23-5,0,0,0,0,NaN,NaN
3,1.000,Cat,16-23,0,0,0,0,NaN,NaN
3,1.000,Cat,23-5,0,0,0,0,NaN,NaN
3,1.000,Horse,16-23,0,0,0,0,NaN,NaN
3,1.000,Horse,23-5,0,0,0,0,NaN,NaN
3,1.000,orangutan,16-23,0,0,0,0,NaN,NaN
3,1.000,orangutan,23-5,0,0,0,0,NaN,NaN
3,1.000,Bat,16-23,0,0,0,0,NaN,NaN
3,1.000,Bat,23-5,0,0,0,0,NaN,NaN
3,1.000,Deer,16-23,0,0,0,0,NaN,NaN
3,1.000,Deer,23-5,0,0,0,0,NaN,NaN
3,1.000,Great Horned Owl,16-23,0,0,0,0,NaN,NaN
3,1.000,Great Horned Owl,23-5,0,0,0,0,NaN,NaN
3,1.000,Freshwater Lagoon,16-23,0,0,0,0,NaN,NaN
3,1.000,Freshwater Lagoon,23-5,0,0,0,0,NaN,NaN
3,1.000,Unknown Avian,16-23,0,0,0,0,NaN,NaN
3,1.000,Unknown Avian,23-5,0,0,0,0,NaN,NaN
3,1.000,Human UTI,16-23,0,0,0,0,NaN,NaN
3,1.000,Human UTI,23-5,0,0,0,0,NaN,NaN
3,1.000,unknown,16-23,0,0,0,0,NaN,NaN
3,1.000,unknown,23-5,0,0,0,0,NaN,NaN
3,1.000,SLO Creek Water,16-23,0,0,0,0,NaN,NaN
3,1.000,SLO Creek Water,23-5,0,0,0,0,NaN,NaN
3,1.000,Pig/Swine,16-23,0,0,0,0,NaN,NaN
3,1.000,Pig/Swine,23-5,0,0,0,0,NaN,NaN
3,1.000,Klebsiella,16-23,0,0,0,0,NaN,NaN
3,1.000,Klebsiella,23-5,0,0,0,0,NaN,NaN
3,1.000,Hu Cw and Dg,16-23,0,0,0,0,NaN,NaN
3,1.000,Hu Cw and Dg,23-5,0,0,0,0,NaN,NaN
3,1.000,Ground Squirrel,16-23,0,0,0,0,NaN,NaN
3,1.000,Ground Squirrel,23-5,0,0,0,0,NaN,NaN
3,1.000,Opossum,16-23,0,0,0,0,NaN,NaN
3,1.000,Opossum,23-5,0,0,0,0,NaN,NaN
3,1.000,Cow,16-23,0,0,0,0,NaN,NaN
3,1.000,Cow,23-5,0,0,0,0,NaN,NaN
3,1.000,Deer Mouse,16-23,0,0,0,0,NaN,NaN
3,1.000,Deer Mouse,23-5,0,0,0,0,NaN,NaN
3,1.000,OVERALL,16-23,68,0,0,68,100.000,100.000
3,1.000,OVERALL,23-5,90,0,0,90,100.000,100.000
4,0.000,Chicken,16-23,5,19,0,24,20.833,20.833
4,0.000,Chicken,23-5,17,22,0,39,43.590,43.590
4,0.000,Sea Lion,16-23,0,1,0,1,0.000,0.000
4,0.000,Sea Lion,23-5,4,6,0,10,40.000,40.000
4,0.000,Hu and Cw,16-23,10,25,0,35,28.571,28.571
4,0.000,Hu and Cw,23-5,12,28,0,40,30.000,30.000
4,0.000,Sheep,16-23,67,69,0,136,49.265,49.265
4,0.000,Sheep,23-5,70,40,0,110,63.636,63.636
4,0.000,Hu and Dg,16-23,11,18,0,29,37.931,37.931
4,0.000,Hu and Dg,23-5,16,9,0,25,64.000,64.000
4,0.000,Common Loon,16-23,0,2,0,2,0.000,0.000
4,0.000,Common Loon,23-5,0,3,0,3,0.000,0.000
4,0.000,Red-Winged Blackbird,16-23,0,10,0,10,0.000,0.000
4,0.000,Red-Winged Blackbird,23-5,0,7,0,7,0.000,0.000
4,0.000,Cw,16-23,13,14,0,27,48.148,48.148
4,0.000,Cw,23-5,25,42,0,67,37.313,37.313
4,0.000,Cliff Sparrow,16-23,10,33,0,43,23.256,23.256
4,0.000,Cliff Sparrow,23-5,3,21,0,24,12.500,12.500
4,0.000,Pig,16-23,15,12,0,27,55.556,55.556
4,0.000,Pig,23-5,7,11,0,18,38.889,38.889
4,0.000,Barn Owl,16-23,0,0,0,0,NaN,NaN
4,0.000,Barn Owl,23-5,0,1,0,1,0.000,0.000
4,0.000,Wild Pig,16-23,8,8,0,16,50.000,50.000
4,0.000,Wild Pig,23-5,8,10,0,18,44.444,44.444
4,0.000,Pennington Creek Water,16-23,0,0,0,0,NaN,NaN
4,0.000,Pennington Creek Water,23-5,0,0,0,0,NaN,NaN
4,0.000,Guinni,16-23,0,0,0,0,NaN,NaN
4,0.000,Guinni,23-5,0,2,0,2,0.000,0.000
4,0.000,Racoon,16-23,0,3,0,3,0.000,0.000
4,0.000,Racoon,23-5,0,0,0,0,NaN,NaN
4,0.000,Hu,16-23,18,14,0,32,56.250,56.250
4,0.000,Hu,23-5,20,12,0,32,62.500,62.500
4,0.000,Cw and Dg,16-23,13,19,0,32,40.625,40.625
4,0.000,Cw and Dg,23-5,17,16,0,33,51.515,51.515
4,0.000,Red Wind Blackbird,16-23,0,1,0,1,0.000,0.000
4,0.000,Red Wind Blackbird,23-5,0,3,0,3,0.000,0.000
4,0.000,Tree Swallow,16-23,0,5,0,5,0.000,0.000
4,0.000,Tree Swallow,23-5,0,2,0,2,0.000,0.000
4,0.000,Turkey Vulture,16-23,0,0,0,0,NaN,NaN
4,0.000,Turkey Vulture,23-5,0,4,0,4,0.000,0.000
4,0.000,Dg,16-23,9,16,0,25,36.000,36.000
4,0.000,Dg,23-5,30,22,0,52,57.692,57.692
4,0.000,Western Kingbird,16-23,0,0,0,0,NaN,NaN
4,0.000,Western Kingbird,23-5,0,0,0,0,NaN,NaN
4,0.000,White Crowned Sparrow,16-23,6,12,0,18,33.333,33.333
4,0.000,White Crowned Sparrow,23-5,5,14,0,19,26.316,26.316
4,0.000,Eared Grebe,16-23,0,0,0,0,NaN,NaN
4,0.000,Eared Grebe,23-5,4,17,0,21,19.048,19.048
4,0.000,cougar,16-23,0,0,0,0,NaN,NaN
4,0.000,cougar,23-5,0,0,0,0,NaN,NaN
4,0.000,Ocean Water,16-23,0,0,0,0,NaN,NaN
4,0.000,Ocean Water,23-5,0,0,0,0,NaN,NaN
4,0.000,Red Tailed Hawk,16-23,0,2,0,2,0.000,0.000
4,0.000,Red Tailed Hawk,23-5,0,12,0,12,0.000,0.000
4,0.000,Dog,16-23,74,80,0,154,48.052,48.052
4,0.000,Dog,23-5,131,152,0,283,46.290,46.290
4,0.000,Human,16-23,1755,567,0,2322,75.581,75.581
4,0.000,Human,23-5,2220,445,0,2665,83.302,83.302
4,0.000,Wild Turkey,16-23,11,35,0,46,23.913,23.913
4,0.000,Wild Turkey,23-5,6,37,0,43,13.953,13.953
4,0.000,Clark Grebe,16-23,0,0,0,0,NaN,NaN
4,0.000,Clark Grebe,23-5,0,2,0,2,0.000,0.000
4,0.000,Seagull,16-23,0,0,0,0,NaN,NaN
4,0.000,Seagull,23-5,48,9,0,57,84.211,84.211
4,0.000,Surf Scoter,16-23,0,0,0,0,NaN,NaN
4,0.000,Surf Scoter,23-5,0,4,0,4,0.000,0.000
4,0.000,Pigeon,16-23,131,180,0,311,42.122,42.122
4,0.000,Pigeon,23-5,163,346,0,509,32.024,32.024
4,0.000,Pacific Ocean Water,16-23,0,0,0,0,NaN,NaN
4,0.000,Pacific Ocean Water,23-5,0,0,0,0,NaN,NaN
4,0.000,Cat,16-23,32,38,0,70,45.714,45.714
4,0.000,Cat,23-5,38,39,0,77,49.351,49.351
4,0.000,Horse,16-23,16,45,0,61,26.230,26.230
4,0.000,Horse,23-5,40,246,0,286,13.986,13.986
4,0.000,orangutan,16-23,0,0,0,0,NaN,NaN
4,0.000,orangutan,23-5,0,0,0,0,NaN,NaN
4,0.000,Bat,16-23,36,15,0,51,70.588,70.588
4,0.000,Bat,23-5,37,26,0,63,58.730,58.730
4,0.000,Deer,16-23,15,20,0,35,42.857,42.857
4,0.000,Deer,23-5,17,75,0,92,18.478,18.478
4,0.000,Great Horned Owl,16-23,0,4,0,4,0.000,0.000
4,0.000,Great Horned Owl,23-5,0,8,0,8,0.000,0.000
4,0.000,Freshwater Lagoon,16-23,0,0,0,0,NaN,NaN
4,0.000,Freshwater Lagoon,23-5,0,0,0,0,NaN,NaN
4,0.000,Unknown Avian,16-23,0,0,0,0,NaN,NaN
4,0.000,Unknown Avian,23-5,0,0,0,0,NaN,NaN
4,0.000,Human UTI,16-23,82,84,0,166,49.398,49.398
4,0.000,Human UTI,23-5,112,103,0,215,52.093,52.093
4,0.000,unknown,16-23,0,8,0,8,0.000,0.000
4,0.000,unknown,23-5,2,10,0,12,16.667,16.667
4,0.000,SLO Creek Water,16-23,0,0,0,0,NaN,NaN
4,0.000,SLO Creek Water,23-5,0,0,0,0,NaN,NaN
4,0.000,Pig/Swine,16-23,15,9,0,24,62.500,62.500
4,0.000,Pig/Swine,23-5,11,9,0,20,55.000,55.000
4,0.000,Klebsiella,16-23,0,0,0,0,NaN,NaN
4,0.000,Klebsiella,23-5,0,0,0,0,NaN,NaN
4,0.000,Hu Cw and Dg,16-23,13,25,0,38,34.211,34.211
4,0.000,Hu Cw and Dg,23-5,22,33,0,55,40.000,40.000
4,0.000,Ground Squirrel,16-23,115,80,0,195,58.974,58.974
4,0.000,Ground Squirrel,23-5,98,88,0,186,52.688,52.688
4,0.000,Opossum,16-23,0,2,0,2,0.000,0.000
4,0.000,Opossum,23-5,0,12,0,12,0.000,0.000
4,0.000,Cow,16-23,1502,891,0,2393,62.766,62.766
4,0.000,Cow,23-5,1468,1011,0,2479,59.217,59.217
4,0.000,Deer Mouse,16-23,0,0,0,0,NaN,NaN
4,0.000,Deer Mouse,23-5,0,0,0,0,NaN,NaN
4,0.000,OVERALL,16-23,3982,2366,0,6348,62.728,62.728
4,0.000,OVERALL,23-5,4651,2959,0,7610,61.117,61.117
4,0.500,Chicken,16-23,5,19,0,24,20.833,20.833
4,0.500,Chicken,23-5,17,22,0,39,43.590,43.590
4,0.500,Sea Lion,16-23,0,1,0,1,0.000,0.000
4,0.500,Sea Lion,23-5,4,6,0,10,40.000,40.000
4,0.500,Hu and Cw,16-23,10,25,0,35,28.571,28.571
4,0.500,Hu and Cw,23-5,12,28,0,40,30.000,30.000
4,0.500,Sheep,16-23,67,69,0,136,49.265,49.265
4,0.500,Sheep,23-5,70,40,0,110,63.636,63.636
4,0.500,Hu and Dg,16-23,11,18,0,29,37.931,37.931
4,0.500,Hu and Dg,23-5,16,9,0,25,64.000,64.000
4,0.500,Common Loon,16-23,0,2,0,2,0.000,0.000
4,0.500,Common Loon,23-5,0,3,0,3,0.000,0.000
4,0.500,Red-Winged Blackbird,16-23,0,10,0,10,0.000,0.000
4,0.500,Red-Winged Blackbird,23-5,0,7,0,7,0.000,0.000
4,0.500,Cw,16-23,13,14,0,27,48.148,48.148
4,0.500,Cw,23-5,25,42,0,67,37.313,37.313
4,0.500,Cliff Sparrow,16-23,10,33,0,43,23.256,23.256
4,0.500,Cliff Sparrow,23-5,3,21,0,24,12.500,12.500
4,0.500,Pig,16-23,15,12,0,27,55.556,55.556
4,0.500,Pig,23-5,7,11,0,18,38.889,38.889
4,0.500,Barn Owl,16-23,0,0,0,0,NaN,NaN
4,0.500,Barn Owl,23-5,0,1,0,1,0.000,0.000
4,0.500,Wild Pig,16-23,8,8,0,16,50.000,50.000
4,0.500,Wild Pig,23-5,8,10,0,18,44.444,44.444
4,0.500,Pennington Creek Water,16-23,0,0,0,0,NaN,NaN
4,0.500,Pennington Creek Water,23-5,0,0,0,0,NaN,NaN
4,0.500,Guinni,16-23,0,0,0,0,NaN,NaN
4,0.500,Guinni,23-5,0,2,0,2,0.000,0.000
4,0.500,Racoon,16-23,0,3,0,3,0.000,0.000
4,0.500,Racoon,23-5,0,0,0,0,NaN,NaN
4,0.500,Hu,16-23,18,14,0,32,56.250,56.250
4,0.500,Hu,23-5,20,12,0,32,62.500,62.500
4,0.500,Cw and Dg,16-23,13,19,0,32,40.625,40.625
4,0.500,Cw and Dg,23-5,17,16,0,33,51.515,51.515
4,0.500,Red Wind Blackbird,16-23,0,1,0,1,0.000,0.000
4,0.500,Red Wind Blackbird,23-5,0,3,0,3,0.000,0.000
4,0.500,Tree Swallow,16-23,0,5,0,5,0.000,0.000
4,0.500,Tree Swallow,23-5,0,2,0,2,0.000,0.000
4,0.500,Turkey Vulture,16-23,0,0,0,0,NaN,NaN
4,0.500,Turkey Vulture,23-5,0,4,0,4,0.000,0.000
4,0.500,Dg,16-23,9,16,0,25,36.000,36.000
4,0.500,Dg,23-5,30,22,0,52,57.692,57.692
4,0.500,Western Kingbird,16-23,0,0,0,0,NaN,NaN
4,0.500,Western Kingbird,23-5,0,0,0,0,NaN,NaN
4,0.500,White Crowned Sparrow,16-23,6,12,0,18,33.333,33.333
4,0.500,White Crowned Sparrow,23-5,5,14,0,19,26.316,26.316
4,0.500,Eared Grebe,16-23,0,0,0,0,NaN,NaN
4,0.500,Eared Grebe,23-5,4,17,0,21,19.048,19.048
4,0.500,cougar,16-23,0,0,0,0,NaN,NaN
4,0.500,cougar,23-5,0,0,0,0,NaN,NaN
4,0.500,Ocean Water,16-23,0,0,0,0,NaN,NaN
4,0.500,Ocean Water,23-5,0,0,0,0,NaN,NaN
4,0.500,Red Tailed Hawk,16-23,0,2,0,2,0.000,0.000
4,0.500,Red Tailed Hawk,23-5,0,12,0,12,0.000,0.000
4,0.500,Dog,16-23,74,80,0,154,48.052,48.052
4,0.500,Dog,23-5,131,152,0,283,46.290,46.290
4,0.500,Human,16-23,1755,567,0,2322,75.581,75.581
4,0.500,Human,23-5,2220,445,0,2665,83.302,83.302
4,0.500,Wild Turkey,16-23,11,35,0,46,23.913,23.913
4,0.500,Wild Turkey,23-5,6,37,0,43,13.953,13.953
4,0.500,Clark Grebe,16-23,0,0,0,0,NaN,NaN
4,0.500,Clark Grebe,23-5,0,2,0,2,0.000,0.000
4,0.500,Seagull,16-23,0,0,0,0,NaN,NaN
4,0.500,Seagull,23-5,48,9,0,57,84.211,84.211
4,0.500,Surf Scoter,16-23,0,0,0,0,NaN,NaN
4,0.500,Surf Scoter,23-5,0,4,0,4,0.000,0.000
4,0.500,Pigeon,16-23,131,180,0,311,42.122,42.122
4,0.500,Pigeon,23-5,163,346,0,509,32.024,32.024
4,0.500,Pacific Ocean Water,16-23,0,0,0,0,NaN,NaN
4,0.500,Pacific Ocean Water,23-5,0,0,0,0,NaN,NaN
4,0.500,Cat,16-23,32,38,0,70,45.714,45.714
4,0.500,Cat,23-5,38,39,0,77,49.351,49.351
4,0.500,Horse,16-23,16,45,0,61,26.230,26.230
4,0.500,Horse,23-5,40,246,0,286,13.986,13.986
4,0.500,orangutan,16-23,0,0,0,0,NaN,NaN
4,0.500,orangutan,23-5,0,0,0,0,NaN,NaN
4,0.500,Bat,16-23,36,15,0,51,70.588,70.588
4,0.500,Bat,23-5,37,26,0,63,58.730,58.730
4,0.500,Deer,16-23,15,20,0,35,42.857,42.857
4,0.500,Deer,23-5,17,75,0,92,18.478,18.478
4,0.500,Great Horned Owl,16-23,0,4,0,4,0.000,0.000
4,0.500,Great Horned Owl,23-5,0,8,0,8,0.000,0.000
4,0.500,Freshwater Lagoon,16-23,0,0,0,0,NaN,NaN
4,0.500,Freshwater Lagoon,23-5,0,0,0,0,NaN,NaN
4,0.500,Unknown Avian,16-23,0,0,0,0,NaN,NaN
4,0.500,Unknown Avian,23-5,0,0,0,0,NaN,NaN
4,0.500,Human UTI,16-23,82,84,0,166,49.398,49.398
4,0.500,Human UTI,23-5,112,103,0,215,52.093,52.093
4,0.500,unknown,16-23,0,8,0,8,0.000,0.000
4,0.500,unknown,23-5,2,10,0,12,16.667,16.667
4,0.500,SLO Creek Water,16-23,0,0,0,0,NaN,NaN
4,0.500,SLO Creek Water,23-5,0,0,0,0,NaN,NaN
4,0.500,Pig/Swine,16-23,15,9,0,24,62.500,62.500
4,0.500,Pig/Swine,23-5,11,9,0,20,55.000,55.000
4,0.500,Klebsiella,16-23,0,0,0,0,NaN,NaN
4,0.500,Klebsiella,23-5,0,0,0,0,NaN,NaN
4,0.500,Hu Cw and Dg,16-23,13,25,0,38,34.211,34.211
4,0.500,Hu Cw and Dg,23-5,22,33,0,55,40.000,40.000
4,0.500,Ground Squirrel,16-23,115,80,0,195,58.974,58.974
4,0.500,Ground Squirrel,23-5,98,88,0,186,52.688,52.688
4,0.500,Opossum,16-23,0,2,0,2,0.000,0.000
4,0.500,Opossum,23-5,0,12,0,12,0.000,0.000
4,0.500,Cow,16-23,1502,891,0,2393,62.766,62.766
4,0.500,Cow,23-5,1468,1011,0,2479,59.217,59.217
4,0.500,Deer Mouse,16-23,0,0,0,0,NaN,NaN
4,0.500,Deer Mouse,23-5,0,0,0,0,NaN,NaN
4,0.500,OVERALL,16-23,3982,2366,0,6348,62.728,62.728
4,0.500,OVERALL,23-5,4651,2959,0,7610,61.117,61.117
4,0.900,Chicken,16-23,5,19,0,24,20.833,20.833
4,0.900,Chicken,23-5,17,22,0,39,43.590,43.590
4,0.900,Sea Lion,16-23,0,1,0,1,0.000,0.000
4,0.900,Sea Lion,23-5,4,6,0,10,40.000,40.000
4,0.900,Hu and Cw,16-23,10,25,0,35,28.571,28.571
4,0.900,Hu and Cw,23-5,12,28,0,40,30.000,30.000
4,0.900,Sheep,16-23,67,69,0,136,49.265,49.265
4,0.900,Sheep,23-5,70,40,0,110,63.636,63.636
4,0.900,Hu and Dg,16-23,11,18,0,29,37.931,37.931
4,0.900,Hu and Dg,23-5,16,9,0,25,64.000,64.000
4,0.900,Common Loon,16-23,0,2,0,2,0.000,0.000
4,0.900,Common Loon,23-5,0,3,0,3,0.000,0.000
4,0.900,Red-Winged Blackbird,16-23,0,10,0,10,0.000,0.000
4,0.900,Red-Winged Blackbird,23-5,0,7,0,7,0.000,0.000
4,0.900,Cw,16-23,13,14,0,27,48.148,48.148
4,0.900,Cw,23-5,25,42,0,67,37.313,37.313
4,0.900,Cliff Sparrow,16-23,10,33,0,43,23.256,23.256
4,0.900,Cliff Sparrow,23-5,3,21,0,24,12.500,12.500
4,0.900,Pig,16-23,15,12,0,27,55.556,55.556
4,0.900,Pig,23-5,7,11,0,18,38.889,38.889
4,0.900,Barn Owl,16-23,0,0,0,0,NaN,NaN
4,0.900,Barn Owl,23-5,0,1,0,1,0.000,0.000
4,0.900,Wild Pig,16-23,8,8,0,16,50.000,50.000
4,0.900,Wild Pig,23-5,8,10,0,18,44.444,44.444
4,0.900,Pennington Creek Water,16-23,0,0,0,0,NaN,NaN
4,0.900,Pennington Creek Water,23-5,0,0,0,0,NaN,NaN
4,0.900,Guinni,16-23,0,0,0,0,NaN,NaN
4,0.900,Guinni,23-5,0,2,0,2,0.000,0.000
4,0.900,Racoon,16-23,0,3,0,3,0.000,0.000
4,0.900,Racoon,23-5,0,0,0,0,NaN,NaN
4,0.900,Hu,16-23,18,14,0,32,56.250,56.250
4,0.900,Hu,23-5,20,12,0,32,62.500,62.500
4,0.900,Cw and Dg,16-23,13,19,0,32,40.625,40.625
4,0.900,Cw and Dg,23-5,17,16,0,33,51.515,51.515
4,0.900,Red Wind Blackbird,16-23,0,1,0,1,0.000,0.000
4,0.900,Red Wind Blackbird,23-5,0,3,0,3,0.000,0.000
4,0.900,Tree Swallow,16-23,0,5,0,5,0.000,0.000
4,0.900,Tree Swallow,23-5,0,2,0,2,0.000,0.000
4,0.900,Turkey Vulture,16-23,0,0,0,0,NaN,NaN
4,0.900,Turkey Vulture,23-5,0,4,0,4,0.000,0.000
4,0.900,Dg,16-23,9,16,0,25,36.000,36.000
4,0.900,Dg,23-5,30,22,0,52,57.692,57.692
4,0.900,Western Kingbird,16-23,0,0,0,0,NaN,NaN
4,0.900,Western Kingbird,23-5,0,0,0,0,NaN,NaN
4,0.900,White Crowned Sparrow,16-23,6,12,0,18,33.333,33.333
4,0.900,White Crowned Sparrow,23-5,5,14,0,19,26.316,26.316
4,0.900,Eared Grebe,16-23,0,0,0,0,NaN,NaN
4,0.900,Eared Grebe,23-5,4,17,0,21,19.048,19.048
4,0.900,cougar,16-23,0,0,0,0,NaN,NaN
4,0.900,cougar,23-5,0,0,0,0,NaN,NaN
4,0.900,Ocean Water,16-23,0,0,0,0,NaN,NaN
4,0.900,Ocean Water,23-5,0,0,0,0,NaN,NaN
4,0.900,Red Tailed Hawk,16-23,0,2,0,2,0.000,0.000
4,0.900,Red Tailed Hawk,23-5,0,12,0,12,0.000,0.000
4,0.900,Dog,16-23,74,80,0,154,48.052,48.052
4,0.900,Dog,23-5,131,150,0,281,46.619,46.619
4,0.900,Human,16-23,1755,563,0,2318,75.712,75.712
4,0.900,Human,23-5,2220,441,0,2661,83.427,83.427
4,0.900,Wild Turkey,16-23,11,35,0,46,23.913,23.913
4,0.900,Wild Turkey,23-5,6,37,0,43,13.953,13.953
4,0.900,Clark Grebe,16-23,0,0,0,0,NaN,NaN
4,0.900,Clark Grebe,23-5,0,2,0,2,0.000,0.000
4,0.900,Seagull,16-23,0,0,0,0,NaN,NaN
4,0.900,Seagull,23-5,48,9,0,57,84.211,84.211
4,0.900,Surf Scoter,16-23,0,0,0,0,NaN,NaN
4,0.900,Surf Scoter,23-5,0,4,0,4,0.000,0.000
4,0.900,Pigeon,16-23,131,180,0,311,42.122,42.122
4,0.900,Pigeon,23-5,163,346,0,509,32.024,32.024
4,0.900,Pacific Ocean Water,16-23,0,0,0,0,NaN,NaN
4,0.900,Pacific Ocean Water,23-5,0,0,0,0,NaN,NaN
4,0.900,Cat,16-23,32,38,0,70,45.714,45.714
4,0.900,Cat,23-5,38,39,0,77,49.351,49.351
4,0.900,Horse,16-23,16,45,0,61,26.230,26.230
4,0.900,Horse,23-5,40,246,0,286,13.986,13.986
4,0.900,orangutan,16-23,0,0,0,0,NaN,NaN
4,0.900,orangutan,23-5,0,0,0,0,NaN,NaN
4,0.900,Bat,16-23,36,15,0,51,70.588,70.588
4,0.900,Bat,23-5,37,26,0,63,58.730,58.730
4,0.900,Deer,16-23,15,20,0,35,42.857,42.857
4,0.900,Deer,23-5,17,75,0,92,18.478,18.478
4,0.900,Great Horned Owl,16-23,0,4,0,4,0.000,0.000
4,0.900,Great Horned Owl,23-5,0,8,0,8,0.000,0.000
4,0.900,Freshwater Lagoon,16-23,0,0,0,0,NaN,NaN
4,0.900,Freshwater Lagoon,23-5,0,0,0,0,NaN,NaN
4,0.900,Unknown Avian,16-23,0,0,0,0,NaN,NaN
4,0.900,Unknown Avian,23-5,0,0,0,0,NaN,NaN
4,0.900,Human UTI,16-23,82,84,0,166,49.398,49.398
4,0.900,Human UTI,23-5,112,103,0,215,52.093,52.093
4,0.900,unknown,16-23,0,8,0,8,0.000,0.000
4,0.900,unknown,23-5,2,10,0,12,16.667,16.667
4,0.900,SLO Creek Water,16-23,0,0,0,0,NaN,NaN
4,0.900,SLO Creek Water,23-5,0,0,0,0,NaN,NaN
4,0.900,Pig/Swine,16-23,15,9,0,24,62.500,62.500
4,0.900,Pig/Swine,23-5,11,9,0,20,55.000,55.000
4,0.900,Klebsiella,16-23,0,0,0,0,NaN,NaN
4,0.900,Klebsiella,23-5,0,0,0,0,NaN,NaN
4,0.900,Hu Cw and Dg,16-23,13,25,0,38,34.211,34.211
4,0.900,Hu Cw and Dg,23-5,22,33,0,55,40.000,40.000
4,0.900,Ground Squirrel,16-23,115,80,0,195,58.974,58.974
4,0.900,Ground Squirrel,23-5,98,88,0,186,52.688,52.688
4,0.900,Opossum,16-23,0,2,0,2,0.000,0.000
4,0.900,Opossum,23-5,0,12,0,12,0.000,0.000
4,0.900,Cow,16-23,1502,891,0,2393,62.766,62.766
4,0.900,Cow,23-5,1468,1009,0,2477,59.265,59.265
4,0.900,Deer Mouse,16-23,0,0,0,0,NaN,NaN
4,0.900,Deer Mouse,23-5,0,0,0,0,NaN,NaN
4,0.900,OVERALL,16-23,3982,2362,0,6344,62.768,62.768
4,0.900,OVERALL,23-5,4651,2951,0,7602,61.181,61.181
4,0.950,Chicken,16-23,5,19,0,24,20.833,20.833
4,0.950,Chicken,23-5,17,22,0,39,43.590,43.590
4,0.950,Sea Lion,16-23,0,1,0,1,0.000,0.000
4,0.950,Sea Lion,23-5,4,6,0,10,40.000,40.000
4,0.950,Hu and Cw,16-23,10,25,0,35,28.571,28.571
4,0.950,Hu and Cw,23-5,12,28,0,40,30.000,30.000
4,0.950,Sheep,16-23,67,69,0,136,49.265,49.265
4,0.950,Sheep,23-5,70,40,0,110,63.636,63.636
4,0.950,Hu and Dg,16-23,11,18,0,29,37.931,37.931
4,0.950,Hu and Dg,23-5,16,9,0,25,64.000,64.000
4,0.950,Common Loon,16-23,0,2,0,2,0.000,0.000
4,0.950,Common Loon,23-5,0,3,0,3,0.000,0.000
4,0.950,Red-Winged Blackbird,16-23,0,10,0,10,0.000,0.000
4,0.950,Red-Winged Blackbird,23-5,0,7,0,7,0.000,0.000
4,0.950,Cw,16-23,13,14,0,27,48.148,48.148
4,0.950,Cw,23-5,25,42,0,67,37.313,37.313
4,0.950,Cliff Sparrow,16-23,10,33,0,43,23.256,23.256
4,0.950,Cliff Sparrow,23-5,3,21,0,24,12.500,12.500
4,0.950,Pig,16-23,15,12,0,27,55.556,55.556
4,0.950,Pig,23-5,7,11,0,18,38.889,38.889
4,0.950,Barn Owl,16-23,0,0,0,0,NaN,NaN
4,0.950,Barn Owl,23-5,0,1,0,1,0.000,0.000
4,0.950,Wild Pig,16-23,8,8,0,16,50.000,50.000
4,0.950,Wild Pig,23-5,8,9,0,17,47.059,47.059
4,0.950,Pennington Creek Water,16-23,0,0,0,0,NaN,NaN
4,0.950,Pennington Creek Water,23-5,0,0,0,0,NaN,NaN
4,0.950,Guinni,16-23,0,0,0,0,NaN,NaN
4,0.950,Guinni,23-5,0,2,0,2,0.000,0.000
4,0.950,Racoon,16-23,0,3,0,3,0.000,0.000
4,0.950,Racoon,23-5,0,0,0,0,NaN,NaN
4,0.950,Hu,16-23,18,14,0,32,56.250,56.250
4,0.950,Hu,23-5,20,12,0,32,62.500,62.500
4,0.950,Cw and Dg,16-23,13,19,0,32,40.625,40.625
4,0.950,Cw and Dg,23-5,17,16,0,33,51.515,51.515
4,0.950,Red Wind Blackbird,16-23,0,1,0,1,0.000,0.000
4,0.950,Red Wind Blackbird,23-5,0,3,0,3,0.000,0.000
4,0.950,Tree Swallow,16-23,0,5,0,5,0.000,0.000
4,0.950,Tree Swallow,23-5,0,2,0,2,0.000,0.000
4,0.950,Turkey Vulture,16-23,0,0,0,0,NaN,NaN
4,0.950,Turkey Vulture,23-5,0,4,0,4,0.000,0.000
4,0.950,Dg,16-23,9,16,0,25,36.000,36.000
4,0.950,Dg,23-5,30,22,0,52,57.692,57.692
4,0.950,Western Kingbird,16-23,0,0,0,0,NaN,NaN
4,0.950,Western Kingbird,23-5,0,0,0,0,NaN,NaN
4,0.950,White Crowned Sparrow,16-23,6,12,0,18,33.333,33.333
4,0.950,White Crowned Sparrow,23-5,5,14,0,19,26.316,26.316
4,0.950,Eared Grebe,16-23,0,0,0,0,NaN,NaN
4,0.950,Eared Grebe,23-5,4,17,0,21,19.048,19.048
4,0.950,cougar,16-23,0,0,0,0,NaN,NaN
4,0.950,cougar,23-5,0,0,0,0,NaN,NaN
4,0.950,Ocean Water,16-23,0,0,0,0,NaN,NaN
4,0.950,Ocean Water,23-5,0,0,0,0,NaN,NaN
4,0.950,Red Tailed Hawk,16-23,0,2,0,2,0.000,0.000
4,0.950,Red Tailed Hawk,23-5,0,12,0,12,0.000,0.000
4,0.950,Dog,16-23,74,80,0,154,48.052,48.052
4,0.950,Dog,23-5,131,150,0,281,46.619,46.619
4,0.950,Human,16-23,1755,562,0,2317,75.744,75.744
4,0.950,Human,23-5,2222,436,0,2658,83.597,83.597
4,0.950,Wild Turkey,16-23,11,35,0,46,23.913,23.913
4,0.950,Wild Turkey,23-5,6,37,0,43,13.953,13.953
4,0.950,Clark Grebe,16-23,0,0,0,0,NaN,NaN
4,0.950,Clark Grebe,23-5,0,2,0,2,0.000,0.000
4,0.950,Seagull,16-23,0,0,0,0,NaN,NaN
4,0.950,Seagull,23-5,48,8,0,56,85.714,85.714
4,0.950,Surf Scoter,16-23,0,0,0,0,NaN,NaN
4,0.950,Surf Scoter,23-5,0,2,0,2,0.000,0.000
4,0.950,Pigeon,16-23,131,180,0,311,42.122,42.122
4,0.950,Pigeon,23-5,163,346,0,509,32.024,32.024
4,0.950,Pacific Ocean Water,16-23,0,0,0,0,NaN,NaN
4,0.950,Pacific Ocean Water,23-5,0,0,0,0,NaN,NaN
4,0.950,Cat,16-23,32,38,0,70,45.714,45.714
4,0.950,Cat,23-5,38,39,0,77,49.351,49.351
4,0.950,Horse,16-23,16,45,0,61,26.230,26.230
4,0.950,Horse,23-5,40,246,0,286,13.986,13.986
4,0.950,orangutan,16-23,0,0,0,0,NaN,NaN
4,0.950,orangutan,23-5,0,0,0,0,NaN,NaN
4,0.950,Bat,16-23,36,15,0,51,70.588,70.588
4,0.950,Bat,23-5,37,25,0,62,59.677,59.677
4,0.950,Deer,16-23,15,20,0,35,42.857,42.857
4,0.950,Deer,23-5,17,75,0,92,18.478,18.478
4,0.950,Great Horned Owl,16-23,0,4,0,4,0.000,0.000
4,0.950,Great Horned Owl,23-5,0,8,0,8,0.000,0.000
4,0.950,Freshwater Lagoon,16-23,0,0,0,0,NaN,NaN
4,0.950,Freshwater Lagoon,23-5,0,0,0,0,NaN,NaN
4,0.950,Unknown Avian,16-23,0,0,0,0,NaN,NaN
4,0.950,Unknown Avian,23-5,0,0,0,0,NaN,NaN
4,0.950,Human UTI,16-23,82,83,0,165,49.697,49.697
4,0.950,Human UTI,23-5,111,102,0,213,52.113,52.113
4,0.950,unknown,16-23,0,8,0,8,0.000,0.000
4,0.950,unknown,23-5,2,10,0,12,16.667,16.667
4,0.950,SLO Creek Water,16-23,0,0,0,0,NaN,NaN
4,0.950,SLO Creek Water,23-5,0,0,0,0,NaN,NaN
4,0.950,Pig/Swine,16-23,15,9,0,24,62.500,62.500
4,0.950,Pig/Swine,23-5,11,9,0,20,55.000,55.000
4,0.950,Klebsiella,16-23,0,0,0,0,NaN,NaN
4,0.950,Klebsiella,23-5,0,0,0,0,NaN,NaN
4,0.950,Hu Cw and Dg,16-23,13,25,0,38,34.211,34.211
4,0.950,Hu Cw and Dg,23-5,22,33,0,55,40.000,40.000
4,0.950,Ground Squirrel,16-23,115,80,0,195,58.974,58.974
4,0.950,Ground Squirrel,23-5,98,87,0,185,52.973,52.973
4,0.950,Opossum,16-23,0,2,0,2,0.000,0.000
4,0.950,Opossum,23-5,0,12,0,12,0.000,0.000
4,0.950,Cow,16-23,1503,875,0,2378,63.204,63.204
4,0.950,Cow,23-5,1467,1009,0,2476,59.249,59.249
4,0.950,Deer Mouse,16-23,0,0,0,0,NaN,NaN
4,0.950,Deer Mouse,23-5,0,0,0,0,NaN,NaN
4,0.950,OVERALL,16-23,3983,2344,0,6327,62.952,62.952
4,0.950,OVERALL,23-5,4651,2939,0,7590,61.278,61.278
4,0.960,Chicken,16-23,5,19,0,24,20.833,20.833
4,0.960,Chicken,23-5,17,22,0,39,43.590,43.590
4,0.960,Sea Lion,16-23,0,1,0,1,0.000,0.000
4,0.960,Sea Lion,23-5,4,6,0,10,40.000,40.000
4,0.960,Hu and Cw,16-23,10,25,0,35,28.571,28.571
4,0.960,Hu and Cw,23-5,12,28,0,40,30.000,30.000
4,0.960,Sheep,16-23,67,69,0,136,49.265,49.265
4,0.960,Sheep,23-5,70,40,0,110,63.636,63.636
4,0.960,Hu and Dg,16-23,11,18,0,29,37.931,37.931
4,0.960,Hu and Dg,23-5,16,9,0,25,64.000,64.000
4,0.960,Common Loon,16-23,0,2,0,2,0.000,0.000
4,0.960,Common Loon,23-5,0,3,0,3,0.000,0.000
4,0.960,Red-Winged Blackbird,16-23,0,10,0,10,0.000,0.000
4,0.960,Red-Winged Blackbird,23-5,0,7,0,7,0.000,0.000
4,0.960,Cw,16-23,13,14,0,27,48.148,48.148
4,0.960,Cw,23-5,25,42,0,67,37.313,37.313
4,0.960,Cliff Sparrow,16-23,10,33,0,43,23.256,23.256
4,0.960,Cliff Sparrow,23-5,3,21,0,24,12.500,12.500
4,0.960,Pig,16-23,15,12,0,27,55.556,55.556
4,0.960,Pig,23-5,7,11,0,18,38.889,38.889
4,0.960,Barn Owl,16-23,0,0,0,0,NaN,NaN
4,0.960,Barn Owl,23-5,0,1,0,1,0.000,0.000
4,0.960,Wild Pig,16-23,8,8,0,16,50.000,50.000
4,0.960,Wild Pig,23-5,8,9,0,17,47.059,47.059
4,0.960,Pennington Creek Water,16-23,0,0,0,0,NaN,NaN
4,0.960,Pennington Creek Water,23-5,0,0,0,0,NaN,NaN
4,0.960,Guinni,16-23,0,0,0,0,NaN,NaN
4,0.960,Guinni,23-5,0,2,0,2,0.000,0.000
4,0.960,Racoon,16-23,0,3,0,3,0.000,0.000
4,0.960,Racoon,23-5,0,0,0,0,NaN,NaN
4,0.960,Hu,16-23,18,14,0,32,56.250,56.250
4,0.960,Hu,23-5,20,12,0,32,62.500,62.500
4,0.960,Cw and Dg,16-23,13,19,0,32,40.625,40.625
4,0.960,Cw and Dg,23-5,17,16,0,33,51.515,51.515
4,0.960,Red Wind Blackbird,16-23,0,1,0,1,0.000,0.000
4,0.960,Red Wind Blackbird,23-5,0,3,0,3,0.000,0.000
4,0.960,Tree Swallow,16-23,0,5,0,5,0.000,0.000
4,0.960,Tree Swallow,23-5,0,2,0,2,0.000,0.000
4,0.960,Turkey Vulture,16-23,0,0,0,0,NaN,NaN
4,0.960,Turkey Vulture,23-5,0,4,0,4,0.000,0.000
4,0.960,Dg,16-23,9,16,0,25,36.000,36.000
4,0.960,Dg,23-5,30,22,0,52,57.692,57.692
4,0.960,Western Kingbird,16-23,0,0,0,0,NaN,NaN
4,0.960,Western Kingbird,23-5,0,0,0,0,NaN,NaN
4,0.960,White Crowned Sparrow,16-23,6,12,0,18,33.333,33.333
4,0.960,White Crowned Sparrow,23-5,5,14,0,19,26.316,26.316
4,0.960,Eared Grebe,16-23,0,0,0,0,NaN,NaN
4,0.960,Eared Grebe,23-5,4,17,0,21,19.048,19.048
4,0.960,cougar,16-23,0,0,0,0,NaN,NaN
4,0.960,cougar,23-5,0,0,0,0,NaN,NaN
4,0.960,Ocean Water,16-23,0,0,0,0,NaN,NaN
4,0.960,Ocean Water,23-5,0,0,0,0,NaN,NaN
4,0.960,Red Tailed Hawk,16-23,0,2,0,2,0.000,0.000
4,0.960,Red Tailed Hawk,23-5,0,12,0,12,0.000,0.000
4,0.960,Dog,16-23,74,80,0,154,48.052,48.052
4,0.960,Dog,23-5,131,147,0,278,47.122,47.122
4,0.960,Human,16-23,1755,561,0,2316,75.777,75.777
4,0.960,Human,23-5,2223,426,0,2649,83.918,83.918
4,0.960,Wild Turkey,16-23,11,35,0,46,23.913,23.913
4,0.960,Wild Turkey,23-5,6,39,0,45,13.333,13.333
4,0.960,Clark Grebe,16-23,0,0,0,0,NaN,NaN
4,0.960,Clark Grebe,23-5,0,2,0,2,0.000,0.000
4,0.960,Seagull,16-23,0,0,0,0,NaN,NaN
4,0.960,Seagull,23-5,48,8,0,56,85.714,85.714
4,0.960,Surf Scoter,16-23,0,0,0,0,NaN,NaN
4,0.960,Surf Scoter,23-5,0,2,0,2,0.000,0.000
4,0.960,Pigeon,16-23,131,180,0,311,42.122,42.122
4,0.960,Pigeon,23-5,164,346,0,510,32.157,32.157
4,0.960,Pacific Ocean Water,16-23,0,0,0,0,NaN,NaN
4,0.960,Pacific Ocean Water,23-5,0,0,0,0,NaN,NaN
4,0.960,Cat,16-23,32,38,0,70,45.714,45.714
4,0.960,Cat,23-5,38,39,0,77,49.351,49.351
4,0.960,Horse,16-23,16,45,0,61,26.230,26.230
4,0.960,Horse,23-5,40,246,0,286,13.986,13.986
4,0.960,orangutan,16-23,0,0,0,0,NaN,NaN
4,0.960,orangutan,23-5,0,0,0,0,NaN,NaN
4,0.960,Bat,16-23,36,15,0,51,70.588,70.588
4,0.960,Bat,23-5,37,25,0,62,59.677,59.677
4,0.960,Deer,16-23,15,20,0,35,42.857,42.857
4,0.960,Deer,23-5,17,75,0,92,18.478,18.478
4,0.960,Great Horned Owl,16-23,0,4,0,4,0.000,0.000
4,0.960,Great Horned Owl,23-5,0,8,0,8,0.000,0.000
4,0.960,Freshwater Lagoon,16-23,0,0,0,0,NaN,NaN
4,0.960,Freshwater Lagoon,23-5,0,0,0,0,NaN,NaN
4,0.960,Unknown Avian,16-23,0,0,0,0,NaN,NaN
4,0.960,Unknown Avian,23-5,0,0,0,0,NaN,NaN
4,0.960,Human UTI,16-23,82,83,0,165,49.697,49.697
4,0.960,Human UTI,23-5,111,101,0,212,52.358,52.358
4,0.960,unknown,16-23,0,8,0,8,0.000,0.000
4,0.960,unknown,23-5,2,10,0,12,16.667,16.667
4,0.960,SLO Creek Water,16-23,0,0,0,0,NaN,NaN
4,0.960,SLO Creek Water,23-5,0,0,0,0,NaN,NaN
4,0.960,Pig/Swine,16-23,15,9,0,24,62.500,62.500
4,0.960,Pig/Swine,23-5,11,9,0,20,55.000,55.000
4,0.960,Klebsiella,16-23,0,0,0,0,NaN,NaN
4,0.960,Klebsiella,23-5,0,0,0,0,NaN,NaN
4,0.960,Hu Cw and Dg,16-23,13,25,0,38,34.211,34.211
4,0.960,Hu Cw and Dg,23-5,22,33,0,55,40.000,40.000
4,0.960,Ground Squirrel,16-23,115,80,0,195,58.974,58.974
4,0.960,Ground Squirrel,23-5,98,87,0,185,52.973,52.973
4,0.960,Opossum,16-23,0,2,0,2,0.000,0.000
4,0.960,Opossum,23-5,0,12,0,12,0.000,0.000
4,0.960,Cow,16-23,1501,867,0,2368,63.387,63.387
4,0.960,Cow,23-5,1467,1009,0,2476,59.249,59.249
4,0.960,Deer Mouse,16-23,0,0,0,0,NaN,NaN
4,0.960,Deer Mouse,23-5,0,0,0,0,NaN,NaN
4,0.960,OVERALL,16-23,3981,2335,0,6316,63.030,63.030
4,0.960,OVERALL,23-5,4653,2927,0,7580,61.385,61.385
4,0.970,Chicken,16-23,5,19,0,24,20.833,20.833
4,0.970,Chicken,23-5,17,22,0,39,43.590,43.590
4,0.970,Sea Lion,16-23,0,1,0,1,0.000,0.000
4,0.970,Sea Lion,23-5,4,6,0,10,40.000,40.000
4,0.970,Hu and Cw,16-23,10,25,0,35,28.571,28.571
4,0.970,Hu and Cw,23-5,12,28,0,40,30.000,30.000
4,0.970,Sheep,16-23,67,69,0,136,49.265,49.265
4,0.970,Sheep,23-5,70,39,0,109,64.220,64.220
4,0.970,Hu and Dg,16-23,11,18,0,29,37.931,37.931
4,0.970,Hu and Dg,23-5,16,9,0,25,64.000,64.000
4,0.970,Common Loon,16-23,0,2,0,2,0.000,0.000
4,0.970,Common Loon,23-5,0,3,0,3,0.000,0.000
4,0.970,Red-Winged Blackbird,16-23,0,10,0,10,0.000,0.000
4,0.970,Red-Winged Blackbird,23-5,0,7,0,7,0.000,0.000
4,0.970,Cw,16-23,13,15,0,28,46.429,46.429
4,0.970,Cw,23-5,25,42,0,67,37.313,37.313
4,0.970,Cliff Sparrow,16-23,10,33,0,43,23.256,23.256
4,0.970,Cliff Sparrow,23-5,3,21,0,24,12.500,12.500
4,0.970,Pig,16-23,15,12,0,27,55.556,55.556
4,0.970,Pig,23-5,7,11,0,18,38.889,38.889
4,0.970,Barn Owl,16-23,0,0,0,0,NaN,NaN
4,0.970,Barn Owl,23-5,0,1,0,1,0.000,0.000
4,0.970,Wild Pig,16-23,8,8,0,16,50.000,50.000
4,0.970,Wild Pig,23-5,7,9,0,16,43.750,43.750
4,0.970,Pennington Creek Water,16-23,0,0,0,0,NaN,NaN
4,0.970,Pennington Creek Water,23-5,0,0,0,0,NaN,NaN
4,0.970,Guinni,16-23,0,0,0,0,NaN,NaN
4,0.970,Guinni,23-5,0,2,0,2,0.000,0.000
4,0.970,Racoon,16-23,0,3,0,3,0.000,0.000
4,0.970,Racoon,23-5,0,0,0,0,NaN,NaN
4,0.970,Hu,16-23,18,14,0,32,56.250,56.250
4,0.970,Hu,23-5,20,12,0,32,62.500,62.500
4,0.970,Cw and Dg,16-23,13,19,0,32,40.625,40.625
4,0.970,Cw and Dg,23-5,17,16,0,33,51.515,51.515
4,0.970,Red Wind Blackbird,16-23,0,1,0,1,0.000,0.000
4,0.970,Red Wind Blackbird,23-5,0,3,0,3,0.000,0.000
4,0.970,Tree Swallow,16-23,0,5,0,5,0.000,0.000
4,0.970,Tree Swallow,23-5,0,2,0,2,0.000,0.000
4,0.970,Turkey Vulture,16-23,0,0,0,0,NaN,NaN
4,0.970,Turkey Vulture,23-5,0,4,0,4,0.000,0.000
4,0.970,Dg,16-23,9,16,0,25,36.000,36.000
4,0.970,Dg,23-5,30,21,0,51,58.824,58.824
4,0.970,Western Kingbird,16-23,0,0,0,0,NaN,NaN
4,0.970,Western Kingbird,23-5,0,0,0,0,NaN,NaN
4,0.970,White Crowned Sparrow,16-23,6,12,0,18,33.333,33.333
4,0.970,White Crowned Sparrow,23-5,5,14,0,19,26.316,26.316
4,0.970,Eared Grebe,16-23,0,0,0,0,NaN,NaN
4,0.970,Eared Grebe,23-5,4,17,0,21,19.048,19.048
4,0.970,cougar,16-23,0,0,0,0,NaN,NaN
4,0.970,cougar,23-5,0,0,0,0,NaN,NaN
4,0.970,Ocean Water,16-23,0,0,0,0,NaN,NaN
4,0.970,Ocean Water,23-5,0,0,0,0,NaN,NaN
4,0.970,Red Tailed Hawk,16-23,0,2,0,2,0.000,0.000
4,0.970,Red Tailed Hawk,23-5,0,12,0,12,0.000,0.000
4,0.970,Dog,16-23,74,80,0,154,48.052,48.052
4,0.970,Dog,23-5,131,145,0,276,47.464,47.464
4,0.970,Human,16-23,1755,558,0,2313,75.875,75.875
4,0.970,Human,23-5,2222,425,0,2647,83.944,83.944
4,0.970,Wild Turkey,16-23,11,36,0,47,23.404,23.404
4,0.970,Wild Turkey,23-5,6,39,0,45,13.333,13.333
4,0.970,Clark Grebe,16-23,0,0,0,0,NaN,NaN
4,0.970,Clark Grebe,23-5,0,2,0,2,0.000,0.000
4,0.970,Seagull,16-23,0,0,0,0,NaN,NaN
4,0.970,Seagull,23-5,48,9,0,57,84.211,84.211
4,0.970,Surf Scoter,16-23,0,0,0,0,NaN,NaN
4,0.970,Surf Scoter,23-5,0,2,0,2,0.000,0.000
4,0.970,Pigeon,16-23,129,180,0,309,41.748,41.748
4,0.970,Pigeon,23-5,164,347,0,511,32.094,32.094
4,0.970,Pacific Ocean Water,16-23,0,0,0,0,NaN,NaN
4,0.970,Pacific Ocean Water,23-5,0,0,0,0,NaN,NaN
4,0.970,Cat,16-23,32,38,0,70,45.714,45.714
4,0.970,Cat,23-5,38,39,0,77,49.351,49.351
4,0.970,Horse,16-23,16,45,0,61,26.230,26.230
4,0.970,Horse,23-5,40,246,0,286,13.986,13.986
4,0.970,orangutan,16-23,0,0,0,0,NaN,NaN
4,0.970,orangutan,23-5,0,0,0,0,NaN,NaN
4,0.970,Bat,16-23,36,15,0,51,70.588,70.588
4,0.970,Bat,23-5,37,25,0,62,59.677,59.677
4,0.970,Deer,16-23,15,20,0,35,42.857,42.857
4,0.970,Deer,23-5,17,75,0,92,18.478,18.478
4,0.970,Great Horned Owl,16-23,0,4,0,4,0.000,0.000
4,0.970,Great Horned Owl,23-5,0,8,0,8,0.000,0.000
4,0.970,Freshwater Lagoon,16-23,0,0,0,0,NaN,NaN
4,0.970,Freshwater Lagoon,23-5,0,0,0,0,NaN,NaN
4,0.970,Unknown Avian,16-23,0,0,0,0,NaN,NaN
4,0.970,Unknown Avian,23-5,0,0,0,0,NaN,NaN
4,0.970,Human UTI,16-23,83,83,0,166,50.000,50.000
4,0.970,Human UTI,23-5,110,99,0,209,52.632,52.632
4,0.970,unknown,16-23,0,8,0,8,0.000,0.000
4,0.970,unknown,23-5,2,10,0,12,16.667,16.667
4,0.970,SLO Creek Water,16-23,0,0,0,0,NaN,NaN
4,0.970,SLO Creek Water,23-5,0,0,0,0,NaN,NaN
4,0.970,Pig/Swine,16-23,15,9,0,24,62.500,62.500
4,0.970,Pig/Swine,23-5,11,9,0,20,55.000,55.000
4,0.970,Klebsiella,16-23,0,0,0,0,NaN,NaN
4,0.970,Klebsiella,23-5,0,0,0,0,NaN,NaN
4,0.970,Hu Cw and Dg,16-23,13,25,0,38,34.211,34.211
4,0.970,Hu Cw and Dg,23-5,22,33,0,55,40.000,40.000
4,0.970,Ground Squirrel,16-23,114,77,0,191,59.686,59.686
4,0.970,Ground Squirrel,23-5,98,85,0,183,53.552,53.552
4,0.970,Opossum,16-23,0,2,0,2,0.000,0.000
4,0.970,Opossum,23-5,0,12,0,12,0.000,0.000
4,0.970,Cow,16-23,1497,867,0,2364,63.325,63.325
4,0.970,Cow,23-5,1465,1002,0,2467,59.384,59.384
4,0.970,Deer Mouse,16-23,0,0,0,0,NaN,NaN
4,0.970,Deer Mouse,23-5,0,0,0,0,NaN,NaN
4,0.970,OVERALL,16-23,3975,2331,0,6306,63.035,63.035
4,0.970,OVERALL,23-5,4648,2913,0,7561,61.473,61.473
4,0.980,Chicken,16-23,5,19,0,24,20.833,20.833
4,0.980,Chicken,23-5,18,22,0,40,45.000,45.000
4,0.980,Sea Lion,16-23,0,1,0,1,0.000,0.000
4,0.980,Sea Lion,23-5,4,6,0,10,40.000,40.000
4,0.980,Hu and Cw,16-23,10,25,0,35,28.571,28.571
4,0.980,Hu and Cw,23-5,12,30,0,42,28.571,28.571
4,0.980,Sheep,16-23,67,67,0,134,50.000,50.000
4,0.980,Sheep,23-5,69,38,0,107,64.486,64.486
4,0.980,Hu and Dg,16-23,11,18,0,29,37.931,37.931
4,0.980,Hu and Dg,23-5,16,9,0,25,64.000,64.000
4,0.980,Common Loon,16-23,0,2,0,2,0.000,0.000
4,0.980,Common Loon,23-5,0,2,0,2,0.000,0.000
4,0.980,Red-Winged Blackbird,16-23,0,10,0,10,0.000,0.000
4,0.980,Red-Winged Blackbird,23-5,0,7,0,7,0.000,0.000
4,0.980,Cw,16-23,13,14,0,27,48.148,48.148
4,0.980,Cw,23-5,25,42,0,67,37.313,37.313
4,0.980,Cliff Sparrow,16-23,10,31,0,41,24.390,24.390
4,0.980,Cliff Sparrow,23-5,3,21,0,24,12.500,12.500
4,0.980,Pig,16-23,15,12,0,27,55.556,55.556
4,0.980,Pig,23-5,7,11,0,18,38.889,38.889
4,0.980,Barn Owl,16-23,0,0,0,0,NaN,NaN
4,0.980,Barn Owl,23-5,0,1,0,1,0.000,0.000
4,0.980,Wild Pig,16-23,8,8,0,16,50.000,50.000
4,0.980,Wild Pig,23-5,7,8,0,15,46.667,46.667
4,0.980,Pennington Creek Water,16-23,0,0,0,0,NaN,NaN
4,0.980,Pennington Creek Water,23-5,0,0,0,0,NaN,NaN
4,0.980,Guinni,16-23,0,0,0,0,NaN,NaN
4,0.980,Guinni,23-5,0,2,0,2,0.000,0.000
4,0.980,Racoon,16-23,0,3,0,3,0.000,0.000
4,0.980,Racoon,23-5,0,0,0,0,NaN,NaN
4,0.980,Hu,16-23,18,14,0,32,56.250,56.250
4,0.980,Hu,23-5,20,12,0,32,62.500,62.500
4,0.980,Cw and Dg,16-23,13,19,0,32,40.625,40.625
4,0.980,Cw and Dg,23-5,17,15,0,32,53.125,53.125
4,0.980,Red Wind Blackbird,16-23,0,1,0,1,0.000,0.000
4,0.980,Red Wind Blackbird,23-5,0,3,0,3,0.000,0.000
4,0.980,Tree Swallow,16-23,0,5,0,5,0.000,0.000
4,0.980,Tree Swallow,23-5,0,2,0,2,0.000,0.000
4,0.980,Turkey Vulture,16-23,0,0,0,0,NaN,NaN
4,0.980,Turkey Vulture,23-5,0,4,0,4,0.000,0.000
4,0.980,Dg,16-23,9,16,0,25,36.000,36.000
4,0.980,Dg,23-5,30,21,0,51,58.824,58.824
4,0.980,Western Kingbird,16-23,0,0,0,0,NaN,NaN
4,0.980,Western Kingbird,23-5,0,0,0,0,NaN,NaN
4,0.980,White Crowned Sparrow,16-23,6,12,0,18,33.333,33.333
4,0.980,White Crowned Sparrow,23-5,5,14,0,19,26.316,26.316
4,0.980,Eared Grebe,16-23,0,0,0,0,NaN,NaN
4,0.980,Eared Grebe,23-5,4,17,0,21,19.048,19.048
4,0.980,cougar,16-23,0,0,0,0,NaN,NaN
4,0.980,cougar,23-5,0,0,0,0,NaN,NaN
4,0.980,Ocean Water,16-23,0,0,0,0,NaN,NaN
4,0.980,Ocean Water,23-5,0,0,0,0,NaN,NaN
4,0.980,Red Tailed Hawk,16-23,0,2,0,2,0.000,0.000
4,0.980,Red Tailed Hawk,23-5,0,12,0,12,0.000,0.000
4,0.980,Dog,16-23,73,81,0,154,47.403,47.403
4,0.980,Dog,23-5,131,145,0,276,47.464,47.464
4,0.980,Human,16-23,1755,552,0,2307,76.073,76.073
4,0.980,Human,23-5,2224,416,0,2640,84.242,84.242
4,0.980,Wild Turkey,16-23,11,36,0,47,23.404,23.404
4,0.980,Wild Turkey,23-5,8,42,0,50,16.000,16.000
4,0.980,Clark Grebe,16-23,0,0,0,0,NaN,NaN
4,0.980,Clark Grebe,23-5,0,2,0,2,0.000,0.000
4,0.980,Seagull,16-23,0,0,0,0,NaN,NaN
4,0.980,Seagull,23-5,50,6,0,56,89.286,89.286
4,0.980,Surf Scoter,16-23,0,0,0,0,NaN,NaN
4,0.980,Surf Scoter,23-5,2,0,0,2,100.000,100.000
4,0.980,Pigeon,16-23,129,179,0,308,41.883,41.883
4,0.980,Pigeon,23-5,163,348,0,511,31.898,31.898
4,0.980,Pacific Ocean Water,16-23,0,0,0,0,NaN,NaN
4,0.980,Pacific Ocean Water,23-5,0,0,0,0,NaN,NaN
4,0.980,Cat,16-23,32,36,0,68,47.059,47.059
4,0.980,Cat,23-5,38,37,0,75,50.667,50.667
4,0.980,Horse,16-23,16,45,0,61,26.230,26.230
4,0.980,Horse,23-5,40,241,0,281,14.235,14.235
4,0.980,orangutan,16-23,0,0,0,0,NaN,NaN
4,0.980,orangutan,23-5,0,0,0,0,NaN,NaN
4,0.980,Bat,16-23,36,15,0,51,70.588,70.588
4,0.980,Bat,23-5,37,25,0,62,59.677,59.677
4,0.980,Deer,16-23,15,20,0,35,42.857,42.857
4,0.980,Deer,23-5,17,75,0,92,18.478,18.478
4,0.980,Great Horned Owl,16-23,0,4,0,4,0.000,0.000
4,0.980,Great Horned Owl,23-5,0,8,0,8,0.000,0.000
4,0.980,Freshwater Lagoon,16-23,0,0,0,0,NaN,NaN
4,0.980,Freshwater Lagoon,23-5,0,0,0,0,NaN,NaN
4,0.980,Unknown Avian,16-23,0,0,0,0,NaN,NaN
4,0.980,Unknown Avian,23-5,0,0,0,0,NaN,NaN
4,0.980,Human UTI,16-23,83,81,0,164,50.610,50.610
4,0.980,Human UTI,23-5,110,96,0,206,53.398,53.398
4,0.980,unknown,16-23,0,8,0,8,0.000,0.000
4,0.980,unknown,23-5,2,10,0,12,16.667,16.667
4,0.980,SLO Creek Water,16-23,0,0,0,0,NaN,NaN
4,0.980,SLO Creek Water,23-5,0,0,0,0,NaN,NaN
4,0.980,Pig/Swine,16-23,15,9,0,24,62.500,62.500
4,0.980,Pig/Swine,23-5,11,9,0,20,55.000,55.000
4,0.980,Klebsiella,16-23,0,0,0,0,NaN,NaN
4,0.980,Klebsiella,23-5,0,0,0,0,NaN,NaN
4,0.980,Hu Cw and Dg,16-23,13,25,0,38,34.211,34.211
4,0.980,Hu Cw and Dg,23-5,22,31,0,53,41.509,41.509
4,0.980,Ground Squirrel,16-23,113,77,0,190,59.474,59.474
4,0.980,Ground Squirrel,23-5,98,82,0,180,54.444,54.444
4,0.980,Opossum,16-23,0,2,0,2,0.000,0.000
4,0.980,Opossum,23-5,0,12,0,12,0.000,0.000
4,0.980,Cow,16-23,1493,860,0,2353,63.451,63.451
4,0.980,Cow,23-5,1461,987,0,2448,59.681,59.681
4,0.980,Deer Mouse,16-23,0,0,0,0,NaN,NaN
4,0.980,Deer Mouse,23-5,0,0,0,0,NaN,NaN
4,0.980,OVERALL,16-23,3969,2309,0,6278,63.221,63.221
4,0.980,OVERALL,23-5,4651,2871,0,7522,61.832,61.832
4,0.990,Chicken,16-23,5,23,0,28,17.857,17.857
4,0.990,Chicken,23-5,19,21,0,40,47.500,47.500
4,0.990,Sea Lion,16-23,0,1,0,1,0.000,0.000
4,0.990,Sea Lion,23-5,4,6,0,10,40.000,40.000
4,0.990,Hu and Cw,16-23,11,25,0,36,30.556,30.556
4,0.990,Hu and Cw,23-5,13,27,0,40,32.500,32.500
4,0.990,Sheep,16-23,65,65,0,130,50.000,50.000
4,0.990,Sheep,23-5,69,37,0,106,65.094,65.094
4,0.990,Hu and Dg,16-23,11,19,0,30,36.667,36.667
4,0.990,Hu and Dg,23-5,16,7,0,23,69.565,69.565
4,0.990,Common Loon,16-23,0,2,0,2,0.000,0.000
4,0.990,Common Loon,23-5,0,3,0,3,0.000,0.000
4,0.990,Red-Winged Blackbird,16-23,0,9,0,9,0.000,0.000
4,0.990,Red-Winged Blackbird,23-5,0,7,0,7,0.000,0.000
4,0.990,Cw,16-23,13,14,0,27,48.148,48.148
4,0.990,Cw,23-5,24,41,0,65,36.923,36.923
4,0.990,Cliff Sparrow,16-23,10,31,0,41,24.390,24.390
4,0.990,Cliff Sparrow,23-5,3,22,0,25,12.000,12.000
4,0.990,Pig,16-23,15,13,0,28,53.571,53.571
4,0.990,Pig,23-5,7,11,0,18,38.889,38.889
4,0.990,Barn Owl,16-23,0,0,0,0,NaN,NaN
4,0.990,Barn Owl,23-5,0,1,0,1,0.000,0.000
4,0.990,Wild Pig,16-23,8,9,0,17,47.059,47.059
4,0.990,Wild Pig,23-5,7,6,0,13,53.846,53.846
4,0.990,Pennington Creek Water,16-23,0,0,0,0,NaN,NaN
4,0.990,Pennington Creek Water,23-5,0,0,0,0,NaN,NaN
4,0.990,Guinni,16-23,0,0,0,0,NaN,NaN
4,0.990,Guinni,23-5,0,1,0,1,0.000,0.000
4,0.990,Racoon,16-23,0,3,0,3,0.000,0.000
4,0.990,Racoon,23-5,0,1,0,1,0.000,0.000
4,0.990,Hu,16-23,18,12,0,30,60.000,60.000
4,0.990,Hu,23-5,20,8,0,28,71.429,71.429
4,0.990,Cw and Dg,16-23,13,19,0,32,40.625,40.625
4,0.990,Cw and Dg,23-5,16,12,0,28,57.143,57.143
4,0.990,Red Wind Blackbird,16-23,0,1,0,1,0.000,0.000
4,0.990,Red Wind Blackbird,23-5,0,3,0,3,0.000,0.000
4,0.990,Tree Swallow,16-23,0,5,0,5,0.000,0.000
4,0.990,Tree Swallow,23-5,0,2,0,2,0.000,0.000
4,0.990,Turkey Vulture,16-23,0,0,0,0,NaN,NaN
4,0.990,Turkey Vulture,23-5,0,4,0,4,0.000,0.000
4,0.990,Dg,16-23,9,16,0,25,36.000,36.000
4,0.990,Dg,23-5,30,20,0,50,60.000,60.000
4,0.990,Western Kingbird,16-23,0,0,0,0,NaN,NaN
4,0.990,Western Kingbird,23-5,0,0,0,0,NaN,NaN
4,0.990,White Crowned Sparrow,16-23,6,11,0,17,35.294,35.294
4,0.990,White Crowned Sparrow,23-5,5,13,0,18,27.778,27.778
4,0.990,Eared Grebe,16-23,0,0,0,0,NaN,NaN
4,0.990,Eared Grebe,23-5,4,16,0,20,20.000,20.000
4,0.990,cougar,16-23,0,1,0,1,0.000,0.000
4,0.990,cougar,23-5,0,0,0,0,NaN,NaN
4,0.990,Ocean Water,16-23,0,0,0,0,NaN,NaN
4,0.990,Ocean Water,23-5,0,0,0,0,NaN,NaN
4,0.990,Red Tailed Hawk,16-23,0,2,0,2,0.000,0.000
4,0.990,Red Tailed Hawk,23-5,0,12,0,12,0.000,0.000
4,0.990,Dog,16-23,73,78,0,151,48.344,48.344
4,0.990,Dog,23-5,131,136,0,267,49.064,49.064
4,0.990,Human,16-23,1744,526,0,2270,76.828,76.828
4,0.990,Human,23-5,2216,393,0,2609,84.937,84.937
4,0.990,Wild Turkey,16-23,13,37,0,50,26.000,26.000
4,0.990,Wild Turkey,23-5,8,39,0,47,17.021,17.021
4,0.990,Clark Grebe,16-23,0,0,0,0,NaN,NaN
4,0.990,Clark Grebe,23-5,2,3,0,5,40.000,40.000
4,0.990,Seagull,16-23,0,0,0,0,NaN,NaN
4,0.990,Seagull,23-5,51,6,0,57,89.474,89.474
4,0.990,Surf Scoter,16-23,0,0,0,0,NaN,NaN
4,0.990,Surf Scoter,23-5,2,0,0,2,100.000,100.000
4,0.990,Pigeon,16-23,130,172,0,302,43.046,43.046
4,0.990,Pigeon,23-5,164,326,0,490,33.469,33.469
4,0.990,Pacific Ocean Water,16-23,0,0,0,0,NaN,NaN
4,0.990,Pacific Ocean Water,23-5,0,0,0,0,NaN,NaN
4,0.990,Cat,16-23,32,34,0,66,48.485,48.485
4,0.990,Cat,23-5,38,34,0,72,52.778,52.778
4,0.990,Horse,16-23,16,43,0,59,27.119,27.119
4,0.990,Horse,23-5,39,237,0,276,14.130,14.130
4,0.990,orangutan,16-23,0,0,0,0,NaN,NaN
4,0.990,orangutan,23-5,0,0,0,0,NaN,NaN
4,0.990,Bat,16-23,36,15,0,51,70.588,70.588
4,0.990,Bat,23-5,37,25,0,62,59.677,59.677
4,0.990,Deer,16-23,15,21,0,36,41.667,41.667
4,0.990,Deer,23-5,17,74,0,91,18.681,18.681
4,0.990,Great Horned Owl,16-23,0,4,0,4,0.000,0.000
4,0.990,Great Horned Owl,23-5,0,7,0,7,0.000,0.000
4,0.990,Freshwater Lagoon,16-23,0,0,0,0,NaN,NaN
4,0.990,Freshwater Lagoon,23-5,0,0,0,0,NaN,NaN
4,0.990,Unknown Avian,16-23,0,0,0,0,NaN,NaN
4,0.990,Unknown Avian,23-5,0,0,0,0,NaN,NaN
4,0.990,Human UTI,16-23,87,74,0,161,54.037,54.037
4,0.990,Human UTI,23-5,111,80,0,191,58.115,58.115
4,0.990,unknown,16-23,0,8,0,8,0.000,0.000
4,0.990,unknown,23-5,2,11,0,13,15.385,15.385
4,0.990,SLO Creek Water,16-23,0,0,0,0,NaN,NaN
4,0.990,SLO Creek Water,23-5,0,0,0,0,NaN,NaN
4,0.990,Pig/Swine,16-23,15,9,0,24,62.500,62.500
4,0.990,Pig/Swine,23-5,11,9,0,20,55.000,55.000
4,0.990,Klebsiella,16-23,0,0,0,0,NaN,NaN
4,0.990,Klebsiella,23-5,0,0,0,0,NaN,NaN
4,0.990,Hu Cw and Dg,16-23,13,25,0,38,34.211,34.211
4,0.990,Hu Cw and Dg,23-5,22,31,0,53,41.509,41.509
4,0.990,Ground Squirrel,16-23,110,73,0,183,60.109,60.109
4,0.990,Ground Squirrel,23-5,99,75,0,174,56.897,56.897
4,0.990,Opossum,16-23,1,2,0,3,33.333,33.333
4,0.990,Opossum,23-5,2,12,0,14,14.286,14.286
4,0.990,Cow,16-23,1459,795,0,2254,64.729,64.729
4,0.990,Cow,23-5,1434,924,0,2358,60.814,60.814
4,0.990,Deer Mouse,16-23,0,0,0,0,NaN,NaN
4,0.990,Deer Mouse,23-5,0,0,0,0,NaN,NaN
4,0.990,OVERALL,16-23,3928,2197,0,6125,64.131,64.131
4,0.990,OVERALL,23-5,4623,2703,0,7326,63.104,63.104
4,1.000,Chicken,16-23,0,0,0,0,NaN,NaN
4,1.000,Chicken,23-5,0,0,0,0,NaN,NaN
4,1.000,Sea Lion,16-23,0,0,0,0,NaN,NaN
4,1.000,Sea Lion,23-5,0,0,0,0,NaN,NaN
4,1.000,Hu and Cw,16-23,0,0,0,0,NaN,NaN
4,1.000,Hu and Cw,23-5,0,0,0,0,NaN,NaN
4,1.000,Sheep,16-23,0,0,0,0,NaN,NaN
4,1.000,Sheep,23-5,0,0,0,0,NaN,NaN
4,1.000,Hu and Dg,16-23,0,0,0,0,NaN,NaN
4,1.000,Hu and Dg,23-5,0,0,0,0,NaN,NaN
4,1.000,Common Loon,16-23,0,0,0,0,NaN,NaN
4,1.000,Common Loon,23-5,0,0,0,0,NaN,NaN
4,1.000,Red-Winged Blackbird,16-23,0,0,0,0,NaN,NaN
4,1.000,Red-Winged Blackbird,23-5,0,0,0,0,NaN,NaN
4,1.000,Cw,16-23,0,0,0,0,NaN,NaN
4,1.000,Cw,23-5,0,0,0,0,NaN,NaN
4,1.000,Cliff Sparrow,16-23,0,0,0,0,NaN,NaN
4,1.000,Cliff Sparrow,23-5,0,0,0,0,NaN,NaN
4,1.000,Pig,16-23,0,0,0,0,NaN,NaN
4,1.000,Pig,23-5,0,0,0,0,NaN,NaN
4,1.000,Barn Owl,16-23,0,0,0,0,NaN,NaN
4,1.000,Barn Owl,23-5,0,0,0,0,NaN,NaN
4,1.000,Wild Pig,16-23,0,0,0,0,NaN,NaN
4,1.000,Wild Pig,23-5,0,0,0,0,NaN,NaN
4,1.000,Pennington Creek Water,16-23,0,0,0,0,NaN,NaN
4,1.000,Pennington Creek Water,23-5,0,0,0,0,NaN,NaN
4,1.000,Guinni,16-23,0,0,0,0,NaN,NaN
4,1.000,Guinni,23-5,0,0,0,0,NaN,NaN
4,1.000,Racoon,16-23,0,0,0,0,NaN,NaN
4,1.000,Racoon,23-5,0,0,0,0,NaN,NaN
4,1.000,Hu,16-23,0,0,0,0,NaN,NaN
4,1.000,Hu,23-5,0,0,0,0,NaN,NaN
4,1.000,Cw and Dg,16-23,0,0,0,0,NaN,NaN
4,1.000,Cw and Dg,23-5,0,0,0,0,NaN,NaN
4,1.000,Red Wind Blackbird,16-23,0,0,0,0,NaN,NaN
4,1.000,Red Wind Blackbird,23-5,0,0,0,0,NaN,NaN
4,1.000,Tree Swallow,16-23,0,0,0,0,NaN,NaN
4,1.000,Tree Swallow,23-5,0,0,0,0,NaN,NaN
4,1.000,Turkey Vulture,16-23,0,0,0,0,NaN,NaN
4,1.000,Turkey Vulture,23-5,0,0,0,0,NaN,NaN
4,1.000,Dg,16-23,0,0,0,0,NaN,NaN
4,1.000,Dg,23-5,0,0,0,0,NaN,NaN
4,1.000,Western Kingbird,16-23,0,0,0,0,NaN,NaN
4,1.000,Western Kingbird,23-5,0,0,0,0,NaN,NaN
4,1.000,White Crowned Sparrow,16-23,0,0,0,0,NaN,NaN
4,1.000,White Crowned Sparrow,23-5,0,0,0,0,NaN,NaN
4,1.000,Eared Grebe,16-23,0,0,0,0,NaN,NaN
4,1.000,Eared Grebe,23-5,0,0,0,0,NaN,NaN
4,1.000,cougar,16-23,0,0,0,0,NaN,NaN
4,1.000,cougar,23-5,0,0,0,0,NaN,NaN
4,1.000,Ocean Water,16-23,0,0,0,0,NaN,NaN
4,1.000,Ocean Water,23-5,0,0,0,0,NaN,NaN
4,1.000,Red Tailed Hawk,16-23,0,0,0,0,NaN,NaN
4,1.000,Red Tailed Hawk,23-5,0,0,0,0,NaN,NaN
4,1.000,Dog,16-23,0,0,0,0,NaN,NaN
4,1.000,Dog,23-5,0,0,0,0,NaN,NaN
4,1.000,Human,16-23,68,0,0,68,100.000,100.000
4,1.000,Human,23-5,90,0,0,90,100.000,100.000
4,1.000,Wild Turkey,16-23,0,0,0,0,NaN,NaN
4,1.000,Wild Turkey,23-5,0,0,0,0,NaN,NaN
4,1.000,Clark Grebe,16-23,0,0,0,0,NaN,NaN
4,1.000,Clark Grebe,23-5,0,0,0,0,NaN,NaN
4,1.000,Seagull,16-23,0,0,0,0,NaN,NaN
4,1.000,Seagull,23-5,0,0,0,0,NaN,NaN
4,1.000,Surf Scoter,16-23,0,0,0,0,NaN,NaN
4,1.000,Surf Scoter,23-5,0,0,0,0,NaN,NaN
4,1.000,Pigeon,16-23,0,0,0,0,NaN,NaN
4,1.000,Pigeon,23-5,0,0,0,0,NaN,NaN
4,1.000,Pacific Ocean Water,16-23,0,0,0,0,NaN,NaN
4,1.000,Pacific Ocean Water,23-5,0,0,0,0,NaN,NaN
4,1.000,Cat,16-23,0,0,0,0,NaN,NaN
4,1.000,Cat,23-5,0,0,0,0,NaN,NaN
4,1.000,Horse,16-23,0,0,0,0,NaN,NaN
4,1.000,Horse,23-5,0,0,0,0,NaN,NaN
4,1.000,orangutan,16-23,0,0,0,0,NaN,NaN
4,1.000,orangutan,23-5,0,0,0,0,NaN,NaN
4,1.000,Bat,16-23,0,0,0,0,NaN,NaN
4,1.000,Bat,23-5,0,0,0,0,NaN,NaN
4,1.000,Deer,16-23,0,0,0,0,NaN,NaN
4,1.000,Deer,23-5,0,0,0,0,NaN,NaN
4,1.000,Great Horned Owl,16-23,0,0,0,0,NaN,NaN
4,1.000,Great Horned Owl,23-5,0,0,0,0,NaN,NaN
4,1.000,Freshwater Lagoon,16-23,0,0,0,0,NaN,NaN
4,1.000,Freshwater Lagoon,23-5,0,0,0,0,NaN,NaN
4,1.000,Unknown Avian,16-23,0,0,0,0,NaN,NaN
4,1.000,Unknown Avian,23-5,0,0,0,0,NaN,NaN
4,1.000,Human UTI,16-23,0,0,0,0,NaN,NaN
4,1.000,Human UTI,23-5,0,0,0,0,NaN,NaN
4,1.000,unknown,16-23,0,0,0,0,NaN,NaN
4,1.000,unknown,23-5,0,0,0,0,NaN,NaN
4,1.000,SLO Creek Water,16-23,0,0,0,0,NaN,NaN
4,1.000,SLO Creek Water,23-5,0,0,0,0,NaN,NaN
4,1.000,Pig/Swine,16-23,0,0,0,0,NaN,NaN
4,1.000,Pig/Swine,23-5,0,0,0,0,NaN,NaN
4,1.000,Klebsiella,16-23,0,0,0,0,NaN,NaN
4,1.000,Klebsiella,23-5,0,0,0,0,NaN,NaN
4,1.000,Hu Cw and Dg,16-23,0,0,0,0,NaN,NaN
4,1.000,Hu Cw and Dg,23-5,0,0,0,0,NaN,NaN
4,1.000,Ground Squirrel,16-23,0,0,0,0,NaN,NaN
4,1.000,Ground Squirrel,23-5,0,0,0,0,NaN,NaN
4,1.000,Opossum,16-23,0,0,0,0,NaN,NaN
4,1.000,Opossum,23-5,0,0,0,0,NaN,NaN
4,1.000,Cow,16-23,0,0,0,0,NaN,NaN
4,1.000,Cow,23-5,0,0,0,0,NaN,NaN
4,1.000,Deer Mouse,16-23,0,0,0,0,NaN,NaN
4,1.000,Deer Mouse,23-5,0,0,0,0,NaN,NaN
4,1.000,OVERALL,16-23,68,0,0,68,100.000,100.000
4,1.000,OVERALL,23-5,90,0,0,90,100.000,100.000
5,0.000,Chicken,16-23,5,24,0,29,17.241,17.241
5,0.000,Chicken,23-5,12,13,0,25,48.000,48.000
5,0.000,Sea Lion,16-23,0,0,0,0,NaN,NaN
5,0.000,Sea Lion,23-5,4,7,0,11,36.364,36.364
5,0.000,Hu and Cw,16-23,10,22,0,32,31.250,31.250
5,0.000,Hu and Cw,23-5,8,29,0,37,21.622,21.622
5,0.000,Sheep,16-23,60,59,0,119,50.420,50.420
5,0.000,Sheep,23-5,70,37,0,107,65.421,65.421
5,0.000,Hu and Dg,16-23,11,19,0,30,36.667,36.667
5,0.000,Hu and Dg,23-5,20,13,0,33,60.606,60.606
5,0.000,Common Loon,16-23,0,2,0,2,0.000,0.000
5,0.000,Common Loon,23-5,0,3,0,3,0.000,0.000
5,0.000,Red-Winged Blackbird,16-23,0,12,0,12,0.000,0.000
5,0.000,Red-Winged Blackbird,23-5,0,8,0,8,0.000,0.000
5,0.000,Cw,16-23,8,14,0,22,36.364,36.364
5,0.000,Cw,23-5,24,41,0,65,36.923,36.923
5,0.000,Cliff Sparrow,16-23,3,30,0,33,9.091,9.091
5,0.000,Cliff Sparrow,23-5,3,12,0,15,20.000,20.000
5,0.000,Pig,16-23,13,8,0,21,61.905,61.905
5,0.000,Pig,23-5,8,12,0,20,40.000,40.000
5,0.000,Barn Owl,16-23,0,0,0,0,NaN,NaN
5,0.000,Barn Owl,23-5,0,1,0,1,0.000,0.000
5,0.000,Wild Pig,16-23,8,5,0,13,61.538,61.538
5,0.000,Wild Pig,23-5,4,6,0,10,40.000,40.000
5,0.000,Pennington Creek Water,16-23,0,0,0,0,NaN,NaN
5,0.000,Pennington Creek Water,23-5,0,0,0,0,NaN,NaN
5,0.000,Guinni,16-23,0,0,0,0,NaN,NaN
5,0.000,Guinni,23-5,0,0,0,0,NaN,NaN
5,0.000,Racoon,16-23,0,3,0,3,0.000,0.000
5,0.000,Racoon,23-5,0,0,0,0,NaN,NaN
5,0.000,Hu,16-23,17,20,0,37,45.946,45.946
5,0.000,Hu,23-5,19,10,0,29,65.517,65.517
5,0.000,Cw and Dg,16-23,8,18,0,26,30.769,30.769
5,0.000,Cw and Dg,23-5,19,23,0,42,45.238,45.238
5,0.000,Red Wind Blackbird,16-23,0,0,0,0,NaN,NaN
5,0.000,Red Wind Blackbird,23-5,0,3,0,3,0.000,0.000
5,0.000,Tree Swallow,16-23,0,1,0,1,0.000,0.000
5,0.000,Tree Swallow,23-5,0,1,0,1,0.000,0.000
5,0.000,Turkey Vulture,16-23,0,0,0,0,NaN,NaN
5,0.000,Turkey Vulture,23-5,0,0,0,0,NaN,NaN
5,0.000,Dg,16-23,9,14,0,23,39.130,39.130
5,0.000,Dg,23-5,30,24,0,54,55.556,55.556
5,0.000,Western Kingbird,16-23,0,0,0,0,NaN,NaN
5,0.000,Western Kingbird,23-5,0,0,0,0,NaN,NaN
5,0.000,White Crowned Sparrow,16-23,3,11,0,14,21.429,21.429
5,0.000,White Crowned Sparrow,23-5,4,13,0,17,23.529,23.529
5,0.000,Eared Grebe,16-23,0,0,0,0,NaN,NaN
5,0.000,Eared Grebe,23-5,3,14,0,17,17.647,17.647
5,0.000,cougar,16-23,0,0,0,0,NaN,NaN
5,0.000,cougar,23-5,0,0,0,0,NaN,NaN
5,0.000,Ocean Water,16-23,0,0,0,0,NaN,NaN
5,0.000,Ocean Water,23-5,0,0,0,0,NaN,NaN
5,0.000,Red Tailed Hawk,16-23,0,2,0,2,0.000,0.000
5,0.000,Red Tailed Hawk,23-5,0,11,0,11,0.000,0.000
5,0.000,Dog,16-23,79,87,0,166,47.590,47.590
5,0.000,Dog,23-5,128,146,0,274,46.715,46.715
5,0.000,Human,16-23,1756,585,0,2341,75.011,75.011
5,0.000,Human,23-5,2217,462,0,2679,82.755,82.755
5,0.000,Wild Turkey,16-23,12,23,0,35,34.286,34.286
5,0.000,Wild Turkey,23-5,4,31,0,35,11.429,11.429
5,0.000,Clark Grebe,16-23,0,0,0,0,NaN,NaN
5,0.000,Clark Grebe,23-5,0,2,0,2,0.000,0.000
5,0.000,Seagull,16-23,0,0,0,0,NaN,NaN
5,0.000,Seagull,23-5,46,6,0,52,88.462,88.462
5,0.000,Surf Scoter,16-23,0,0,0,0,NaN,NaN
5,0.000,Surf Scoter,23-5,0,6,0,6,0.000,0.000
5,0.000,Pigeon,16-23,126,192,0,318,39.623,39.623
5,0.000,Pigeon,23-5,150,275,0,425,35.294,35.294
5,0.000,Pacific Ocean Water,16-23,0,0,0,0,NaN,NaN
5,0.000,Pacific Ocean Water,23-5,0,0,0,0,NaN,NaN
5,0.000,Cat,16-23,29,43,0,72,40.278,40.278
5,0.000,Cat,23-5,37,39,0,76,48.684,48.684
5,0.000,Horse,16-23,13,33,0,46,28.261,28.261
5,0.000,Horse,23-5,34,208,0,242,14.050,14.050
5,0.000,orangutan,16-23,0,0,0,0,NaN,NaN
5,0.000,orangutan,23-5,0,0,0,0,NaN,NaN
5,0.000,Bat,16-23,36,17,0,53,67.925,67.925
5,0.000,Bat,23-5,37,21,0,58,63.793,63.793
5,0.000,Deer,16-23,16,19,0,35,45.714,45.714
5,0.000,Deer,23-5,18,83,0,101,17.822,17.822
5,0.000,Great Horned Owl,16-23,0,0,0,0,NaN,NaN
5,0.000,Great Horned Owl,23-5,0,8,0,8,0.000,0.000
5,0.000,Freshwater Lagoon,16-23,0,0,0,0,NaN,NaN
5,0.000,Freshwater Lagoon,23-5,0,0,0,0,NaN,NaN
5,0.000,Unknown Avian,16-23,0,0,0,0,NaN,NaN
5,0.000,Unknown Avian,23-5,0,0,0,0,NaN,NaN
5,0.000,Human UTI,16-23,89,78,0,167,53.293,53.293
5,0.000,Human UTI,23-5,111,103,0,214,51.869,51.869
5,0.000,unknown,16-23,0,6,0,6,0.000,0.000
5,0.000,unknown,23-5,3,8,0,11,27.273,27.273
5,0.000,SLO Creek Water,16-23,0,0,0,0,NaN,NaN
5,0.000,SLO Creek Water,23-5,0,0,0,0,NaN,NaN
5,0.000,Pig/Swine,16-23,13,12,0,25,52.000,52.000
5,0.000,Pig/Swine,23-5,13,10,0,23,56.522,56.522
5,0.000,Klebsiella,16-23,0,0,0,0,NaN,NaN
5,0.000,Klebsiella,23-5,0,0,0,0,NaN,NaN
5,0.000,Hu Cw and Dg,16-23,11,24,0,35,31.429,31.429
5,0.000,Hu Cw and Dg,23-5,21,29,0,50,42.000,42.000
5,0.000,Ground Squirrel,16-23,104,72,0,176,59.091,59.091
5,0.000,Ground Squirrel,23-5,89,84,0,173,51.445,51.445
5,0.000,Opossum,16-23,0,2,0,2,0.000,0.000
5,0.000,Opossum,23-5,0,9,0,9,0.000,0.000
5,0.000,Cow,16-23,1525,927,0,2452,62.194,62.194
5,0.000,Cow,23-5,1493,1170,0,2663,56.065,56.065
5,0.000,Deer Mouse,16-23,0,0,0,0,NaN,NaN
5,0.000,Deer Mouse,23-5,0,0,0,0,NaN,NaN
5,0.000,OVERALL,16-23,3964,2384,0,6348,62.445,62.445
5,0.000,OVERALL,23-5,4629,2981,0,7610,60.828,60.828
5,0.500,Chicken,16-23,5,24,0,29,17.241,17.241
5,0.500,Chicken,23-5,12,13,0,25,48.000,48.000
5,0.500,Sea Lion,16-23,0,0,0,0,NaN,NaN
5,0.500,Sea Lion,23-5,4,7,0,11,36.364,36.364
5,0.500,Hu and Cw,16-23,10,22,0,32,31.250,31.250
5,0.500,Hu and Cw,23-5,8,29,0,37,21.622,21.622
5,0.500,Sheep,16-23,60,59,0,119,50.420,50.420
5,0.500,Sheep,23-5,70,37,0,107,65.421,65.421
5,0.500,Hu and Dg,16-23,11,19,0,30,36.667,36.667
5,0.500,Hu and Dg,23-5,20,13,0,33,60.606,60.606
5,0.500,Common Loon,16-23,0,2,0,2,0.000,0.000
5,0.500,Common Loon,23-5,0,3,0,3,0.000,0.000
5,0.500,Red-Winged Blackbird,16-23,0,12,0,12,0.000,0.000
5,0.500,Red-Winged Blackbird,23-5,0,8,0,8,0.000,0.000
5,0.500,Cw,16-23,8,14,0,22,36.364,36.364
5,0.500,Cw,23-5,24,41,0,65,36.923,36.923
5,0.500,Cliff Sparrow,16-23,3,30,0,33,9.091,9.091
5,0.500,Cliff Sparrow,23-5,3,12,0,15,20.000,20.000
5,0.500,Pig,16-23,13,8,0,21,61.905,61.905
5,0.500,Pig,23-5,8,12,0,20,40.000,40.000
5,0.500,Barn Owl,16-23,0,0,0,0,NaN,NaN
5,0.500,Barn Owl,23-5,0,1,0,1,0.000,0.000
5,0.500,Wild Pig,16-23,8,5,0,13,61.538,61.538
5,0.500,Wild Pig,23-5,4,6,0,10,40.000,40.000
5,0.500,Pennington Creek Water,16-23,0,0,0,0,NaN,NaN
5,0.500,Pennington Creek Water,23-5,0,0,0,0,NaN,NaN
5,0.500,Guinni,16-23,0,0,0,0,NaN,NaN
5,0.500,Guinni,23-5,0,0,0,0,NaN,NaN
5,0.500,Racoon,16-23,0,3,0,3,0.000,0.000
5,0.500,Racoon,23-5,0,0,0,0,NaN,NaN
5,0.500,Hu,16-23,17,20,0,37,45.946,45.946
5,0.500,Hu,23-5,19,10,0,29,65.517,65.517
5,0.500,Cw and Dg,16-23,8,18,0,26,30.769,30.769
5,0.500,Cw and Dg,23-5,19,23,0,42,45.238,45.238
5,0.500,Red Wind Blackbird,16-23,0,0,0,0,NaN,NaN
5,0.500,Red Wind Blackbird,23-5,0,3,0,3,0.000,0.000
5,0.500,Tree Swallow,16-23,0,1,0,1,0.000,0.000
5,0.500,Tree Swallow,23-5,0,1,0,1,0.000,0.000
5,0.500,Turkey Vulture,16-23,0,0,0,0,NaN,NaN
5,0.500,Turkey Vulture,23-5,0,0,0,0,NaN,NaN
5,0.500,Dg,16-23,9,14,0,23,39.130,39.130
5,0.500,Dg,23-5,30,24,0,54,55.556,55.556
5,0.500,Western Kingbird,16-23,0,0,0,0,NaN,NaN
5,0.500,Western Kingbird,23-5,0,0,0,0,NaN,NaN
5,0.500,White Crowned Sparrow,16-23,3,11,0,14,21.429,21.429
5,0.500,White Crowned Sparrow,23-5,4,13,0,17,23.529,23.529
5,0.500,Eared Grebe,16-23,0,0,0,0,NaN,NaN
5,0.500,Eared Grebe,23-5,3,14,0,17,17.647,17.647
5,0.500,cougar,16-23,0,0,0,0,NaN,NaN
5,0.500,cougar,23-5,0,0,0,0,NaN,NaN
5,0.500,Ocean Water,16-23,0,0,0,0,NaN,NaN
5,0.500,Ocean Water,23-5,0,0,0,0,NaN,NaN
5,0.500,Red Tailed Hawk,16-23,0,2,0,2,0.000,0.000
5,0.500,Red Tailed Hawk,23-5,0,11,0,11,0.000,0.000
5,0.500,Dog,16-23,79,87,0,166,47.590,47.590
5,0.500,Dog,23-5,128,146,0,274,46.715,46.715
5,0.500,Human,16-23,1756,585,0,2341,75.011,75.011
5,0.500,Human,23-5,2217,462,0,2679,82.755,82.755
5,0.500,Wild Turkey,16-23,12,23,0,35,34.286,34.286
5,0.500,Wild Turkey,23-5,4,31,0,35,11.429,11.429
5,0.500,Clark Grebe,16-23,0,0,0,0,NaN,NaN
5,0.500,Clark Grebe,23-5,0,2,0,2,0.000,0.000
5,0.500,Seagull,16-23,0,0,0,0,NaN,NaN
5,0.500,Seagull,23-5,46,6,0,52,88.462,88.462
5,0.500,Surf Scoter,16-23,0,0,0,0,NaN,NaN
5,0.500,Surf Scoter,23-5,0,6,0,6,0.000,0.000
5,0.500,Pigeon,16-23,126,192,0,318,39.623,39.623
5,0.500,Pigeon,23-5,150,275,0,425,35.294,35.294
5,0.500,Pacific Ocean Water,16-23,0,0,0,0,NaN,NaN
5,0.500,Pacific Ocean Water,23-5,0,0,0,0,NaN,NaN
5,0.500,Cat,16-23,29,43,0,72,40.278,40.278
5,0.500,Cat,23-5,37,39,0,76,48.684,48.684
5,0.500,Horse,16-23,13,33,0,46,28.261,28.261
5,0.500,Horse,23-5,34,208,0,242,14.050,14.050
5,0.500,orangutan,16-23,0,0,0,0,NaN,NaN
5,0.500,orangutan,23-5,0,0,0,0,NaN,NaN
5,0.500,Bat,16-23,36,17,0,53,67.925,67.925
5,0.500,Bat,23-5,37,21,0,58,63.793,63.793
5,0.500,Deer,16-23,16,19,0,35,45.714,45.714
5,0.500,Deer,23-5,18,83,0,101,17.822,17.822
5,0.500,Great Horned Owl,16-23,0,0,0,0,NaN,NaN
5,0.500,Great Horned Owl,23-5,0,8,0,8,0.000,0.000
5,0.500,Freshwater Lagoon,16-23,0,0,0,0,NaN,NaN
5,0.500,Freshwater Lagoon,23-5,0,0,0,0,NaN,NaN
5,0.500,Unknown Avian,16-23,0,0,0,0,NaN,NaN
5,0.500,Unknown Avian,23-5,0,0,0,0,NaN,NaN
5,0.500,Human UTI,16-23,89,78,0,167,53.293,53.293
5,0.500,Human UTI,23-5,111,103,0,214,51.869,51.869
5,0.500,unknown,16-23,0,6,0,6,0.000,0.000
5,0.500,unknown,23-5,3,8,0,11,27.273,27.273
5,0.500,SLO Creek Water,16-23,0,0,0,0,NaN,NaN
5,0.500,SLO Creek Water,23-5,0,0,0,0,NaN,NaN
5,0.500,Pig/Swine,16-23,13,12,0,25,52.000,52.000
5,0.500,Pig/Swine,23-5,13,10,0,23,56.522,56.522
5,0.500,Klebsiella,16-23,0,0,0,0,NaN,NaN
5,0.500,Klebsiella,23-5,0,0,0,0,NaN,NaN
5,0.500,Hu Cw and Dg,16-23,11,24,0,35,31.429,31.429
5,0.500,Hu Cw and Dg,23-5,21,29,0,50,42.000,42.000
5,0.500,Ground Squirrel,16-23,104,72,0,176,59.091,59.091
5,0.500,Ground Squirrel,23-5,89,84,0,173,51.445,51.445
5,0.500,Opossum,16-23,0,2,0,2,0.000,0.000
5,0.500,Opossum,23-5,0,9,0,9,0.000,0.000
5,0.500,Cow,16-23,1525,927,0,2452,62.194,62.194
5,0.500,Cow,23-5,1493,1170,0,2663,56.065,56.065
5,0.500,Deer Mouse,16-23,0,0,0,0,NaN,NaN
5,0.500,Deer Mouse,23-5,0,0,0,0,NaN,NaN
5,0.500,OVERALL,16-23,3964,2384,0,6348,62.445,62.445
5,0.500,OVERALL,23-5,4629,2981,0,7610,60.828,60.828
5,0.900,Chicken,16-23,5,24,0,29,17.241,17.241
5,0.900,Chicken,23-5,12,13,0,25,48.000,48.000
5,0.900,Sea Lion,16-23,0,0,0,0,NaN,NaN
5,0.900,Sea Lion,23-5,4,7,0,11,36.364,36.364
5,0.900,Hu and Cw,16-23,10,22,0,32,31.250,31.250
5,0.900,Hu and Cw,23-5,8,29,0,37,21.622,21.622
5,0.900,Sheep,16-23,60,59,0,119,50.420,50.420
5,0.900,Sheep,23-5,70,37,0,107,65.421,65.421
5,0.900,Hu and Dg,16-23,11,19,0,30,36.667,36.667
5,0.900,Hu and Dg,23-5,20,13,0,33,60.606,60.606
5,0.900,Common Loon,16-23,0,2,0,2,0.000,0.000
5,0.900,Common Loon,23-5,0,3,0,3,0.000,0.000
5,0.900,Red-Winged Blackbird,16-23,0,12,0,12,0.000,0.000
5,0.900,Red-Winged Blackbird,23-5,0,8,0,8,0.000,0.000
5,0.900,Cw,16-23,8,14,0,22,36.364,36.364
5,0.900,Cw,23-5,24,41,0,65,36.923,36.923
5,0.900,Cliff Sparrow,16-23,3,30,0,33,9.091,9.091
5,0.900,Cliff Sparrow,23-5,3,12,0,15,20.000,20.000
5,0.900,Pig,16-23,13,8,0,21,61.905,61.905
5,0.900,Pig,23-5,8,12,0,20,40.000,40.000
5,0.900,Barn Owl,16-23,0,0,0,0,NaN,NaN
5,0.900,Barn Owl,23-5,0,1,0,1,0.000,0.000
5,0.900,Wild Pig,16-23,8,5,0,13,61.538,61.538
5,0.900,Wild Pig,23-5,4,6,0,10,40.000,40.000
5,0.900,Pennington Creek Water,16-23,0,0,0,0,NaN,NaN
5,0.900,Pennington Creek Water,23-5,0,0,0,0,NaN,NaN
5,0.900,Guinni,16-23,0,0,0,0,NaN,NaN
5,0.900,Guinni,23-5,0,0,0,0,NaN,NaN
5,0.900,Racoon,16-23,0,3,0,3,0.000,0.000
5,0.900,Racoon,23-5,0,0,0,0,NaN,NaN
5,0.900,Hu,16-23,17,20,0,37,45.946,45.946
5,0.900,Hu,23-5,19,10,0,29,65.517,65.517
5,0.900,Cw and Dg,16-23,8,18,0,26,30.769,30.769
5,0.900,Cw and Dg,23-5,19,23,0,42,45.238,45.238
5,0.900,Red Wind Blackbird,16-23,0,0,0,0,NaN,NaN
5,0.900,Red Wind Blackbird,23-5,0,3,0,3,0.000,0.000
5,0.900,Tree Swallow,16-23,0,1,0,1,0.000,0.000
5,0.900,Tree Swallow,23-5,0,1,0,1,0.000,0.000
5,0.900,Turkey Vulture,16-23,0,0,0,0,NaN,NaN
5,0.900,Turkey Vulture,23-5,0,0,0,0,NaN,NaN
5,0.900,Dg,16-23,9,14,0,23,39.130,39.130
5,0.900,Dg,23-5,30,24,0,54,55.556,55.556
5,0.900,Western Kingbird,16-23,0,0,0,0,NaN,NaN
5,0.900,Western Kingbird,23-5,0,0,0,0,NaN,NaN
5,0.900,White Crowned Sparrow,16-23,3,11,0,14,21.429,21.429
5,0.900,White Crowned Sparrow,23-5,4,13,0,17,23.529,23.529
5,0.900,Eared Grebe,16-23,0,0,0,0,NaN,NaN
5,0.900,Eared Grebe,23-5,3,14,0,17,17.647,17.647
5,0.900,cougar,16-23,0,0,0,0,NaN,NaN
5,0.900,cougar,23-5,0,0,0,0,NaN,NaN
5,0.900,Ocean Water,16-23,0,0,0,0,NaN,NaN
5,0.900,Ocean Water,23-5,0,0,0,0,NaN,NaN
5,0.900,Red Tailed Hawk,16-23,0,2,0,2,0.000,0.000
5,0.900,Red Tailed Hawk,23-5,0,11,0,11,0.000,0.000
5,0.900,Dog,16-23,79,87,0,166,47.590,47.590
5,0.900,Dog,23-5,128,144,0,272,47.059,47.059
5,0.900,Human,16-23,1756,581,0,2337,75.139,75.139
5,0.900,Human,23-5,2217,458,0,2675,82.879,82.879
5,0.900,Wild Turkey,16-23,12,23,0,35,34.286,34.286
5,0.900,Wild Turkey,23-5,4,31,0,35,11.429,11.429
5,0.900,Clark Grebe,16-23,0,0,0,0,NaN,NaN
5,0.900,Clark Grebe,23-5,0,2,0,2,0.000,0.000
5,0.900,Seagull,16-23,0,0,0,0,NaN,NaN
5,0.900,Seagull,23-5,46,7,0,53,86.792,86.792
5,0.900,Surf Scoter,16-23,0,0,0,0,NaN,NaN
5,0.900,Surf Scoter,23-5,0,5,0,5,0.000,0.000
5,0.900,Pigeon,16-23,126,192,0,318,39.623,39.623
5,0.900,Pigeon,23-5,150,275,0,425,35.294,35.294
5,0.900,Pacific Ocean Water,16-23,0,0,0,0,NaN,NaN
5,0.900,Pacific Ocean Water,23-5,0,0,0,0,NaN,NaN
5,0.900,Cat,16-23,29,43,0,72,40.278,40.278
5,0.900,Cat,23-5,37,39,0,76,48.684,48.684
5,0.900,Horse,16-23,13,33,0,46,28.261,28.261
5,0.900,Horse,23-5,34,208,0,242,14.050,14.050
5,0.900,orangutan,16-23,0,0,0,0,NaN,NaN
5,0.900,orangutan,23-5,0,0,0,0,NaN,NaN
5,0.900,Bat,16-23,36,17,0,53,67.925,67.925
5,0.900,Bat,23-5,37,21,0,58,63.793,63.793
5,0.900,Deer,16-23,16,19,0,35,45.714,45.714
5,0.900,Deer,23-5,18,83,0,101,17.822,17.822
5,0.900,Great Horned Owl,16-23,0,0,0,0,NaN,NaN
5,0.900,Great Horned Owl,23-5,0,8,0,8,0.000,0.000
5,0.900,Freshwater Lagoon,16-23,0,0,0,0,NaN,NaN
5,0.900,Freshwater Lagoon,23-5,0,0,0,0,NaN,NaN
5,0.900,Unknown Avian,16-23,0,0,0,0,NaN,NaN
5,0.900,Unknown Avian,23-5,0,0,0,0,NaN,NaN
5,0.900,Human UTI,16-23,89,78,0,167,53.293,53.293
5,0.900,Human UTI,23-5,111,103,0,214,51.869,51.869
5,0.900,unknown,16-23,0,6,0,6,0.000,0.000
5,0.900,unknown,23-5,3,8,0,11,27.273,27.273
5,0.900,SLO Creek Water,16-23,0,0,0,0,NaN,NaN
5,0.900,SLO Creek Water,23-5,0,0,0,0,NaN,NaN
5,0.900,Pig/Swine,16-23,13,12,0,25,52.000,52.000
5,0.900,Pig/Swine,23-5,13,10,0,23,56.522,56.522
5,0.900,Klebsiella,16-23,0,0,0,0,NaN,NaN
5,0.900,Klebsiella,23-5,0,0,0,0,NaN,NaN
5,0.900,Hu Cw and Dg,16-23,11,24,0,35,31.429,31.429
5,0.900,Hu Cw and Dg,23-5,21,29,0,50,42.000,42.000
5,0.900,Ground Squirrel,16-23,104,72,0,176,59.091,59.091
5,0.900,Ground Squirrel,23-5,89,84,0,173,51.445,51.445
5,0.900,Opossum,16-23,0,2,0,2,0.000,0.000
5,0.900,Opossum,23-5,0,9,0,9,0.000,0.000
5,0.900,Cow,16-23,1525,927,0,2452,62.194,62.194
5,0.900,Cow,23-5,1493,1168,0,2661,56.107,56.107
5,0.900,Deer Mouse,16-23,0,0,0,0,NaN,NaN
5,0.900,Deer Mouse,23-5,0,0,0,0,NaN,NaN
5,0.900,OVERALL,16-23,3964,2380,0,6344,62.484,62.484
5,0.900,OVERALL,23-5,4629,2973,0,7602,60.892,60.892
5,0.950,Chicken,16-23,5,24,0,29,17.241,17.241
5,0.950,Chicken,23-5,12,13,0,25,48.000,48.000
5,0.950,Sea Lion,16-23,0,0,0,0,NaN,NaN
5,0.950,Sea Lion,23-5,4,7,0,11,36.364,36.364
5,0.950,Hu and Cw,16-23,10,22,0,32,31.250,31.250
5,0.950,Hu and Cw,23-5,8,29,0,37,21.622,21.622
5,0.950,Sheep,16-23,60,59,0,119,50.420,50.420
5,0.950,Sheep,23-5,70,37,0,107,65.421,65.421
5,0.950,Hu and Dg,16-23,11,19,0,30,36.667,36.667
5,0.950,Hu and Dg,23-5,20,13,0,33,60.606,60.606
5,0.950,Common Loon,16-23,0,2,0,2,0.000,0.000
5,0.950,Common Loon,23-5,0,3,0,3,0.000,0.000
5,0.950,Red-Winged Blackbird,16-23,0,12,0,12,0.000,0.000
5,0.950,Red-Winged Blackbird,23-5,0,8,0,8,0.000,0.000
5,0.950,Cw,16-23,8,14,0,22,36.364,36.364
5,0.950,Cw,23-5,24,41,0,65,36.923,36.923
5,0.950,Cliff Sparrow,16-23,3,30,0,33,9.091,9.091
5,0.950,Cliff Sparrow,23-5,3,12,0,15,20.000,20.000
5,0.950,Pig,16-23,13,8,0,21,61.905,61.905
5,0.950,Pig,23-5,8,12,0,20,40.000,40.000
5,0.950,Barn Owl,16-23,0,0,0,0,NaN,NaN
5,0.950,Barn Owl,23-5,0,1,0,1,0.000,0.000
5,0.950,Wild Pig,16-23,8,5,0,13,61.538,61.538
5,0.950,Wild Pig,23-5,4,5,0,9,44.444,44.444
5,0.950,Pennington Creek Water,16-23,0,0,0,0,NaN,NaN
5,0.950,Pennington Creek Water,23-5,0,0,0,0,NaN,NaN
5,0.950,Guinni,16-23,0,0,0,0,NaN,NaN
5,0.950,Guinni,23-5,0,0,0,0,NaN,NaN
5,0.950,Racoon,16-23,0,3,0,3,0.000,0.000
5,0.950,Racoon,23-5,0,0,0,0,NaN,NaN
5,0.950,Hu,16-23,17,20,0,37,45.946,45.946
5,0.950,Hu,23-5,19,10,0,29,65.517,65.517
5,0.950,Cw and Dg,16-23,8,18,0,26,30.769,30.769
5,0.950,Cw and Dg,23-5,19,23,0,42,45.238,45.238
5,0.950,Red Wind Blackbird,16-23,0,0,0,0,NaN,NaN
5,0.950,Red Wind Blackbird,23-5,0,3,0,3,0.000,0.000
5,0.950,Tree Swallow,16-23,0,1,0,1,0.000,0.000
5,0.950,Tree Swallow,23-5,0,1,0,1,0.000,0.000
5,0.950,Turkey Vulture,16-23,0,0,0,0,NaN,NaN
5,0.950,Turkey Vulture,23-5,0,0,0,0,NaN,NaN
5,0.950,Dg,16-23,9,14,0,23,39.130,39.130
5,0.950,Dg,23-5,30,24,0,54,55.556,55.556
5,0.950,Western Kingbird,16-23,0,0,0,0,NaN,NaN
5,0.950,Western Kingbird,23-5,0,0,0,0,NaN,NaN
5,0.950,White Crowned Sparrow,16-23,3,11,0,14,21.429,21.429
5,0.950,White Crowned Sparrow,23-5,4,13,0,17,23.529,23.529
5,0.950,Eared Grebe,16-23,0,0,0,0,NaN,NaN
5,0.950,Eared Grebe,23-5,3,14,0,17,17.647,17.647
5,0.950,cougar,16-23,0,0,0,0,NaN,NaN
5,0.950,cougar,23-5,0,0,0,0,NaN,NaN
5,0.950,Ocean Water,16-23,0,0,0,0,NaN,NaN
5,0.950,Ocean Water,23-5,0,0,0,0,NaN,NaN
5,0.950,Red Tailed Hawk,16-23,0,2,0,2,0.000,0.000
5,0.950,Red Tailed Hawk,23-5,0,11,0,11,0.000,0.000
5,0.950,Dog,16-23,79,87,0,166,47.590,47.590
5,0.950,Dog,23-5,128,144,0,272,47.059,47.059
5,0.950,Human,16-23,1756,581,0,2337,75.139,75.139
5,0.950,Human,23-5,2219,452,0,2671,83.077,83.077
5,0.950,Wild Turkey,16-23,12,23,0,35,34.286,34.286
5,0.950,Wild Turkey,23-5,4,31,0,35,11.429,11.429
5,0.950,Clark Grebe,16-23,0,0,0,0,NaN,NaN
5,0.950,Clark Grebe,23-5,0,2,0,2,0.000,0.000
5,0.950,Seagull,16-23,0,0,0,0,NaN,NaN
5,0.950,Seagull,23-5,46,6,0,52,88.462,88.462
5,0.950,Surf Scoter,16-23,0,0,0,0,NaN,NaN
5,0.950,Surf Scoter,23-5,0,3,0,3,0.000,0.000
5,0.950,Pigeon,16-23,126,192,0,318,39.623,39.623
5,0.950,Pigeon,23-5,150,276,0,426,35.211,35.211
5,0.950,Pacific Ocean Water,16-23,0,0,0,0,NaN,NaN
5,0.950,Pacific Ocean Water,23-5,0,0,0,0,NaN,NaN
5,0.950,Cat,16-23,29,43,0,72,40.278,40.278
5,0.950,Cat,23-5,37,39,0,76,48.684,48.684
5,0.950,Horse,16-23,13,33,0,46,28.261,28.261
5,0.950,Horse,23-5,34,208,0,242,14.050,14.050
5,0.950,orangutan,16-23,0,0,0,0,NaN,NaN
5,0.950,orangutan,23-5,0,0,0,0,NaN,NaN
5,0.950,Bat,16-23,36,17,0,53,67.925,67.925
5,0.950,Bat,23-5,37,20,0,57,64.912,64.912
5,0.950,Deer,16-23,16,19,0,35,45.714,45.714
5,0.950,Deer,23-5,18,83,0,101,17.822,17.822
5,0.950,Great Horned Owl,16-23,0,0,0,0,NaN,NaN
5,0.950,Great Horned Owl,23-5,0,8,0,8,0.000,0.000
5,0.950,Freshwater Lagoon,16-23,0,0,0,0,NaN,NaN
5,0.950,Freshwater Lagoon,23-5,0,0,0,0,NaN,NaN
5,0.950,Unknown Avian,16-23,0,0,0,0,NaN,NaN
5,0.950,Unknown Avian,23-5,0,0,0,0,NaN,NaN
5,0.950,Human UTI,16-23,90,78,0,168,53.571,53.571
5,0.950,Human UTI,23-5,110,102,0,212,51.887,51.887
5,0.950,unknown,16-23,0,6,0,6,0.000,0.000
5,0.950,unknown,23-5,3,8,0,11,27.273,27.273
5,0.950,SLO Creek Water,16-23,0,0,0,0,NaN,NaN
5,0.950,SLO Creek Water,23-5,0,0,0,0,NaN,NaN
5,0.950,Pig/Swine,16-23,13,12,0,25,52.000,52.000
5,0.950,Pig/Swine,23-5,13,10,0,23,56.522,56.522
5,0.950,Klebsiella,16-23,0,0,0,0,NaN,NaN
5,0.950,Klebsiella,23-5,0,0,0,0,NaN,NaN
5,0.950,Hu Cw and Dg,16-23,11,24,0,35,31.429,31.429
5,0.950,Hu Cw and Dg,23-5,21,29,0,50,42.000,42.000
5,0.950,Ground Squirrel,16-23,104,72,0,176,59.091,59.091
5,0.950,Ground Squirrel,23-5,89,83,0,172,51.744,51.744
5,0.950,Opossum,16-23,0,2,0,2,0.000,0.000
5,0.950,Opossum,23-5,0,9,0,9,0.000,0.000
5,0.950,Cow,16-23,1525,909,0,2434,62.654,62.654
5,0.950,Cow,23-5,1492,1168,0,2660,56.090,56.090
5,0.950,Deer Mouse,16-23,0,0,0,0,NaN,NaN
5,0.950,Deer Mouse,23-5,0,0,0,0,NaN,NaN
5,0.950,OVERALL,16-23,3965,2362,0,6327,62.668,62.668
5,0.950,OVERALL,23-5,4629,2961,0,7590,60.988,60.988
5,0.960,Chicken,16-23,5,24,0,29,17.241,17.241
5,0.960,Chicken,23-5,12,13,0,25,48.000,48.000
5,0.960,Sea Lion,16-23,0,0,0,0,NaN,NaN
5,0.960,Sea Lion,23-5,4,7,0,11,36.364,36.364
5,0.960,Hu and Cw,16-23,10,22,0,32,31.250,31.250
5,0.960,Hu and Cw,23-5,8,29,0,37,21.622,21.622
5,0.960,Sheep,16-23,60,59,0,119,50.420,50.420
5,0.960,Sheep,23-5,70,38,0,108,64.815,64.815
5,0.960,Hu and Dg,16-23,11,19,0,30,36.667,36.667
5,0.960,Hu and Dg,23-5,20,13,0,33,60.606,60.606
5,0.960,Common Loon,16-23,0,2,0,2,0.000,0.000
5,0.960,Common Loon,23-5,0,3,0,3,0.000,0.000
5,0.960,Red-Winged Blackbird,16-23,0,12,0,12,0.000,0.000
5,0.960,Red-Winged Blackbird,23-5,0,8,0,8,0.000,0.000
5,0.960,Cw,16-23,8,14,0,22,36.364,36.364
5,0.960,Cw,23-5,24,41,0,65,36.923,36.923
5,0.960,Cliff Sparrow,16-23,3,30,0,33,9.091,9.091
5,0.960,Cliff Sparrow,23-5,3,12,0,15,20.000,20.000
5,0.960,Pig,16-23,13,8,0,21,61.905,61.905
5,0.960,Pig,23-5,8,12,0,20,40.000,40.000
5,0.960,Barn Owl,16-23,0,0,0,0,NaN,NaN
5,0.960,Barn Owl,23-5,0,1,0,1,0.000,0.000
5,0.960,Wild Pig,16-23,8,5,0,13,61.538,61.538
5,0.960,Wild Pig,23-5,5,5,0,10,50.000,50.000
5,0.960,Pennington Creek Water,16-23,0,0,0,0,NaN,NaN
5,0.960,Pennington Creek Water,23-5,0,0,0,0,NaN,NaN
5,0.960,Guinni,16-23,0,0,0,0,NaN,NaN
5,0.960,Guinni,23-5,0,0,0,0,NaN,NaN
5,0.960,Racoon,16-23,0,3,0,3,0.000,0.000
5,0.960,Racoon,23-5,0,0,0,0,NaN,NaN
5,0.960,Hu,16-23,17,20,0,37,45.946,45.946
5,0.960,Hu,23-5,19,10,0,29,65.517,65.517
5,0.960,Cw and Dg,16-23,8,18,0,26,30.769,30.769
5,0.960,Cw and Dg,23-5,19,23,0,42,45.238,45.238
5,0.960,Red Wind Blackbird,16-23,0,0,0,0,NaN,NaN
5,0.960,Red Wind Blackbird,23-5,0,3,0,3,0.000,0.000
5,0.960,Tree Swallow,16-23,0,1,0,1,0.000,0.000
5,0.960,Tree Swallow,23-5,0,1,0,1,0.000,0.000
5,0.960,Turkey Vulture,16-23,0,0,0,0,NaN,NaN
5,0.960,Turkey Vulture,23-5,0,0,0,0,NaN,NaN
5,0.960,Dg,16-23,9,14,0,23,39.130,39.130
5,0.960,Dg,23-5,30,24,0,54,55.556,55.556
5,0.960,Western Kingbird,16-23,0,0,0,0,NaN,NaN
5,0.960,Western Kingbird,23-5,0,0,0,0,NaN,NaN
5,0.960,White Crowned Sparrow,16-23,3,11,0,14,21.429,21.429
5,0.960,White Crowned Sparrow,23-5,4,13,0,17,23.529,23.529
5,0.960,Eared Grebe,16-23,0,0,0,0,NaN,NaN
5,0.960,Eared Grebe,23-5,3,14,0,17,17.647,17.647
5,0.960,cougar,16-23,0,0,0,0,NaN,NaN
5,0.960,cougar,23-5,0,0,0,0,NaN,NaN
5,0.960,Ocean Water,16-23,0,0,0,0,NaN,NaN
5,0.960,Ocean Water,23-5,0,0,0,0,NaN,NaN
5,0.960,Red Tailed Hawk,16-23,0,2,0,2,0.000,0.000
5,0.960,Red Tailed Hawk,23-5,0,11,0,11,0.000,0.000
5,0.960,Dog,16-23,79,87,0,166,47.590,47.590
5,0.960,Dog,23-5,128,142,0,270,47.407,47.407
5,0.960,Human,16-23,1756,580,0,2336,75.171,75.171
5,0.960,Human,23-5,2219,440,0,2659,83.452,83.452
5,0.960,Wild Turkey,16-23,12,23,0,35,34.286,34.286
5,0.960,Wild Turkey,23-5,4,33,0,37,10.811,10.811
5,0.960,Clark Grebe,16-23,0,0,0,0,NaN,NaN
5,0.960,Clark Grebe,23-5,0,2,0,2,0.000,0.000
5,0.960,Seagull,16-23,0,0,0,0,NaN,NaN
5,0.960,Seagull,23-5,46,6,0,52,88.462,88.462
5,0.960,Surf Scoter,16-23,0,0,0,0,NaN,NaN
5,0.960,Surf Scoter,23-5,0,2,0,2,0.000,0.000
5,0.960,Pigeon,16-23,125,192,0,317,39.432,39.432
5,0.960,Pigeon,23-5,151,290,0,441,34.240,34.240
5,0.960,Pacific Ocean Water,16-23,0,0,0,0,NaN,NaN
5,0.960,Pacific Ocean Water,23-5,0,0,0,0,NaN,NaN
5,0.960,Cat,16-23,29,43,0,72,40.278,40.278
5,0.960,Cat,23-5,37,39,0,76,48.684,48.684
5,0.960,Horse,16-23,13,33,0,46,28.261,28.261
5,0.960,Horse,23-5,34,208,0,242,14.050,14.050
5,0.960,orangutan,16-23,0,0,0,0,NaN,NaN
5,0.960,orangutan,23-5,0,0,0,0,NaN,NaN
5,0.960,Bat,16-23,36,17,0,53,67.925,67.925
5,0.960,Bat,23-5,37,20,0,57,64.912,64.912
5,0.960,Deer,16-23,16,19,0,35,45.714,45.714
5,0.960,Deer,23-5,18,83,0,101,17.822,17.822
5,0.960,Great Horned Owl,16-23,0,0,0,0,NaN,NaN
5,0.960,Great Horned Owl,23-5,0,8,0,8,0.000,0.000
5,0.960,Freshwater Lagoon,16-23,0,0,0,0,NaN,NaN
5,0.960,Freshwater Lagoon,23-5,0,0,0,0,NaN,NaN
5,0.960,Unknown Avian,16-23,0,0,0,0,NaN,NaN
5,0.960,Unknown Avian,23-5,0,0,0,0,NaN,NaN
5,0.960,Human UTI,16-23,90,78,0,168,53.571,53.571
5,0.960,Human UTI,23-5,110,101,0,211,52.133,52.133
5,0.960,unknown,16-23,0,6,0,6,0.000,0.000
5,0.960,unknown,23-5,3,8,0,11,27.273,27.273
5,0.960,SLO Creek Water,16-23,0,0,0,0,NaN,NaN
5,0.960,SLO Creek Water,23-5,0,0,0,0,NaN,NaN
5,0.960,Pig/Swine,16-23,13,12,0,25,52.000,52.000
5,0.960,Pig/Swine,23-5,13,10,0,23,56.522,56.522
5,0.960,Klebsiella,16-23,0,0,0,0,NaN,NaN
5,0.960,Klebsiella,23-5,0,0,0,0,NaN,NaN
5,0.960,Hu Cw and Dg,16-23,11,24,0,35,31.429,31.429
5,0.960,Hu Cw and Dg,23-5,21,29,0,50,42.000,42.000
5,0.960,Ground Squirrel,16-23,104,72,0,176,59.091,59.091
5,0.960,Ground Squirrel,23-5,89,84,0,173,51.445,51.445
5,0.960,Opossum,16-23,0,2,0,2,0.000,0.000
5,0.960,Opossum,23-5,0,9,0,9,0.000,0.000
5,0.960,Cow,16-23,1523,902,0,2425,62.804,62.804
5,0.960,Cow,23-5,1492,1154,0,2646,56.387,56.387
5,0.960,Deer Mouse,16-23,0,0,0,0,NaN,NaN
5,0.960,Deer Mouse,23-5,0,0,0,0,NaN,NaN
5,0.960,OVERALL,16-23,3962,2354,0,6316,62.730,62.730
5,0.960,OVERALL,23-5,4631,2949,0,7580,61.095,61.095
5,0.970,Chicken,16-23,5,24,0,29,17.241,17.241
5,0.970,Chicken,23-5,12,13,0,25,48.000,48.000
5,0.970,Sea Lion,16-23,0,0,0,0,NaN,NaN
5,0.970,Sea Lion,23-5,4,7,0,11,36.364,36.364
5,0.970,Hu and Cw,16-23,10,22,0,32,31.250,31.250
5,0.970,Hu and Cw,23-5,8,29,0,37,21.622,21.622
5,0.970,Sheep,16-23,60,60,0,120,50.000,50.000
5,0.970,Sheep,23-5,70,37,0,107,65.421,65.421
5,0.970,Hu and Dg,16-23,11,19,0,30,36.667,36.667
5,0.970,Hu and Dg,23-5,20,13,0,33,60.606,60.606
5,0.970,Common Loon,16-23,0,2,0,2,0.000,0.000
5,0.970,Common Loon,23-5,0,3,0,3,0.000,0.000
5,0.970,Red-Winged Blackbird,16-23,0,12,0,12,0.000,0.000
5,0.970,Red-Winged Blackbird,23-5,0,8,0,8,0.000,0.000
5,0.970,Cw,16-23,8,15,0,23,34.783,34.783
5,0.970,Cw,23-5,24,41,0,65,36.923,36.923
5,0.970,Cliff Sparrow,16-23,3,30,0,33,9.091,9.091
5,0.970,Cliff Sparrow,23-5,3,12,0,15,20.000,20.000
5,0.970,Pig,16-23,13,8,0,21,61.905,61.905
5,0.970,Pig,23-5,8,12,0,20,40.000,40.000
5,0.970,Barn Owl,16-23,0,0,0,0,NaN,NaN
5,0.970,Barn Owl,23-5,0,1,0,1,0.000,0.000
5,0.970,Wild Pig,16-23,8,5,0,13,61.538,61.538
5,0.970,Wild Pig,23-5,4,5,0,9,44.444,44.444
5,0.970,Pennington Creek Water,16-23,0,0,0,0,NaN,NaN
5,0.970,Pennington Creek Water,23-5,0,0,0,0,NaN,NaN
5,0.970,Guinni,16-23,0,0,0,0,NaN,NaN
5,0.970,Guinni,23-5,0,0,0,0,NaN,NaN
5,0.970,Racoon,16-23,0,3,0,3,0.000,0.000
5,0.970,Racoon,23-5,0,0,0,0,NaN,NaN
5,0.970,Hu,16-23,17,20,0,37,45.946,45.946
5,0.970,Hu,23-5,19,10,0,29,65.517,65.517
5,0.970,Cw and Dg,16-23,8,18,0,26,30.769,30.769
5,0.970,Cw and Dg,23-5,19,23,0,42,45.238,45.238
5,0.970,Red Wind Blackbird,16-23,0,0,0,0,NaN,NaN
5,0.970,Red Wind Blackbird,23-5,0,3,0,3,0.000,0.000
5,0.970,Tree Swallow,16-23,0,1,0,1,0.000,0.000
5,0.970,Tree Swallow,23-5,0,1,0,1,0.000,0.000
5,0.970,Turkey Vulture,16-23,0,0,0,0,NaN,NaN
5,0.970,Turkey Vulture,23-5,0,0,0,0,NaN,NaN
5,0.970,Dg,16-23,9,14,0,23,39.130,39.130
5,0.970,Dg,23-5,30,23,0,53,56.604,56.604
5,0.970,Western Kingbird,16-23,0,0,0,0,NaN,NaN
5,0.970,Western Kingbird,23-5,0,0,0,0,NaN,NaN
5,0.970,White Crowned Sparrow,16-23,3,11,0,14,21.429,21.429
5,0.970,White Crowned Sparrow,23-5,4,13,0,17,23.529,23.529
5,0.970,Eared Grebe,16-23,0,0,0,0,NaN,NaN
5,0.970,Eared Grebe,23-5,3,14,0,17,17.647,17.647
5,0.970,cougar,16-23,0,0,0,0,NaN,NaN
5,0.970,cougar,23-5,0,0,0,0,NaN,NaN
5,0.970,Ocean Water,16-23,0,0,0,0,NaN,NaN
5,0.970,Ocean Water,23-5,0,0,0,0,NaN,NaN
5,0.970,Red Tailed Hawk,16-23,0,2,0,2,0.000,0.000
5,0.970,Red Tailed Hawk,23-5,0,11,0,11,0.000,0.000
5,0.970,Dog,16-23,79,87,0,166,47.590,47.590
5,0.970,Dog,23-5,128,141,0,269,47.584,47.584
5,0.970,Human,16-23,1756,579,0,2335,75.203,75.203
5,0.970,Human,23-5,2217,440,0,2657,83.440,83.440
5,0.970,Wild Turkey,16-23,12,24,0,36,33.333,33.333
5,0.970,Wild Turkey,23-5,6,32,0,38,15.789,15.789
5,0.970,Clark Grebe,16-23,0,0,0,0,NaN,NaN
5,0.970,Clark Grebe,23-5,0,2,0,2,0.000,0.000
5,0.970,Seagull,16-23,0,0,0,0,NaN,NaN
5,0.970,Seagull,23-5,46,7,0,53,86.792,86.792
5,0.970,Surf Scoter,16-23,0,0,0,0,NaN,NaN
5,0.970,Surf Scoter,23-5,0,2,0,2,0.000,0.000
5,0.970,Pigeon,16-23,123,192,0,315,39.048,39.048
5,0.970,Pigeon,23-5,151,303,0,454,33.260,33.260
5,0.970,Pacific Ocean Water,16-23,0,0,0,0,NaN,NaN
5,0.970,Pacific Ocean Water,23-5,0,0,0,0,NaN,NaN
5,0.970,Cat,16-23,29,43,0,72,40.278,40.278
5,0.970,Cat,23-5,37,39,0,76,48.684,48.684
5,0.970,Horse,16-23,13,33,0,46,28.261,28.261
5,0.970,Horse,23-5,34,209,0,243,13.992,13.992
5,0.970,orangutan,16-23,0,0,0,0,NaN,NaN
5,0.970,orangutan,23-5,0,0,0,0,NaN,NaN
5,0.970,Bat,16-23,36,17,0,53,67.925,67.925
5,0.970,Bat,23-5,37,20,0,57,64.912,64.912
5,0.970,Deer,16-23,16,19,0,35,45.714,45.714
5,0.970,Deer,23-5,18,83,0,101,17.822,17.822
5,0.970,Great Horned Owl,16-23,0,0,0,0,NaN,NaN
5,0.970,Great Horned Owl,23-5,0,8,0,8,0.000,0.000
5,0.970,Freshwater Lagoon,16-23,0,0,0,0,NaN,NaN
5,0.970,Freshwater Lagoon,23-5,0,0,0,0,NaN,NaN
5,0.970,Unknown Avian,16-23,0,0,0,0,NaN,NaN
5,0.970,Unknown Avian,23-5,0,0,0,0,NaN,NaN
5,0.970,Human UTI,16-23,90,78,0,168,53.571,53.571
5,0.970,Human UTI,23-5,109,99,0,208,52.404,52.404
5,0.970,unknown,16-23,0,6,0,6,0.000,0.000
5,0.970,unknown,23-5,3,8,0,11,27.273,27.273
5,0.970,SLO Creek Water,16-23,0,0,0,0,NaN,NaN
5,0.970,SLO Creek Water,23-5,0,0,0,0,NaN,NaN
5,0.970,Pig/Swine,16-23,13,12,0,25,52.000,52.000
5,0.970,Pig/Swine,23-5,13,10,0,23,56.522,56.522
5,0.970,Klebsiella,16-23,0,0,0,0,NaN,NaN
5,0.970,Klebsiella,23-5,0,0,0,0,NaN,NaN
5,0.970,Hu Cw and Dg,16-23,11,24,0,35,31.429,31.429
5,0.970,Hu Cw and Dg,23-5,21,29,0,50,42.000,42.000
5,0.970,Ground Squirrel,16-23,103,68,0,171,60.234,60.234
5,0.970,Ground Squirrel,23-5,89,82,0,171,52.047,52.047
5,0.970,Opossum,16-23,0,2,0,2,0.000,0.000
5,0.970,Opossum,23-5,0,9,0,9,0.000,0.000
5,0.970,Cow,16-23,1519,901,0,2420,62.769,62.769
5,0.970,Cow,23-5,1489,1133,0,2622,56.789,56.789
5,0.970,Deer Mouse,16-23,0,0,0,0,NaN,NaN
5,0.970,Deer Mouse,23-5,0,0,0,0,NaN,NaN
5,0.970,OVERALL,16-23,3955,2351,0,6306,62.718,62.718
5,0.970,OVERALL,23-5,4626,2935,0,7561,61.182,61.182
5,0.980,Chicken,16-23,5,24,0,29,17.241,17.241
5,0.980,Chicken,23-5,13,12,0,25,52.000,52.000
5,0.980,Sea Lion,16-23,0,0,0,0,NaN,NaN
5,0.980,Sea Lion,23-5,4,6,0,10,40.000,40.000
5,0.980,Hu and Cw,16-23,10,22,0,32,31.250,31.250
5,0.980,Hu and Cw,23-5,8,34,0,42,19.048,19.048
5,0.980,Sheep,16-23,60,58,0,118,50.847,50.847
5,0.980,Sheep,23-5,69,36,0,105,65.714,65.714
5,0.980,Hu and Dg,16-23,11,19,0,30,36.667,36.667
5,0.980,Hu and Dg,23-5,20,12,0,32,62.500,62.500
5,0.980,Common Loon,16-23,0,2,0,2,0.000,0.000
5,0.980,Common Loon,23-5,0,2,0,2,0.000,0.000
5,0.980,Red-Winged Blackbird,16-23,0,12,0,12,0.000,0.000
5,0.980,Red-Winged Blackbird,23-5,0,8,0,8,0.000,0.000
5,0.980,Cw,16-23,8,14,0,22,36.364,36.364
5,0.980,Cw,23-5,24,42,0,66,36.364,36.364
5,0.980,Cliff Sparrow,16-23,3,28,0,31,9.677,9.677
5,0.980,Cliff Sparrow,23-5,3,12,0,15,20.000,20.000
5,0.980,Pig,16-23,13,8,0,21,61.905,61.905
5,0.980,Pig,23-5,8,12,0,20,40.000,40.000
5,0.980,Barn Owl,16-23,0,0,0,0,NaN,NaN
5,0.980,Barn Owl,23-5,0,1,0,1,0.000,0.000
5,0.980,Wild Pig,16-23,8,5,0,13,61.538,61.538
5,0.980,Wild Pig,23-5,4,4,0,8,50.000,50.000
5,0.980,Pennington Creek Water,16-23,0,0,0,0,NaN,NaN
5,0.980,Pennington Creek Water,23-5,0,0,0,0,NaN,NaN
5,0.980,Guinni,16-23,0,0,0,0,NaN,NaN
5,0.980,Guinni,23-5,0,0,0,0,NaN,NaN
5,0.980,Racoon,16-23,0,3,0,3,0.000,0.000
5,0.980,Racoon,23-5,0,0,0,0,NaN,NaN
5,0.980,Hu,16-23,17,20,0,37,45.946,45.946
5,0.980,Hu,23-5,19,10,0,29,65.517,65.517
5,0.980,Cw and Dg,16-23,8,18,0,26,30.769,30.769
5,0.980,Cw and Dg,23-5,19,22,0,41,46.341,46.341
5,0.980,Red Wind Blackbird,16-23,0,0,0,0,NaN,NaN
5,0.980,Red Wind Blackbird,23-5,0,3,0,3,0.000,0.000
5,0.980,Tree Swallow,16-23,0,1,0,1,0.000,0.000
5,0.980,Tree Swallow,23-5,0,1,0,1,0.000,0.000
5,0.980,Turkey Vulture,16-23,0,0,0,0,NaN,NaN
5,0.980,Turkey Vulture,23-5,0,0,0,0,NaN,NaN
5,0.980,Dg,16-23,9,14,0,23,39.130,39.130
5,0.980,Dg,23-5,30,21,0,51,58.824,58.824
5,0.980,Western Kingbird,16-23,0,0,0,0,NaN,NaN
5,0.980,Western Kingbird,23-5,0,0,0,0,NaN,NaN
5,0.980,White Crowned Sparrow,16-23,3,11,0,14,21.429,21.429
5,0.980,White Crowned Sparrow,23-5,4,13,0,17,23.529,23.529
5,0.980,Eared Grebe,16-23,0,0,0,0,NaN,NaN
5,0.980,Eared Grebe,23-5,3,14,0,17,17.647,17.647
5,0.980,cougar,16-23,0,0,0,0,NaN,NaN
5,0.980,cougar,23-5,0,0,0,0,NaN,NaN
5,0.980,Ocean Water,16-23,0,0,0,0,NaN,NaN
5,0.980,Ocean Water,23-5,0,0,0,0,NaN,NaN
5,0.980,Red Tailed Hawk,16-23,0,2,0,2,0.000,0.000
5,0.980,Red Tailed Hawk,23-5,0,11,0,11,0.000,0.000
5,0.980,Dog,16-23,78,88,0,166,46.988,46.988
5,0.980,Dog,23-5,128,140,0,268,47.761,47.761
5,0.980,Human,16-23,1760,571,0,2331,75.504,75.504
5,0.980,Human,23-5,2219,429,0,2648,83.799,83.799
5,0.980,Wild Turkey,16-23,12,24,0,36,33.333,33.333
5,0.980,Wild Turkey,23-5,8,35,0,43,18.605,18.605
5,0.980,Clark Grebe,16-23,0,0,0,0,NaN,NaN
5,0.980,Clark Grebe,23-5,0,2,0,2,0.000,0.000
5,0.980,Seagull,16-23,0,0,0,0,NaN,NaN
5,0.980,Seagull,23-5,48,5,0,53,90.566,90.566
5,0.980,Surf Scoter,16-23,0,0,0,0,NaN,NaN
5,0.980,Surf Scoter,23-5,2,0,0,2,100.000,100.000
5,0.980,Pigeon,16-23,123,192,0,315,39.048,39.048
5,0.980,Pigeon,23-5,150,307,0,457,32.823,32.823
5,0.980,Pacific Ocean Water,16-23,0,0,0,0,NaN,NaN
5,0.980,Pacific Ocean Water,23-5,0,0,0,0,NaN,NaN
5,0.980,Cat,16-23,29,41,0,70,41.429,41.429
5,0.980,Cat,23-5,37,37,0,74,50.000,50.000
5,0.980,Horse,16-23,13,33,0,46,28.261,28.261
5,0.980,Horse,23-5,34,205,0,239,14.226,14.226
5,0.980,orangutan,16-23,0,0,0,0,NaN,NaN
5,0.980,orangutan,23-5,0,0,0,0,NaN,NaN
5,0.980,Bat,16-23,36,17,0,53,67.925,67.925
5,0.980,Bat,23-5,37,19,0,56,66.071,66.071
5,0.980,Deer,16-23,16,19,0,35,45.714,45.714
5,0.980,Deer,23-5,18,83,0,101,17.822,17.822
5,0.980,Great Horned Owl,16-23,0,0,0,0,NaN,NaN
5,0.980,Great Horned Owl,23-5,0,8,0,8,0.000,0.000
5,0.980,Freshwater Lagoon,16-23,0,0,0,0,NaN,NaN
5,0.980,Freshwater Lagoon,23-5,0,0,0,0,NaN,NaN
5,0.980,Unknown Avian,16-23,0,0,0,0,NaN,NaN
5,0.980,Unknown Avian,23-5,0,0,0,0,NaN,NaN
5,0.980,Human UTI,16-23,90,78,0,168,53.571,53.571
5,0.980,Human UTI,23-5,109,97,0,206,52.913,52.913
5,0.980,unknown,16-23,0,6,0,6,0.000,0.000
5,0.980,unknown,23-5,3,9,0,12,25.000,25.000
5,0.980,SLO Creek Water,16-23,0,0,0,0,NaN,NaN
5,0.980,SLO Creek Water,23-5,0,0,0,0,NaN,NaN
5,0.980,Pig/Swine,16-23,13,12,0,25,52.000,52.000
5,0.980,Pig/Swine,23-5,13,10,0,23,56.522,56.522
5,0.980,Klebsiella,16-23,0,0,0,0,NaN,NaN
5,0.980,Klebsiella,23-5,0,0,0,0,NaN,NaN
5,0.980,Hu Cw and Dg,16-23,11,24,0,35,31.429,31.429
5,0.980,Hu Cw and Dg,23-5,21,27,0,48,43.750,43.750
5,0.980,Ground Squirrel,16-23,102,69,0,171,59.649,59.649
5,0.980,Ground Squirrel,23-5,89,79,0,168,52.976,52.976
5,0.980,Opossum,16-23,0,2,0,2,0.000,0.000
5,0.980,Opossum,23-5,0,9,0,9,0.000,0.000
5,0.980,Cow,16-23,1513,890,0,2403,62.963,62.963
5,0.980,Cow,23-5,1485,1116,0,2601,57.093,57.093
5,0.980,Deer Mouse,16-23,0,0,0,0,NaN,NaN
5,0.980,Deer Mouse,23-5,0,0,0,0,NaN,NaN
5,0.980,OVERALL,16-23,3951,2327,0,6278,62.934,62.934
5,0.980,OVERALL,23-5,4629,2893,0,7522,61.539,61.539
5,0.990,Chicken,16-23,5,29,0,34,14.706,14.706
5,0.990,Chicken,23-5,14,11,0,25,56.000,56.000
5,0.990,Sea Lion,16-23,0,0,0,0,NaN,NaN
5,0.990,Sea Lion,23-5,4,6,0,10,40.000,40.000
5,0.990,Hu and Cw,16-23,11,22,0,33,33.333,33.333
5,0.990,Hu and Cw,23-5,9,32,0,41,21.951,21.951
5,0.990,Sheep,16-23,60,57,0,117,51.282,51.282
5,0.990,Sheep,23-5,69,36,0,105,65.714,65.714
5,0.990,Hu and Dg,16-23,11,20,0,31,35.484,35.484
5,0.990,Hu and Dg,23-5,20,11,0,31,64.516,64.516
5,0.990,Common Loon,16-23,0,2,0,2,0.000,0.000
5,0.990,Common Loon,23-5,0,3,0,3,0.000,0.000
5,0.990,Red-Winged Blackbird,16-23,0,11,0,11,0.000,0.000
5,0.990,Red-Winged Blackbird,23-5,0,8,0,8,0.000,0.000
5,0.990,Cw,16-23,8,14,0,22,36.364,36.364
5,0.990,Cw,23-5,24,41,0,65,36.923,36.923
5,0.990,Cliff Sparrow,16-23,3,26,0,29,10.345,10.345
5,0.990,Cliff Sparrow,23-5,3,14,0,17,17.647,17.647
5,0.990,Pig,16-23,13,9,0,22,59.091,59.091
5,0.990,Pig,23-5,8,11,0,19,42.105,42.105
5,0.990,Barn Owl,16-23,0,0,0,0,NaN,NaN
5,0.990,Barn Owl,23-5,0,1,0,1,0.000,0.000
5,0.990,Wild Pig,16-23,8,6,0,14,57.143,57.143
5,0.990,Wild Pig,23-5,4,3,0,7,57.143,57.143
5,0.990,Pennington Creek Water,16-23,0,0,0,0,NaN,NaN
5,0.990,Pennington Creek Water,23-5,0,0,0,0,NaN,NaN
5,0.990,Guinni,16-23,0,0,0,0,NaN,NaN
5,0.990,Guinni,23-5,0,0,0,0,NaN,NaN
5,0.990,Racoon,16-23,0,3,0,3,0.000,0.000
5,0.990,Racoon,23-5,0,1,0,1,0.000,0.000
5,0.990,Hu,16-23,17,18,0,35,48.571,48.571
5,0.990,Hu,23-5,19,7,0,26,73.077,73.077
5,0.990,Cw and Dg,16-23,8,18,0,26,30.769,30.769
5,0.990,Cw and Dg,23-5,18,15,0,33,54.545,54.545
5,0.990,Red Wind Blackbird,16-23,0,0,0,0,NaN,NaN
5,0.990,Red Wind Blackbird,23-5,0,3,0,3,0.000,0.000
5,0.990,Tree Swallow,16-23,0,1,0,1,0.000,0.000
5,0.990,Tree Swallow,23-5,0,1,0,1,0.000,0.000
5,0.990,Turkey Vulture,16-23,0,0,0,0,NaN,NaN
5,0.990,Turkey Vulture,23-5,0,0,0,0,NaN,NaN
5,0.990,Dg,16-23,9,14,0,23,39.130,39.130
5,0.990,Dg,23-5,30,19,0,49,61.224,61.224
5,0.990,Western Kingbird,16-23,0,0,0,0,NaN,NaN
5,0.990,Western Kingbird,23-5,0,0,0,0,NaN,NaN
5,0.990,White Crowned Sparrow,16-23,3,9,0,12,25.000,25.000
5,0.990,White Crowned Sparrow,23-5,4,12,0,16,25.000,25.000
5,0.990,Eared Grebe,16-23,0,0,0,0,NaN,NaN
5,0.990,Eared Grebe,23-5,3,12,0,15,20.000,20.000
5,0.990,cougar,16-23,0,1,0,1,0.000,0.000
5,0.990,cougar,23-5,0,0,0,0,NaN,NaN
5,0.990,Ocean Water,16-23,0,0,0,0,NaN,NaN
5,0.990,Ocean Water,23-5,0,0,0,0,NaN,NaN
5,0.990,Red Tailed Hawk,16-23,0,2,0,2,0.000,0.000
5,0.990,Red Tailed Hawk,23-5,0,12,0,12,0.000,0.000
5,0.990,Dog,16-23,79,84,0,163,48.466,48.466
5,0.990,Dog,23-5,128,132,0,260,49.231,49.231
5,0.990,Human,16-23,1747,543,0,2290,76.288,76.288
5,0.990,Human,23-5,2211,405,0,2616,84.518,84.518
5,0.990,Wild Turkey,16-23,13,26,0,39,33.333,33.333
5,0.990,Wild Turkey,23-5,8,32,0,40,20.000,20.000
5,0.990,Clark Grebe,16-23,0,0,0,0,NaN,NaN
5,0.990,Clark Grebe,23-5,2,3,0,5,40.000,40.000
5,0.990,Seagull,16-23,0,0,0,0,NaN,NaN
5,0.990,Seagull,23-5,49,5,0,54,90.741,90.741
5,0.990,Surf Scoter,16-23,0,0,0,0,NaN,NaN
5,0.990,Surf Scoter,23-5,2,0,0,2,100.000,100.000
5,0.990,Pigeon,16-23,124,184,0,308,40.260,40.260
5,0.990,Pigeon,23-5,153,289,0,442,34.615,34.615
5,0.990,Pacific Ocean Water,16-23,0,0,0,0,NaN,NaN
5,0.990,Pacific Ocean Water,23-5,0,0,0,0,NaN,NaN
5,0.990,Cat,16-23,28,37,0,65,43.077,43.077
5,0.990,Cat,23-5,37,36,0,73,50.685,50.685
5,0.990,Horse,16-23,15,32,0,47,31.915,31.915
5,0.990,Horse,23-5,34,206,0,240,14.167,14.167
5,0.990,orangutan,16-23,0,0,0,0,NaN,NaN
5,0.990,orangutan,23-5,0,0,0,0,NaN,NaN
5,0.990,Bat,16-23,36,16,0,52,69.231,69.231
5,0.990,Bat,23-5,37,19,0,56,66.071,66.071
5,0.990,Deer,16-23,16,20,0,36,44.444,44.444
5,0.990,Deer,23-5,18,82,0,100,18.000,18.000
5,0.990,Great Horned Owl,16-23,0,0,0,0,NaN,NaN
5,0.990,Great Horned Owl,23-5,0,8,0,8,0.000,0.000
5,0.990,Freshwater Lagoon,16-23,0,0,0,0,NaN,NaN
5,0.990,Freshwater Lagoon,23-5,0,0,0,0,NaN,NaN
5,0.990,Unknown Avian,16-23,0,0,0,0,NaN,NaN
5,0.990,Unknown Avian,23-5,0,0,0,0,NaN,NaN
5,0.990,Human UTI,16-23,94,69,0,163,57.669,57.669
5,0.990,Human UTI,23-5,110,82,0,192,57.292,57.292
5,0.990,unknown,16-23,0,6,0,6,0.000,0.000
5,0.990,unknown,23-5,3,10,0,13,23.077,23.077
5,0.990,SLO Creek Water,16-23,0,0,0,0,NaN,NaN
5,0.990,SLO Creek Water,23-5,0,0,0,0,NaN,NaN
5,0.990,Pig/Swine,16-23,13,13,0,26,50.000,50.000
5,0.990,Pig/Swine,23-5,13,10,0,23,56.522,56.522
5,0.990,Klebsiella,16-23,0,0,0,0,NaN,NaN
5,0.990,Klebsiella,23-5,0,0,0,0,NaN,NaN
5,0.990,Hu Cw and Dg,16-23,11,24,0,35,31.429,31.429
5,0.990,Hu Cw and Dg,23-5,21,27,0,48,43.750,43.750
5,0.990,Ground Squirrel,16-23,103,67,0,170,60.588,60.588
5,0.990,Ground Squirrel,23-5,90,77,0,167,53.892,53.892
5,0.990,Opossum,16-23,1,2,0,3,33.333,33.333
5,0.990,Opossum,23-5,2,9,0,11,18.182,18.182
5,0.990,Cow,16-23,1483,821,0,2304,64.366,64.366
5,0.990,Cow,23-5,1455,1033,0,2488,58.481,58.481
5,0.990,Deer Mouse,16-23,0,0,0,0,NaN,NaN
5,0.990,Deer Mouse,23-5,0,0,0,0,NaN,NaN
5,0.990,OVERALL,16-23,3919,2206,0,6125,63.984,63.984
5,0.990,OVERALL,23-5,4602,2724,0,7326,62.817,62.817
5,1.000,Chicken,16-23,0,0,0,0,NaN,NaN
5,1.000,Chicken,23-5,0,0,0,0,NaN,NaN
5,1.000,Sea Lion,16-23,0,0,0,0,NaN,NaN
5,1.000,Sea Lion,23-5,0,0,0,0,NaN,NaN
5,1.000,Hu and Cw,16-23,0,0,0,0,NaN,NaN
5,1.000,Hu and Cw,23-5,0,0,0,0,NaN,NaN
5,1.000,Sheep,16-23,0,0,0,0,NaN,NaN
5,1.000,Sheep,23-5,0,0,0,0,NaN,NaN
5,1.000,Hu and Dg,16-23,0,0,0,0,NaN,NaN
5,1.000,Hu and Dg,23-5,0,0,0,0,NaN,NaN
5,1.000,Common Loon,16-23,0,0,0,0,NaN,NaN
5,1.000,Common Loon,23-5,0,0,0,0,NaN,NaN
5,1.000,Red-Winged Blackbird,16-23,0,0,0,0,NaN,NaN
5,1.000,Red-Winged Blackbird,23-5,0,0,0,0,NaN,NaN
5,1.000,Cw,16-23,0,0,0,0,NaN,NaN
5,1.000,Cw,23-5,0,0,0,0,NaN,NaN
5,1.000,Cliff Sparrow,16-23,0,0,0,0,NaN,NaN
5,1.000,Cliff Sparrow,23-5,0,0,0,0,NaN,NaN
5,1.000,Pig,16-23,0,0,0,0,NaN,NaN
5,1.000,Pig,23-5,0,0,0,0,NaN,NaN
5,1.000,Barn Owl,16-23,0,0,0,0,NaN,NaN
5,1.000,Barn Owl,23-5,0,0,0,0,NaN,NaN
5,1.000,Wild Pig,16-23,0,0,0,0,NaN,NaN
5,1.000,Wild Pig,23-5,0,0,0,0,NaN,NaN
5,1.000,Pennington Creek Water,16-23,0,0,0,0,NaN,NaN
5,1.000,Pennington Creek Water,23-5,0,0,0,0,NaN,NaN
5,1.000,Guinni,16-23,0,0,0,0,NaN,NaN
5,1.000,Guinni,23-5,0,0,0,0,NaN,NaN
5,1.000,Racoon,16-23,0,0,0,0,NaN,NaN
5,1.000,Racoon,23-5,0,0,0,0,NaN,NaN
5,1.000,Hu,16-23,0,0,0,0,NaN,NaN
5,1.000,Hu,23-5,0,0,0,0,NaN,NaN
5,1.000,Cw and Dg,16-23,0,0,0,0,NaN,NaN
5,1.000,Cw and Dg,23-5,0,0,0,0,NaN,NaN
5,1.000,Red Wind Blackbird,16-23,0,0,0,0,NaN,NaN
5,1.000,Red Wind Blackbird,23-5,0,0,0,0,NaN,NaN
5,1.000,Tree Swallow,16-23,0,0,0,0,NaN,NaN
5,1.000,Tree Swallow,23-5,0,0,0,0,NaN,NaN
5,1.000,Turkey Vulture,16-23,0,0,0,0,NaN,NaN
5,1.000,Turkey Vulture,23-5,0,0,0,0,NaN,NaN
5,1.000,Dg,16-23,0,0,0,0,NaN,NaN
5,1.000,Dg,23-5,0,0,0,0,NaN,NaN
5,1.000,Western Kingbird,16-23,0,0,0,0,NaN,NaN
5,1.000,Western Kingbird,23-5,0,0,0,0,NaN,NaN
5,1.000,White Crowned Sparrow,16-23,0,0,0,0,NaN,NaN
5,1.000,White Crowned Sparrow,23-5,0,0,0,0,NaN,NaN
5,1.000,Eared Grebe,16-23,0,0,0,0,NaN,NaN
5,1.000,Eared Grebe,23-5,0,0,0,0,NaN,NaN
5,1.000,cougar,16-23,0,0,0,0,NaN,NaN
5,1.000,cougar,23-5,0,0,0,0,NaN,NaN
5,1.000,Ocean Water,16-23,0,0,0,0,NaN,NaN
5,1.000,Ocean Water,23-5,0,0,0,0,NaN,NaN
5,1.000,Red Tailed Hawk,16-23,0,0,0,0,NaN,NaN
5,1.000,Red Tailed Hawk,23-5,0,0,0,0,NaN,NaN
5,1.000,Dog,16-23,0,0,0,0,NaN,NaN
5,1.000,Dog,23-5,0,0,0,0,NaN,NaN
5,1.000,Human,16-23,68,0,0,68,100.000,100.000
5,1.000,Human,23-5,90,0,0,90,100.000,100.000
5,1.000,Wild Turkey,16-23,0,0,0,0,NaN,NaN
5,1.000,Wild Turkey,23-5,0,0,0,0,NaN,NaN
5,1.000,Clark Grebe,16-23,0,0,0,0,NaN,NaN
5,1.000,Clark Grebe,23-5,0,0,0,0,NaN,NaN
5,1.000,Seagull,16-23,0,0,0,0,NaN,NaN
5,1.000,Seagull,23-5,0,0,0,0,NaN,NaN
5,1.000,Surf Scoter,16-23,0,0,0,0,NaN,NaN
5,1.000,Surf Scoter,23-5,0,0,0,0,NaN,NaN
5,1.000,Pigeon,16-23,0,0,0,0,NaN,NaN
5,1.000,Pigeon,23-5,0,0,0,0,NaN,NaN
5,1.000,Pacific Ocean Water,16-23,0,0,0,0,NaN,NaN
5,1.000,Pacific Ocean Water,23-5,0,0,0,0,NaN,NaN
5,1.000,Cat,16-23,0,0,0,0,NaN,NaN
5,1.000,Cat,23-5,0,0,0,0,NaN,NaN
5,1.000,Horse,16-23,0,0,0,0,NaN,NaN
5,1.000,Horse,23-5,0,0,0,0,NaN,NaN
5,1.000,orangutan,16-23,0,0,0,0,NaN,NaN
5,1.000,orangutan,23-5,0,0,0,0,NaN,NaN
5,1.000,Bat,16-23,0,0,0,0,NaN,NaN
5,1.000,Bat,23-5,0,0,0,0,NaN,NaN
5,1.000,Deer,16-23,0,0,0,0,NaN,NaN
5,1.000,Deer,23-5,0,0,0,0,NaN,NaN
5,1.000,Great Horned Owl,16-23,0,0,0,0,NaN,NaN
5,1.000,Great Horned Owl,23-5,0,0,0,0,NaN,NaN
5,1.000,Freshwater Lagoon,16-23,0,0,0,0,NaN,NaN
5,1.000,Freshwater Lagoon,23-5,0,0,0,0,NaN,NaN
5,1.000,Unknown Avian,16-23,0,0,0,0,NaN,NaN
5,1.000,Unknown Avian,23-5,0,0,0,0,NaN,NaN
5,1.000,Human UTI,16-23,0,0,0,0,NaN,NaN
5,1.000,Human UTI,23-5,0,0,0,0,NaN,NaN
5,1.000,unknown,16-23,0,0,0,0,NaN,NaN
5,1.000,unknown,23-5,0,0,0,0,NaN,NaN
5,1.000,SLO Creek Water,16-23,0,0,0,0,NaN,NaN
5,1.000,SLO Creek Water,23-5,0,0,0,0,NaN,NaN
5,1.000,Pig/Swine,16-23,0,0,0,0,NaN,NaN
5,1.000,Pig/Swine,23-5,0,0,0,0,NaN,NaN
5,1.000,Klebsiella,16-23,0,0,0,0,NaN,NaN
5,1.000,Klebsiella,23-5,0,0,0,0,NaN,NaN
5,1.000,Hu Cw and Dg,16-23,0,0,0,0,NaN,NaN
5,1.000,Hu Cw and Dg,23-5,0,0,0,0,NaN,NaN
5,1.000,Ground Squirrel,16-23,0,0,0,0,NaN,NaN
5,1.000,Ground Squirrel,23-5,0,0,0,0,NaN,NaN
5,1.000,Opossum,16-23,0,0,0,0,NaN,NaN
5,1.000,Opossum,23-5,0,0,0,0,NaN,NaN
5,1.000,Cow,16-23,0,0,0,0,NaN,NaN
5,1.000,Cow,23-5,0,0,0,0,NaN,NaN
5,1.000,Deer Mouse,16-23,0,0,0,0,NaN,NaN
5,1.000,Deer Mouse,23-5,0,0,0,0,NaN,NaN
5,1.000,OVERALL,16-23,68,0,0,68,100.000,100.000
5,1.000,OVERALL,23-5,90,0,0,90,100.000,100.000
6,0.000,Chicken,16-23,4,14,0,18,22.222,22.222
6,0.000,Chicken,23-5,12,11,0,23,52.174,52.174
6,0.000,Sea Lion,16-23,0,1,0,1,0.000,0.000
6,0.000,Sea Lion,23-5,4,8,0,12,33.333,33.333
6,0.000,Hu and Cw,16-23,8,18,0,26,30.769,30.769
6,0.000,Hu and Cw,23-5,8,21,0,29,27.586,27.586
6,0.000,Sheep,16-23,60,52,0,112,53.571,53.571
6,0.000,Sheep,23-5,71,39,0,110,64.545,64.545
6,0.000,Hu and Dg,16-23,10,18,0,28,35.714,35.714
6,0.000,Hu and Dg,23-5,19,14,0,33,57.576,57.576
6,0.000,Common Loon,16-23,0,0,0,0,NaN,NaN
6,0.000,Common Loon,23-5,0,4,0,4,0.000,0.000
6,0.000,Red-Winged Blackbird,16-23,0,12,0,12,0.000,0.000
6,0.000,Red-Winged Blackbird,23-5,0,6,0,6,0.000,0.000
6,0.000,Cw,16-23,12,12,0,24,50.000,50.000
6,0.000,Cw,23-5,25,45,0,70,35.714,35.714
6,0.000,Cliff Sparrow,16-23,3,32,0,35,8.571,8.571
6,0.000,Cliff Sparrow,23-5,2,7,0,9,22.222,22.222
6,0.000,Pig,16-23,13,8,0,21,61.905,61.905
6,0.000,Pig,23-5,4,12,0,16,25.000,25.000
6,0.000,Barn Owl,16-23,0,0,0,0,NaN,NaN
6,0.000,Barn Owl,23-5,0,0,0,0,NaN,NaN
6,0.000,Wild Pig,16-23,6,3,0,9,66.667,66.667
6,0.000,Wild Pig,23-5,4,4,0,8,50.000,50.000
6,0.000,Pennington Creek Water,16-23,0,0,0,0,NaN,NaN
6,0.000,Pennington Creek Water,23-5,0,0,0,0,NaN,NaN
6,0.000,Guinni,16-23,0,0,0,0,NaN,NaN
6,0.000,Guinni,23-5,0,0,0,0,NaN,NaN
6,0.000,Racoon,16-23,0,3,0,3,0.000,0.000
6,0.000,Racoon,23-5,0,0,0,0,NaN,NaN
6,0.000,Hu,16-23,17,18,0,35,48.571,48.571
6,0.000,Hu,23-5,19,10,0,29,65.517,65.517
6,0.000,Cw and Dg,16-23,4,16,0,20,20.000,20.000
6,0.000,Cw and Dg,23-5,16,23,0,39,41.026,41.026
6,0.000,Red Wind Blackbird,16-23,0,0,0,0,NaN,NaN
6,0.000,Red Wind Blackbird,23-5,0,0,0,0,NaN,NaN
6,0.000,Tree Swallow,16-23,0,1,0,1,0.000,0.000
6,0.000,Tree Swallow,23-5,0,1,0,1,0.000,0.000
6,0.000,Turkey Vulture,16-23,0,0,0,0,NaN,NaN
6,0.000,Turkey Vulture,23-5,0,0,0,0,NaN,NaN
6,0.000,Dg,16-23,8,16,0,24,33.333,33.333
6,0.000,Dg,23-5,30,30,0,60,50.000,50.000
6,0.000,Western Kingbird,16-23,0,0,0,0,NaN,NaN
6,0.000,Western Kingbird,23-5,0,0,0,0,NaN,NaN
6,0.000,White Crowned Sparrow,16-23,1,6,0,7,14.286,14.286
6,0.000,White Crowned Sparrow,23-5,3,10,0,13,23.077,23.077
6,0.000,Eared Grebe,16-23,0,0,0,0,NaN,NaN
6,0.000,Eared Grebe,23-5,2,18,0,20,10.000,10.000
6,0.000,cougar,16-23,0,0,0,0,NaN,NaN
6,0.000,cougar,23-5,0,0,0,0,NaN,NaN
6,0.000,Ocean Water,16-23,0,0,0,0,NaN,NaN
6,0.000,Ocean Water,23-5,0,0,0,0,NaN,NaN
6,0.000,Red Tailed Hawk,16-23,0,3,0,3,0.000,0.000
6,0.000,Red Tailed Hawk,23-5,0,9,0,9,0.000,0.000
6,0.000,Dog,16-23,72,81,0,153,47.059,47.059
6,0.000,Dog,23-5,118,133,0,251,47.012,47.012
6,0.000,Human,16-23,1758,639,0,2397,73.342,73.342
6,0.000,Human,23-5,2220,516,0,2736,81.140,81.140
6,0.000,Wild Turkey,16-23,13,24,0,37,35.135,35.135
6,0.000,Wild Turkey,23-5,2,31,0,33,6.061,6.061
6,0.000,Clark Grebe,16-23,0,0,0,0,NaN,NaN
6,0.000,Clark Grebe,23-5,0,1,0,1,0.000,0.000
6,0.000,Seagull,16-23,0,0,0,0,NaN,NaN
6,0.000,Seagull,23-5,46,6,0,52,88.462,88.462
6,0.000,Surf Scoter,16-23,0,0,0,0,NaN,NaN
6,0.000,Surf Scoter,23-5,0,3,0,3,0.000,0.000
6,0.000,Pigeon,16-23,113,175,0,288,39.236,39.236
6,0.000,Pigeon,23-5,151,260,0,411,36.740,36.740
6,0.000,Pacific Ocean Water,16-23,0,0,0,0,NaN,NaN
6,0.000,Pacific Ocean Water,23-5,0,0,0,0,NaN,NaN
6,0.000,Cat,16-23,28,36,0,64,43.750,43.750
6,0.000,Cat,23-5,37,38,0,75,49.333,49.333
6,0.000,Horse,16-23,10,21,0,31,32.258,32.258
6,0.000,Horse,23-5,35,188,0,223,15.695,15.695
6,0.000,orangutan,16-23,0,0,0,0,NaN,NaN
6,0.000,orangutan,23-5,0,0,0,0,NaN,NaN
6,0.000,Bat,16-23,36,20,0,56,64.286,64.286
6,0.000,Bat,23-5,37,24,0,61,60.656,60.656
6,0.000,Deer,16-23,16,20,0,36,44.444,44.444
6,0.000,Deer,23-5,18,86,0,104,17.308,17.308
6,0.000,Great Horned Owl,16-23,0,0,0,0,NaN,NaN
6,0.000,Great Horned Owl,23-5,0,6,0,6,0.000,0.000
6,0.000,Freshwater Lagoon,16-23,0,0,0,0,NaN,NaN
6,0.000,Freshwater Lagoon,23-5,0,0,0,0,NaN,NaN
6,0.000,Unknown Avian,16-23,0,0,0,0,NaN,NaN
6,0.000,Unknown Avian,23-5,0,0,0,0,NaN,NaN
6,0.000,Human UTI,16-23,83,76,0,159,52.201,52.201
6,0.000,Human UTI,23-5,111,96,0,207,53.623,53.623
6,0.000,unknown,16-23,0,3,0,3,0.000,0.000
6,0.000,unknown,23-5,2,6,0,8,25.000,25.000
6,0.000,SLO Creek Water,16-23,0,0,0,0,NaN,NaN
6,0.000,SLO Creek Water,23-5,0,0,0,0,NaN,NaN
6,0.000,Pig/Swine,16-23,14,11,0,25,56.000,56.000
6,0.000,Pig/Swine,23-5,13,9,0,22,59.091,59.091
6,0.000,Klebsiella,16-23,0,0,0,0,NaN,NaN
6,0.000,Klebsiella,23-5,0,0,0,0,NaN,NaN
6,0.000,Hu Cw and Dg,16-23,10,23,0,33,30.303,30.303
6,0.000,Hu Cw and Dg,23-5,18,27,0,45,40.000,40.000
6,0.000,Ground Squirrel,16-23,104,80,0,184,56.522,56.522
6,0.000,Ground Squirrel,23-5,90,84,0,174,51.724,51.724
6,0.000,Opossum,16-23,0,2,0,2,0.000,0.000
6,0.000,Opossum,23-5,0,8,0,8,0.000,0.000
6,0.000,Cow,16-23,1530,971,0,2501,61.176,61.176
6,0.000,Cow,23-5,1481,1218,0,2699,54.872,54.872
6,0.000,Deer Mouse,16-23,0,0,0,0,NaN,NaN
6,0.000,Deer Mouse,23-5,0,0,0,0,NaN,NaN
6,0.000,OVERALL,16-23,3933,2415,0,6348,61.957,61.957
6,0.000,OVERALL,23-5,4598,3012,0,7610,60.420,60.420
6,0.500,Chicken,16-23,4,14,0,18,22.222,22.222
6,0.500,Chicken,23-5,12,11,0,23,52.174,52.174
6,0.500,Sea Lion,16-23,0,1,0,1,0.000,0.000
6,0.500,Sea Lion,23-5,4,8,0,12,33.333,33.333
6,0.500,Hu and Cw,16-23,8,18,0,26,30.769,30.769
6,0.500,Hu and Cw,23-5,8,21,0,29,27.586,27.586
6,0.500,Sheep,16-23,60,52,0,112,53.571,53.571
6,0.500,Sheep,23-5,71,39,0,110,64.545,64.545
6,0.500,Hu and Dg,16-23,10,18,0,28,35.714,35.714
6,0.500,Hu and Dg,23-5,19,14,0,33,57.576,57.576
6,0.500,Common Loon,16-23,0,0,0,0,NaN,NaN
6,0.500,Common Loon,23-5,0,4,0,4,0.000,0.000
6,0.500,Red-Winged Blackbird,16-23,0,12,0,12,0.000,0.000
6,0.500,Red-Winged Blackbird,23-5,0,6,0,6,0.000,0.000
6,0.500,Cw,16-23,12,12,0,24,50.000,50.000
6,0.500,Cw,23-5,25,45,0,70,35.714,35.714
6,0.500,Cliff Sparrow,16-23,3,32,0,35,8.571,8.571
6,0.500,Cliff Sparrow,23-5,2,7,0,9,22.222,22.222
6,0.500,Pig,16-23,13,8,0,21,61.905,61.905
6,0.500,Pig,23-5,4,12,0,16,25.000,25.000
6,0.500,Barn Owl,16-23,0,0,0,0,NaN,NaN
6,0.500,Barn Owl,23-5,0,0,0,0,NaN,NaN
6,0.500,Wild Pig,16-23,6,3,0,9,66.667,66.667
6,0.500,Wild Pig,23-5,4,4,0,8,50.000,50.000
6,0.500,Pennington Creek Water,16-23,0,0,0,0,NaN,NaN
6,0.500,Pennington Creek Water,23-5,0,0,0,0,NaN,NaN
6,0.500,Guinni,16-23,0,0,0,0,NaN,NaN
6,0.500,Guinni,23-5,0,0,0,0,NaN,NaN
6,0.500,Racoon,16-23,0,3,0,3,0.000,0.000
6,0.500,Racoon,23-5,0,0,0,0,NaN,NaN
6,0.500,Hu,16-23,17,18,0,35,48.571,48.571
6,0.500,Hu,23-5,19,10,0,29,65.517,65.517
6,0.500,Cw and Dg,16-23,4,16,0,20,20.000,20.000
6,0.500,Cw and Dg,23-5,16,23,0,39,41.026,41.026
6,0.500,Red Wind Blackbird,16-23,0,0,0,0,NaN,NaN
6,0.500,Red Wind Blackbird,23-5,0,0,0,0,NaN,NaN
6,0.500,Tree Swallow,16-23,0,1,0,1,0.000,0.000
6,0.500,Tree Swallow,23-5,0,1,0,1,0.000,0.000
6,0.500,Turkey Vulture,16-23,0,0,0,0,NaN,NaN
6,0.500,Turkey Vulture,23-5,0,0,0,0,NaN,NaN
6,0.500,Dg,16-23,8,16,0,24,33.333,33.333
6,0.500,Dg,23-5,30,30,0,60,50.000,50.000
6,0.500,Western Kingbird,16-23,0,0,0,0,NaN,NaN
6,0.500,Western Kingbird,23-5,0,0,0,0,NaN,NaN
6,0.500,White Crowned Sparrow,16-23,1,6,0,7,14.286,14.286
6,0.500,White Crowned Sparrow,23-5,3,10,0,13,23.077,23.077
6,0.500,Eared Grebe,16-23,0,0,0,0,NaN,NaN
6,0.500,Eared Grebe,23-5,2,18,0,20,10.000,10.000
6,0.500,cougar,16-23,0,0,0,0,NaN,NaN
6,0.500,cougar,23-5,0,0,0,0,NaN,NaN
6,0.500,Ocean Water,16-23,0,0,0,0,NaN,NaN
6,0.500,Ocean Water,23-5,0,0,0,0,NaN,NaN
6,0.500,Red Tailed Hawk,16-23,0,3,0,3,0.000,0.000
6,0.500,Red Tailed Hawk,23-5,0,9,0,9,0.000,0.000
6,0.500,Dog,16-23,72,81,0,153,47.059,47.059
6,0.500,Dog,23-5,118,133,0,251,47.012,47.012
6,0.500,Human,16-23,1758,639,0,2397,73.342,73.342
6,0.500,Human,23-5,2220,516,0,2736,81.140,81.140
6,0.500,Wild Turkey,16-23,13,24,0,37,35.135,35.135
6,0.500,Wild Turkey,23-5,2,31,0,33,6.061,6.061
6,0.500,Clark Grebe,16-23,0,0,0,0,NaN,NaN
6,0.500,Clark Grebe,23-5,0,1,0,1,0.000,0.000
6,0.500,Seagull,16-23,0,0,0,0,NaN,NaN
6,0.500,Seagull,23-5,46,6,0,52,88.462,88.462
6,0.500,Surf Scoter,16-23,0,0,0,0,NaN,NaN
6,0.500,Surf Scoter,23-5,0,3,0,3,0.000,0.000
6,0.500,Pigeon,16-23,113,175,0,288,39.236,39.236
6,0.500,Pigeon,23-5,151,260,0,411,36.740,36.740
6,0.500,Pacific Ocean Water,16-23,0,0,0,0,NaN,NaN
6,0.500,Pacific Ocean Water,23-5,0,0,0,0,NaN,NaN
6,0.500,Cat,16-23,28,36,0,64,43.750,43.750
6,0.500,Cat,23-5,37,38,0,75,49.333,49.333
6,0.500,Horse,16-23,10,21,0,31,32.258,32.258
6,0.500,Horse,23-5,35,188,0,223,15.695,15.695
6,0.500,orangutan,16-23,0,0,0,0,NaN,NaN
6,0.500,orangutan,23-5,0,0,0,0,NaN,NaN
6,0.500,Bat,16-23,36,20,0,56,64.286,64.286
6,0.500,Bat,23-5,37,24,0,61,60.656,60.656
6,0.500,Deer,16-23,16,20,0,36,44.444,44.444
6,0.500,Deer,23-5,18,86,0,104,17.308,17.308
6,0.500,Great Horned Owl,16-23,0,0,0,0,NaN,NaN
6,0.500,Great Horned Owl,23-5,0,6,0,6,0.000,0.000
6,0.500,Freshwater Lagoon,16-23,0,0,0,0,NaN,NaN
6,0.500,Freshwater Lagoon,23-5,0,0,0,0,NaN,NaN
6,0.500,Unknown Avian,16-23,0,0,0,0,NaN,NaN
6,0.500,Unknown Avian,23-5,0,0,0,0,NaN,NaN
6,0.500,Human UTI,16-23,83,76,0,159,52.201,52.201
6,0.500,Human UTI,23-5,111,96,0,207,53.623,53.623
6,0.500,unknown,16-23,0,3,0,3,0.000,0.000
6,0.500,unknown,23-5,2,6,0,8,25.000,25.000
6,0.500,SLO Creek Water,16-23,0,0,0,0,NaN,NaN
6,0.500,SLO Creek Water,23-5,0,0,0,0,NaN,NaN
6,0.500,Pig/Swine,16-23,14,11,0,25,56.000,56.000
6,0.500,Pig/Swine,23-5,13,9,0,22,59.091,59.091
6,0.500,Klebsiella,16-23,0,0,0,0,NaN,NaN
6,0.500,Klebsiella,23-5,0,0,0,0,NaN,NaN
6,0.500,Hu Cw and Dg,16-23,10,23,0,33,30.303,30.303
6,0.500,Hu Cw and Dg,23-5,18,27,0,45,40.000,40.000
6,0.500,Ground Squirrel,16-23,104,80,0,184,56.522,56.522
6,0.500,Ground Squirrel,23-5,90,84,0,174,51.724,51.724
6,0.500,Opossum,16-23,0,2,0,2,0.000,0.000
6,0.500,Opossum,23-5,0,8,0,8,0.000,0.000
6,0.500,Cow,16-23,1530,971,0,2501,61.176,61.176
6,0.500,Cow,23-5,1481,1218,0,2699,54.872,54.872
6,0.500,Deer Mouse,16-23,0,0,0,0,NaN,NaN
6,0.500,Deer Mouse,23-5,0,0,0,0,NaN,NaN
6,0.500,OVERALL,16-23,3933,2415,0,6348,61.957,61.957
6,0.500,OVERALL,23-5,4598,3012,0,7610,60.420,60.420
6,0.900,Chicken,16-23,4,14,0,18,22.222,22.222
6,0.900,Chicken,23-5,12,11,0,23,52.174,52.174
6,0.900,Sea Lion,16-23,0,1,0,1,0.000,0.000
6,0.900,Sea Lion,23-5,4,8,0,12,33.333,33.333
6,0.900,Hu and Cw,16-23,8,18,0,26,30.769,30.769
6,0.900,Hu and Cw,23-5,8,21,0,29,27.586,27.586
6,0.900,Sheep,16-23,60,52,0,112,53.571,53.571
6,0.900,Sheep,23-5,71,39,0,110,64.545,64.545
6,0.900,Hu and Dg,16-23,10,18,0,28,35.714,35.714
6,0.900,Hu and Dg,23-5,19,14,0,33,57.576,57.576
6,0.900,Common Loon,16-23,0,0,0,0,NaN,NaN
6,0.900,Common Loon,23-5,0,4,0,4,0.000,0.000
6,0.900,Red-Winged Blackbird,16-23,0,12,0,12,0.000,0.000
6,0.900,Red-Winged Blackbird,23-5,0,6,0,6,0.000,0.000
6,0.900,Cw,16-23,12,12,0,24,50.000,50.000
6,0.900,Cw,23-5,25,45,0,70,35.714,35.714
6,0.900,Cliff Sparrow,16-23,3,32,0,35,8.571,8.571
6,0.900,Cliff Sparrow,23-5,2,7,0,9,22.222,22.222
6,0.900,Pig,16-23,13,8,0,21,61.905,61.905
6,0.900,Pig,23-5,4,12,0,16,25.000,25.000
6,0.900,Barn Owl,16-23,0,0,0,0,NaN,NaN
6,0.900,Barn Owl,23-5,0,0,0,0,NaN,NaN
6,0.900,Wild Pig,16-23,6,3,0,9,66.667,66.667
6,0.900,Wild Pig,23-5,4,4,0,8,50.000,50.000
6,0.900,Pennington Creek Water,16-23,0,0,0,0,NaN,NaN
6,0.900,Pennington Creek Water,23-5,0,0,0,0,NaN,NaN
6,0.900,Guinni,16-23,0,0,0,0,NaN,NaN
6,0.900,Guinni,23-5,0,0,0,0,NaN,NaN
6,0.900,Racoon,16-23,0,3,0,3,0.000,0.000
6,0.900,Racoon,23-5,0,0,0,0,NaN,NaN
6,0.900,Hu,16-23,17,18,0,35,48.571,48.571
6,0.900,Hu,23-5,19,10,0,29,65.517,65.517
6,0.900,Cw and Dg,16-23,4,16,0,20,20.000,20.000
6,0.900,Cw and Dg,23-5,16,23,0,39,41.026,41.026
6,0.900,Red Wind Blackbird,16-23,0,0,0,0,NaN,NaN
6,0.900,Red Wind Blackbird,23-5,0,0,0,0,NaN,NaN
6,0.900,Tree Swallow,16-23,0,1,0,1,0.000,0.000
6,0.900,Tree Swallow,23-5,0,1,0,1,0.000,0.000
6,0.900,Turkey Vulture,16-23,0,0,0,0,NaN,NaN
6,0.900,Turkey Vulture,23-5,0,0,0,0,NaN,NaN
6,0.900,Dg,16-23,8,16,0,24,33.333,33.333
6,0.900,Dg,23-5,30,30,0,60,50.000,50.000
6,0.900,Western Kingbird,16-23,0,0,0,0,NaN,NaN
6,0.900,Western Kingbird,23-5,0,0,0,0,NaN,NaN
6,0.900,White Crowned Sparrow,16-23,1,6,0,7,14.286,14.286
6,0.900,White Crowned Sparrow,23-5,3,10,0,13,23.077,23.077
6,0.900,Eared Grebe,16-23,0,0,0,0,NaN,NaN
6,0.900,Eared Grebe,23-5,2,18,0,20,10.000,10.000
6,0.900,cougar,16-23,0,0,0,0,NaN,NaN
6,0.900,cougar,23-5,0,0,0,0,NaN,NaN
6,0.900,Ocean Water,16-23,0,0,0,0,NaN,NaN
6,0.900,Ocean Water,23-5,0,0,0,0,NaN,NaN
6,0.900,Red Tailed Hawk,16-23,0,3,0,3,0.000,0.000
6,0.900,Red Tailed Hawk,23-5,0,9,0,9,0.000,0.000
6,0.900,Dog,16-23,72,81,0,153,47.059,47.059
6,0.900,Dog,23-5,118,131,0,249,47.390,47.390
6,0.900,Human,16-23,1758,635,0,2393,73.464,73.464
6,0.900,Human,23-5,2220,512,0,2732,81.259,81.259
6,0.900,Wild Turkey,16-23,13,24,0,37,35.135,35.135
6,0.900,Wild Turkey,23-5,2,31,0,33,6.061,6.061
6,0.900,Clark Grebe,16-23,0,0,0,0,NaN,NaN
6,0.900,Clark Grebe,23-5,0,1,0,1,0.000,0.000
6,0.900,Seagull,16-23,0,0,0,0,NaN,NaN
6,0.900,Seagull,23-5,46,7,0,53,86.792,86.792
6,0.900,Surf Scoter,16-23,0,0,0,0,NaN,NaN
6,0.900,Surf Scoter,23-5,0,2,0,2,0.000,0.000
6,0.900,Pigeon,16-23,113,175,0,288,39.236,39.236
6,0.900,Pigeon,23-5,151,260,0,411,36.740,36.740
6,0.900,Pacific Ocean Water,16-23,0,0,0,0,NaN,NaN
6,0.900,Pacific Ocean Water,23-5,0,0,0,0,NaN,NaN
6,0.900,Cat,16-23,28,36,0,64,43.750,43.750
6,0.900,Cat,23-5,37,38,0,75,49.333,49.333
6,0.900,Horse,16-23,10,21,0,31,32.258,32.258
6,0.900,Horse,23-5,35,188,0,223,15.695,15.695
6,0.900,orangutan,16-23,0,0,0,0,NaN,NaN
6,0.900,orangutan,23-5,0,0,0,0,NaN,NaN
6,0.900,Bat,16-23,36,20,0,56,64.286,64.286
6,0.900,Bat,23-5,37,24,0,61,60.656,60.656
6,0.900,Deer,16-23,16,20,0,36,44.444,44.444
6,0.900,Deer,23-5,18,86,0,104,17.308,17.308
6,0.900,Great Horned Owl,16-23,0,0,0,0,NaN,NaN
6,0.900,Great Horned Owl,23-5,0,6,0,6,0.000,0.000
6,0.900,Freshwater Lagoon,16-23,0,0,0,0,NaN,NaN
6,0.900,Freshwater Lagoon,23-5,0,0,0,0,NaN,NaN
6,0.900,Unknown Avian,16-23,0,0,0,0,NaN,NaN
6,0.900,Unknown Avian,23-5,0,0,0,0,NaN,NaN
6,0.900,Human UTI,16-23,83,76,0,159,52.201,52.201
6,0.900,Human UTI,23-5,111,96,0,207,53.623,53.623
6,0.900,unknown,16-23,0,3,0,3,0.000,0.000
6,0.900,unknown,23-5,2,6,0,8,25.000,25.000
6,0.900,SLO Creek Water,16-23,0,0,0,0,NaN,NaN
6,0.900,SLO Creek Water,23-5,0,0,0,0,NaN,NaN
6,0.900,Pig/Swine,16-23,14,11,0,25,56.000,56.000
6,0.900,Pig/Swine,23-5,13,9,0,22,59.091,59.091
6,0.900,Klebsiella,16-23,0,0,0,0,NaN,NaN
6,0.900,Klebsiella,23-5,0,0,0,0,NaN,NaN
6,0.900,Hu Cw and Dg,16-23,10,23,0,33,30.303,30.303
6,0.900,Hu Cw and Dg,23-5,18,27,0,45,40.000,40.000
6,0.900,Ground Squirrel,16-23,104,80,0,184,56.522,56.522
6,0.900,Ground Squirrel,23-5,90,84,0,174,51.724,51.724
6,0.900,Opossum,16-23,0,2,0,2,0.000,0.000
6,0.900,Opossum,23-5,0,8,0,8,0.000,0.000
6,0.900,Cow,16-23,1530,971,0,2501,61.176,61.176
6,0.900,Cow,23-5,1481,1216,0,2697,54.913,54.913
6,0.900,Deer Mouse,16-23,0,0,0,0,NaN,NaN
6,0.900,Deer Mouse,23-5,0,0,0,0,NaN,NaN
6,0.900,OVERALL,16-23,3933,2411,0,6344,61.996,61.996
6,0.900,OVERALL,23-5,4598,3004,0,7602,60.484,60.484
6,0.950,Chicken,16-23,4,14,0,18,22.222,22.222
6,0.950,Chicken,23-5,12,11,0,23,52.174,52.174
6,0.950,Sea Lion,16-23,0,1,0,1,0.000,0.000
6,0.950,Sea Lion,23-5,4,8,0,12,33.333,33.333
6,0.950,Hu and Cw,16-23,8,18,0,26,30.769,30.769
6,0.950,Hu and Cw,23-5,8,21,0,29,27.586,27.586
6,0.950,Sheep,16-23,60,52,0,112,53.571,53.571
6,0.950,Sheep,23-5,71,39,0,110,64.545,64.545
6,0.950,Hu and Dg,16-23,10,18,0,28,35.714,35.714
6,0.950,Hu and Dg,23-5,19,14,0,33,57.576,57.576
6,0.950,Common Loon,16-23,0,0,0,0,NaN,NaN
6,0.950,Common Loon,23-5,0,4,0,4,0.000,0.000
6,0.950,Red-Winged Blackbird,16-23,0,12,0,12,0.000,0.000
6,0.950,Red-Winged Blackbird,23-5,0,6,0,6,0.000,0.000
6,0.950,Cw,16-23,12,12,0,24,50.000,50.000
6,0.950,Cw,23-5,25,45,0,70,35.714,35.714
6,0.950,Cliff Sparrow,16-23,3,32,0,35,8.571,8.571
6,0.950,Cliff Sparrow,23-5,2,7,0,9,22.222,22.222
6,0.950,Pig,16-23,13,8,0,21,61.905,61.905
6,0.950,Pig,23-5,4,12,0,16,25.000,25.000
6,0.950,Barn Owl,16-23,0,0,0,0,NaN,NaN
6,0.950,Barn Owl,23-5,0,0,0,0,NaN,NaN
6,0.950,Wild Pig,16-23,6,3,0,9,66.667,66.667
6,0.950,Wild Pig,23-5,4,3,0,7,57.143,57.143
6,0.950,Pennington Creek Water,16-23,0,0,0,0,NaN,NaN
6,0.950,Pennington Creek Water,23-5,0,0,0,0,NaN,NaN
6,0.950,Guinni,16-23,0,0,0,0,NaN,NaN
6,0.950,Guinni,23-5,0,0,0,0,NaN,NaN
6,0.950,Racoon,16-23,0,3,0,3,0.000,0.000
6,0.950,Racoon,23-5,0,0,0,0,NaN,NaN
6,0.950,Hu,16-23,17,18,0,35,48.571,48.571
6,0.950,Hu,23-5,19,10,0,29,65.517,65.517
6,0.950,Cw and Dg,16-23,4,16,0,20,20.000,20.000
6,0.950,Cw and Dg,23-5,16,23,0,39,41.026,41.026
6,0.950,Red Wind Blackbird,16-23,0,0,0,0,NaN,NaN
6,0.950,Red Wind Blackbird,23-5,0,0,0,0,NaN,NaN
6,0.950,Tree Swallow,16-23,0,1,0,1,0.000,0.000
6,0.950,Tree Swallow,23-5,0,1,0,1,0.000,0.000
6,0.950,Turkey Vulture,16-23,0,0,0,0,NaN,NaN
6,0.950,Turkey Vulture,23-5,0,0,0,0,NaN,NaN
6,0.950,Dg,16-23,8,16,0,24,33.333,33.333
6,0.950,Dg,23-5,30,30,0,60,50.000,50.000
6,0.950,Western Kingbird,16-23,0,0,0,0,NaN,NaN
6,0.950,Western Kingbird,23-5,0,0,0,0,NaN,NaN
6,0.950,White Crowned Sparrow,16-23,1,6,0,7,14.286,14.286
6,0.950,White Crowned Sparrow,23-5,3,10,0,13,23.077,23.077
6,0.950,Eared Grebe,16-23,0,0,0,0,NaN,NaN
6,0.950,Eared Grebe,23-5,2,18,0,20,10.000,10.000
6,0.950,cougar,16-23,0,0,0,0,NaN,NaN
6,0.950,cougar,23-5,0,0,0,0,NaN,NaN
6,0.950,Ocean Water,16-23,0,0,0,0,NaN,NaN
6,0.950,Ocean Water,23-5,0,0,0,0,NaN,NaN
6,0.950,Red Tailed Hawk,16-23,0,3,0,3,0.000,0.000
6,0.950,Red Tailed Hawk,23-5,0,9,0,9,0.000,0.000
6,0.950,Dog,16-23,72,81,0,153,47.059,47.059
6,0.950,Dog,23-5,118,130,0,248,47.581,47.581
6,0.950,Human,16-23,1758,635,0,2393,73.464,73.464
6,0.950,Human,23-5,2222,507,0,2729,81.422,81.422
6,0.950,Wild Turkey,16-23,13,24,0,37,35.135,35.135
6,0.950,Wild Turkey,23-5,2,31,0,33,6.061,6.061
6,0.950,Clark Grebe,16-23,0,0,0,0,NaN,NaN
6,0.950,Clark Grebe,23-5,0,1,0,1,0.000,0.000
6,0.950,Seagull,16-23,0,0,0,0,NaN,NaN
6,0.950,Seagull,23-5,46,6,0,52,88.462,88.462
6,0.950,Surf Scoter,16-23,0,0,0,0,NaN,NaN
6,0.950,Surf Scoter,23-5,0,1,0,1,0.000,0.000
6,0.950,Pigeon,16-23,113,175,0,288,39.236,39.236
6,0.950,Pigeon,23-5,151,261,0,412,36.650,36.650
6,0.950,Pacific Ocean Water,16-23,0,0,0,0,NaN,NaN
6,0.950,Pacific Ocean Water,23-5,0,0,0,0,NaN,NaN
6,0.950,Cat,16-23,28,36,0,64,43.750,43.750
6,0.950,Cat,23-5,37,38,0,75,49.333,49.333
6,0.950,Horse,16-23,10,21,0,31,32.258,32.258
6,0.950,Horse,23-5,35,188,0,223,15.695,15.695
6,0.950,orangutan,16-23,0,0,0,0,NaN,NaN
6,0.950,orangutan,23-5,0,0,0,0,NaN,NaN
6,0.950,Bat,16-23,36,20,0,56,64.286,64.286
6,0.950,Bat,23-5,37,23,0,60,61.667,61.667
6,0.950,Deer,16-23,16,20,0,36,44.444,44.444
6,0.950,Deer,23-5,18,86,0,104,17.308,17.308
6,0.950,Great Horned Owl,16-23,0,0,0,0,NaN,NaN
6,0.950,Great Horned Owl,23-5,0,6,0,6,0.000,0.000
6,0.950,Freshwater Lagoon,16-23,0,0,0,0,NaN,NaN
6,0.950,Freshwater Lagoon,23-5,0,0,0,0,NaN,NaN
6,0.950,Unknown Avian,16-23,0,0,0,0,NaN,NaN
6,0.950,Unknown Avian,23-5,0,0,0,0,NaN,NaN
6,0.950,Human UTI,16-23,86,76,0,162,53.086,53.086
6,0.950,Human UTI,23-5,110,97,0,207,53.140,53.140
6,0.950,unknown,16-23,0,3,0,3,0.000,0.000
6,0.950,unknown,23-5,2,6,0,8,25.000,25.000
6,0.950,SLO Creek Water,16-23,0,0,0,0,NaN,NaN
6,0.950,SLO Creek Water,23-5,0,0,0,0,NaN,NaN
6,0.950,Pig/Swine,16-23,14,11,0,25,56.000,56.000
6,0.950,Pig/Swine,23-5,13,9,0,22,59.091,59.091
6,0.950,Klebsiella,16-23,0,0,0,0,NaN,NaN
6,0.950,Klebsiella,23-5,0,0,0,0,NaN,NaN
6,0.950,Hu Cw and Dg,16-23,10,23,0,33,30.303,30.303
6,0.950,Hu Cw and Dg,23-5,18,27,0,45,40.000,40.000
6,0.950,Ground Squirrel,16-23,104,80,0,184,56.522,56.522
6,0.950,Ground Squirrel,23-5,90,83,0,173,52.023,52.023
6,0.950,Opossum,16-23,0,2,0,2,0.000,0.000
6,0.950,Opossum,23-5,0,8,0,8,0.000,0.000
6,0.950,Cow,16-23,1530,951,0,2481,61.669,61.669
6,0.950,Cow,23-5,1480,1213,0,2693,54.957,54.957
6,0.950,Deer Mouse,16-23,0,0,0,0,NaN,NaN
6,0.950,Deer Mouse,23-5,0,0,0,0,NaN,NaN
6,0.950,OVERALL,16-23,3936,2391,0,6327,62.210,62.210
6,0.950,OVERALL,23-5,4598,2992,0,7590,60.580,60.580
6,0.960,Chicken,16-23,4,14,0,18,22.222,22.222
6,0.960,Chicken,23-5,12,11,0,23,52.174,52.174
6,0.960,Sea Lion,16-23,0,1,0,1,0.000,0.000
6,0.960,Sea Lion,23-5,4,8,0,12,33.333,33.333
6,0.960,Hu and Cw,16-23,8,18,0,26,30.769,30.769
6,0.960,Hu and Cw,23-5,8,21,0,29,27.586,27.586
6,0.960,Sheep,16-23,60,52,0,112,53.571,53.571
6,0.960,Sheep,23-5,71,40,0,111,63.964,63.964
6,0.960,Hu and Dg,16-23,10,18,0,28,35.714,35.714
6,0.960,Hu and Dg,23-5,19,14,0,33,57.576,57.576
6,0.960,Common Loon,16-23,0,0,0,0,NaN,NaN
6,0.960,Common Loon,23-5,0,4,0,4,0.000,0.000
6,0.960,Red-Winged Blackbird,16-23,0,12,0,12,0.000,0.000
6,0.960,Red-Winged Blackbird,23-5,0,6,0,6,0.000,0.000
6,0.960,Cw,16-23,12,12,0,24,50.000,50.000
6,0.960,Cw,23-5,25,45,0,70,35.714,35.714
6,0.960,Cliff Sparrow,16-23,3,32,0,35,8.571,8.571
6,0.960,Cliff Sparrow,23-5,2,7,0,9,22.222,22.222
6,0.960,Pig,16-23,13,8,0,21,61.905,61.905
6,0.960,Pig,23-5,4,12,0,16,25.000,25.000
6,0.960,Barn Owl,16-23,0,0,0,0,NaN,NaN
6,0.960,Barn Owl,23-5,0,0,0,0,NaN,NaN
6,0.960,Wild Pig,16-23,6,3,0,9,66.667,66.667
6,0.960,Wild Pig,23-5,5,3,0,8,62.500,62.500
6,0.960,Pennington Creek Water,16-23,0,0,0,0,NaN,NaN
6,0.960,Pennington Creek Water,23-5,0,0,0,0,NaN,NaN
6,0.960,Guinni,16-23,0,0,0,0,NaN,NaN
6,0.960,Guinni,23-5,0,0,0,0,NaN,NaN
6,0.960,Racoon,16-23,0,3,0,3,0.000,0.000
6,0.960,Racoon,23-5,0,0,0,0,NaN,NaN
6,0.960,Hu,16-23,17,18,0,35,48.571,48.571
6,0.960,Hu,23-5,19,10,0,29,65.517,65.517
6,0.960,Cw and Dg,16-23,4,16,0,20,20.000,20.000
6,0.960,Cw and Dg,23-5,16,23,0,39,41.026,41.026
6,0.960,Red Wind Blackbird,16-23,0,0,0,0,NaN,NaN
6,0.960,Red Wind Blackbird,23-5,0,0,0,0,NaN,NaN
6,0.960,Tree Swallow,16-23,0,1,0,1,0.000,0.000
6,0.960,Tree Swallow,23-5,0,1,0,1,0.000,0.000
6,0.960,Turkey Vulture,16-23,0,0,0,0,NaN,NaN
6,0.960,Turkey Vulture,23-5,0,0,0,0,NaN,NaN
6,0.960,Dg,16-23,8,16,0,24,33.333,33.333
6,0.960,Dg,23-5,30,30,0,60,50.000,50.000
6,0.960,Western Kingbird,16-23,0,0,0,0,NaN,NaN
6,0.960,Western Kingbird,23-5,0,0,0,0,NaN,NaN
6,0.960,White Crowned Sparrow,16-23,1,6,0,7,14.286,14.286
6,0.960,White Crowned Sparrow,23-5,3,10,0,13,23.077,23.077
6,0.960,Eared Grebe,16-23,0,0,0,0,NaN,NaN
6,0.960,Eared Grebe,23-5,2,18,0,20,10.000,10.000
6,0.960,cougar,16-23,0,0,0,0,NaN,NaN
6,0.960,cougar,23-5,0,0,0,0,NaN,NaN
6,0.960,Ocean Water,16-23,0,0,0,0,NaN,NaN
6,0.960,Ocean Water,23-5,0,0,0,0,NaN,NaN
6,0.960,Red Tailed Hawk,16-23,0,3,0,3,0.000,0.000
6,0.960,Red Tailed Hawk,23-5,0,9,0,9,0.000,0.000
6,0.960,Dog,16-23,72,81,0,153,47.059,47.059
6,0.960,Dog,23-5,118,127,0,245,48.163,48.163
6,0.960,Human,16-23,1758,634,0,2392,73.495,73.495
6,0.960,Human,23-5,2222,494,0,2716,81.811,81.811
6,0.960,Wild Turkey,16-23,13,24,0,37,35.135,35.135
6,0.960,Wild Turkey,23-5,2,34,0,36,5.556,5.556
6,0.960,Clark Grebe,16-23,0,0,0,0,NaN,NaN
6,0.960,Clark Grebe,23-5,0,1,0,1,0.000,0.000
6,0.960,Seagull,16-23,0,0,0,0,NaN,NaN
6,0.960,Seagull,23-5,46,7,0,53,86.792,86.792
6,0.960,Surf Scoter,16-23,0,0,0,0,NaN,NaN
6,0.960,Surf Scoter,23-5,0,2,0,2,0.000,0.000
6,0.960,Pigeon,16-23,112,175,0,287,39.024,39.024
6,0.960,Pigeon,23-5,152,274,0,426,35.681,35.681
6,0.960,Pacific Ocean Water,16-23,0,0,0,0,NaN,NaN
6,0.960,Pacific Ocean Water,23-5,0,0,0,0,NaN,NaN
6,0.960,Cat,16-23,28,36,0,64,43.750,43.750
6,0.960,Cat,23-5,37,38,0,75,49.333,49.333
6,0.960,Horse,16-23,10,21,0,31,32.258,32.258
6,0.960,Horse,23-5,35,188,0,223,15.695,15.695
6,0.960,orangutan,16-23,0,0,0,0,NaN,NaN
6,0.960,orangutan,23-5,0,0,0,0,NaN,NaN
6,0.960,Bat,16-23,36,20,0,56,64.286,64.286
6,0.960,Bat,23-5,37,23,0,60,61.667,61.667
6,0.960,Deer,16-23,16,20,0,36,44.444,44.444
6,0.960,Deer,23-5,18,86,0,104,17.308,17.308
6,0.960,Great Horned Owl,16-23,0,0,0,0,NaN,NaN
6,0.960,Great Horned Owl,23-5,0,6,0,6,0.000,0.000
6,0.960,Freshwater Lagoon,16-23,0,0,0,0,NaN,NaN
6,0.960,Freshwater Lagoon,23-5,0,0,0,0,NaN,NaN
6,0.960,Unknown Avian,16-23,0,0,0,0,NaN,NaN
6,0.960,Unknown Avian,23-5,0,0,0,0,NaN,NaN
6,0.960,Human UTI,16-23,86,76,0,162,53.086,53.086
6,0.960,Human UTI,23-5,110,96,0,206,53.398,53.398
6,0.960,unknown,16-23,0,3,0,3,0.000,0.000
6,0.960,unknown,23-5,2,6,0,8,25.000,25.000
6,0.960,SLO Creek Water,16-23,0,0,0,0,NaN,NaN
6,0.960,SLO Creek Water,23-5,0,0,0,0,NaN,NaN
6,0.960,Pig/Swine,16-23,14,11,0,25,56.000,56.000
6,0.960,Pig/Swine,23-5,13,9,0,22,59.091,59.091
6,0.960,Klebsiella,16-23,0,0,0,0,NaN,NaN
6,0.960,Klebsiella,23-5,0,0,0,0,NaN,NaN
6,0.960,Hu Cw and Dg,16-23,10,23,0,33,30.303,30.303
6,0.960,Hu Cw and Dg,23-5,18,27,0,45,40.000,40.000
6,0.960,Ground Squirrel,16-23,104,80,0,184,56.522,56.522
6,0.960,Ground Squirrel,23-5,90,84,0,174,51.724,51.724
6,0.960,Opossum,16-23,0,2,0,2,0.000,0.000
6,0.960,Opossum,23-5,0,8,0,8,0.000,0.000
6,0.960,Cow,16-23,1528,944,0,2472,61.812,61.812
6,0.960,Cow,23-5,1480,1198,0,2678,55.265,55.265
6,0.960,Deer Mouse,16-23,0,0,0,0,NaN,NaN
6,0.960,Deer Mouse,23-5,0,0,0,0,NaN,NaN
6,0.960,OVERALL,16-23,3933,2383,0,6316,62.270,62.270
6,0.960,OVERALL,23-5,4600,2980,0,7580,60.686,60.686
6,0.970,Chicken,16-23,4,14,0,18,22.222,22.222
6,0.970,Chicken,23-5,12,11,0,23,52.174,52.174
6,0.970,Sea Lion,16-23,0,1,0,1,0.000,0.000
6,0.970,Sea Lion,23-5,4,8,0,12,33.333,33.333
6,0.970,Hu and Cw,16-23,8,18,0,26,30.769,30.769
6,0.970,Hu and Cw,23-5,8,21,0,29,27.586,27.586
6,0.970,Sheep,16-23,60,53,0,113,53.097,53.097
6,0.970,Sheep,23-5,71,39,0,110,64.545,64.545
6,0.970,Hu and Dg,16-23,10,18,0,28,35.714,35.714
6,0.970,Hu and Dg,23-5,19,14,0,33,57.576,57.576
6,0.970,Common Loon,16-23,0,0,0,0,NaN,NaN
6,0.970,Common Loon,23-5,0,4,0,4,0.000,0.000
6,0.970,Red-Winged Blackbird,16-23,0,12,0,12,0.000,0.000
6,0.970,Red-Winged Blackbird,23-5,0,6,0,6,0.000,0.000
6,0.970,Cw,16-23,12,13,0,25,48.000,48.000
6,0.970,Cw,23-5,25,45,0,70,35.714,35.714
6,0.970,Cliff Sparrow,16-23,3,32,0,35,8.571,8.571
6,0.970,Cliff Sparrow,23-5,2,7,0,9,22.222,22.222
6,0.970,Pig,16-23,13,8,0,21,61.905,61.905
6,0.970,Pig,23-5,4,12,0,16,25.000,25.000
6,0.970,Barn Owl,16-23,0,0,0,0,NaN,NaN
6,0.970,Barn Owl,23-5,0,0,0,0,NaN,NaN
6,0.970,Wild Pig,16-23,6,3,0,9,66.667,66.667
6,0.970,Wild Pig,23-5,4,3,0,7,57.143,57.143
6,0.970,Pennington Creek Water,16-23,0,0,0,0,NaN,NaN
6,0.970,Pennington Creek Water,23-5,0,0,0,0,NaN,NaN
6,0.970,Guinni,16-23,0,0,0,0,NaN,NaN
6,0.970,Guinni,23-5,0,0,0,0,NaN,NaN
6,0.970,Racoon,16-23,0,3,0,3,0.000,0.000
6,0.970,Racoon,23-5,0,0,0,0,NaN,NaN
6,0.970,Hu,16-23,17,18,0,35,48.571,48.571
6,0.970,Hu,23-5,19,10,0,29,65.517,65.517
6,0.970,Cw and Dg,16-23,4,16,0,20,20.000,20.000
6,0.970,Cw and Dg,23-5,16,23,0,39,41.026,41.026
6,0.970,Red Wind Blackbird,16-23,0,0,0,0,NaN,NaN
6,0.970,Red Wind Blackbird,23-5,0,0,0,0,NaN,NaN
6,0.970,Tree Swallow,16-23,0,1,0,1,0.000,0.000
6,0.970,Tree Swallow,23-5,0,1,0,1,0.000,0.000
6,0.970,Turkey Vulture,16-23,0,0,0,0,NaN,NaN
6,0.970,Turkey Vulture,23-5,0,0,0,0,NaN,NaN
6,0.970,Dg,16-23,8,16,0,24,33.333,33.333
6,0.970,Dg,23-5,30,29,0,59,50.847,50.847
6,0.970,Western Kingbird,16-23,0,0,0,0,NaN,NaN
6,0.970,Western Kingbird,23-5,0,0,0,0,NaN,NaN
6,0.970,White Crowned Sparrow,16-23,1,6,0,7,14.286,14.286
6,0.970,White Crowned Sparrow,23-5,3,10,0,13,23.077,23.077
6,0.970,Eared Grebe,16-23,0,0,0,0,NaN,NaN
6,0.970,Eared Grebe,23-5,2,18,0,20,10.000,10.000
6,0.970,cougar,16-23,0,0,0,0,NaN,NaN
6,0.970,cougar,23-5,0,0,0,0,NaN,NaN
6,0.970,Ocean Water,16-23,0,0,0,0,NaN,NaN
6,0.970,Ocean Water,23-5,0,0,0,0,NaN,NaN
6,0.970,Red Tailed Hawk,16-23,0,3,0,3,0.000,0.000
6,0.970,Red Tailed Hawk,23-5,0,9,0,9,0.000,0.000
6,0.970,Dog,16-23,72,81,0,153,47.059,47.059
6,0.970,Dog,23-5,118,126,0,244,48.361,48.361
6,0.970,Human,16-23,1756,633,0,2389,73.504,73.504
6,0.970,Human,23-5,2220,493,0,2713,81.828,81.828
6,0.970,Wild Turkey,16-23,13,25,0,38,34.211,34.211
6,0.970,Wild Turkey,23-5,4,33,0,37,10.811,10.811
6,0.970,Clark Grebe,16-23,0,0,0,0,NaN,NaN
6,0.970,Clark Grebe,23-5,0,1,0,1,0.000,0.000
6,0.970,Seagull,16-23,0,0,0,0,NaN,NaN
6,0.970,Seagull,23-5,46,8,0,54,85.185,85.185
6,0.970,Surf Scoter,16-23,0,0,0,0,NaN,NaN
6,0.970,Surf Scoter,23-5,0,2,0,2,0.000,0.000
6,0.970,Pigeon,16-23,110,174,0,284,38.732,38.732
6,0.970,Pigeon,23-5,152,292,0,444,34.234,34.234
6,0.970,Pacific Ocean Water,16-23,0,0,0,0,NaN,NaN
6,0.970,Pacific Ocean Water,23-5,0,0,0,0,NaN,NaN
6,0.970,Cat,16-23,28,36,0,64,43.750,43.750
6,0.970,Cat,23-5,37,38,0,75,49.333,49.333
6,0.970,Horse,16-23,10,21,0,31,32.258,32.258
6,0.970,Horse,23-5,35,188,0,223,15.695,15.695
6,0.970,orangutan,16-23,0,0,0,0,NaN,NaN
6,0.970,orangutan,23-5,0,0,0,0,NaN,NaN
6,0.970,Bat,16-23,36,20,0,56,64.286,64.286
6,0.970,Bat,23-5,37,23,0,60,61.667,61.667
6,0.970,Deer,16-23,16,20,0,36,44.444,44.444
6,0.970,Deer,23-5,18,86,0,104,17.308,17.308
6,0.970,Great Horned Owl,16-23,0,0,0,0,NaN,NaN
6,0.970,Great Horned Owl,23-5,0,6,0,6,0.000,0.000
6,0.970,Freshwater Lagoon,16-23,0,0,0,0,NaN,NaN
6,0.970,Freshwater Lagoon,23-5,0,0,0,0,NaN,NaN
6,0.970,Unknown Avian,16-23,0,0,0,0,NaN,NaN
6,0.970,Unknown Avian,23-5,0,0,0,0,NaN,NaN
6,0.970,Human UTI,16-23,86,77,0,163,52.761,52.761
6,0.970,Human UTI,23-5,109,95,0,204,53.431,53.431
6,0.970,unknown,16-23,0,3,0,3,0.000,0.000
6,0.970,unknown,23-5,2,6,0,8,25.000,25.000
6,0.970,SLO Creek Water,16-23,0,0,0,0,NaN,NaN
6,0.970,SLO Creek Water,23-5,0,0,0,0,NaN,NaN
6,0.970,Pig/Swine,16-23,14,11,0,25,56.000,56.000
6,0.970,Pig/Swine,23-5,13,9,0,22,59.091,59.091
6,0.970,Klebsiella,16-23,0,0,0,0,NaN,NaN
6,0.970,Klebsiella,23-5,0,0,0,0,NaN,NaN
6,0.970,Hu Cw and Dg,16-23,10,23,0,33,30.303,30.303
6,0.970,Hu Cw and Dg,23-5,18,27,0,45,40.000,40.000
6,0.970,Ground Squirrel,16-23,103,76,0,179,57.542,57.542
6,0.970,Ground Squirrel,23-5,90,82,0,172,52.326,52.326
6,0.970,Opossum,16-23,0,2,0,2,0.000,0.000
6,0.970,Opossum,23-5,0,8,0,8,0.000,0.000
6,0.970,Cow,16-23,1523,946,0,2469,61.685,61.685
6,0.970,Cow,23-5,1477,1173,0,2650,55.736,55.736
6,0.970,Deer Mouse,16-23,0,0,0,0,NaN,NaN
6,0.970,Deer Mouse,23-5,0,0,0,0,NaN,NaN
6,0.970,OVERALL,16-23,3923,2383,0,6306,62.211,62.211
6,0.970,OVERALL,23-5,4595,2966,0,7561,60.772,60.772
6,0.980,Chicken,16-23,4,14,0,18,22.222,22.222
6,0.980,Chicken,23-5,13,10,0,23,56.522,56.522
6,0.980,Sea Lion,16-23,0,1,0,1,0.000,0.000
6,0.980,Sea Lion,23-5,4,7,0,11,36.364,36.364
6,0.980,Hu and Cw,16-23,8,18,0,26,30.769,30.769
6,0.980,Hu and Cw,23-5,8,30,0,38,21.053,21.053
6,0.980,Sheep,16-23,60,51,0,111,54.054,54.054
6,0.980,Sheep,23-5,70,38,0,108,64.815,64.815
6,0.980,Hu and Dg,16-23,10,18,0,28,35.714,35.714
6,0.980,Hu and Dg,23-5,19,12,0,31,61.290,61.290
6,0.980,Common Loon,16-23,0,0,0,0,NaN,NaN
6,0.980,Common Loon,23-5,0,4,0,4,0.000,0.000
6,0.980,Red-Winged Blackbird,16-23,0,12,0,12,0.000,0.000
6,0.980,Red-Winged Blackbird,23-5,0,6,0,6,0.000,0.000
6,0.980,Cw,16-23,12,12,0,24,50.000,50.000
6,0.980,Cw,23-5,25,46,0,71,35.211,35.211
6,0.980,Cliff Sparrow,16-23,3,30,0,33,9.091,9.091
6,0.980,Cliff Sparrow,23-5,2,7,0,9,22.222,22.222
6,0.980,Pig,16-23,13,8,0,21,61.905,61.905
6,0.980,Pig,23-5,4,12,0,16,25.000,25.000
6,0.980,Barn Owl,16-23,0,0,0,0,NaN,NaN
6,0.980,Barn Owl,23-5,0,0,0,0,NaN,NaN
6,0.980,Wild Pig,16-23,6,3,0,9,66.667,66.667
6,0.980,Wild Pig,23-5,4,2,0,6,66.667,66.667
6,0.980,Pennington Creek Water,16-23,0,0,0,0,NaN,NaN
6,0.980,Pennington Creek Water,23-5,0,0,0,0,NaN,NaN
6,0.980,Guinni,16-23,0,0,0,0,NaN,NaN
6,0.980,Guinni,23-5,0,0,0,0,NaN,NaN
6,0.980,Racoon,16-23,0,3,0,3,0.000,0.000
6,0.980,Racoon,23-5,0,0,0,0,NaN,NaN
6,0.980,Hu,16-23,17,18,0,35,48.571,48.571
6,0.980,Hu,23-5,19,11,0,30,63.333,63.333
6,0.980,Cw and Dg,16-23,4,16,0,20,20.000,20.000
6,0.980,Cw and Dg,23-5,16,22,0,38,42.105,42.105
6,0.980,Red Wind Blackbird,16-23,0,0,0,0,NaN,NaN
6,0.980,Red Wind Blackbird,23-5,0,0,0,0,NaN,NaN
6,0.980,Tree Swallow,16-23,0,1,0,1,0.000,0.000
6,0.980,Tree Swallow,23-5,0,1,0,1,0.000,0.000
6,0.980,Turkey Vulture,16-23,0,0,0,0,NaN,NaN
6,0.980,Turkey Vulture,23-5,0,0,0,0,NaN,NaN
6,0.980,Dg,16-23,8,16,0,24,33.333,33.333
6,0.980,Dg,23-5,30,24,0,54,55.556,55.556
6,0.980,Western Kingbird,16-23,0,0,0,0,NaN,NaN
6,0.980,Western Kingbird,23-5,0,0,0,0,NaN,NaN
6,0.980,White Crowned Sparrow,16-23,1,5,0,6,16.667,16.667
6,0.980,White Crowned Sparrow,23-5,3,10,0,13,23.077,23.077
6,0.980,Eared Grebe,16-23,0,0,0,0,NaN,NaN
6,0.980,Eared Grebe,23-5,2,18,0,20,10.000,10.000
6,0.980,cougar,16-23,0,0,0,0,NaN,NaN
6,0.980,cougar,23-5,0,0,0,0,NaN,NaN
6,0.980,Ocean Water,16-23,0,0,0,0,NaN,NaN
6,0.980,Ocean Water,23-5,0,0,0,0,NaN,NaN
6,0.980,Red Tailed Hawk,16-23,0,3,0,3,0.000,0.000
6,0.980,Red Tailed Hawk,23-5,0,8,0,8,0.000,0.000
6,0.980,Dog,16-23,71,84,0,155,45.806,45.806
6,0.980,Dog,23-5,118,124,0,242,48.760,48.760
6,0.980,Human,16-23,1759,625,0,2384,73.784,73.784
6,0.980,Human,23-5,2222,484,0,2706,82.114,82.114
6,0.980,Wild Turkey,16-23,13,25,0,38,34.211,34.211
6,0.980,Wild Turkey,23-5,6,37,0,43,13.953,13.953
6,0.980,Clark Grebe,16-23,0,0,0,0,NaN,NaN
6,0.980,Clark Grebe,23-5,0,1,0,1,0.000,0.000
6,0.980,Seagull,16-23,0,0,0,0,NaN,NaN
6,0.980,Seagull,23-5,48,6,0,54,88.889,88.889
6,0.980,Surf Scoter,16-23,0,0,0,0,NaN,NaN
6,0.980,Surf Scoter,23-5,2,0,0,2,100.000,100.000
6,0.980,Pigeon,16-23,110,173,0,283,38.869,38.869
6,0.980,Pigeon,23-5,151,297,0,448,33.705,33.705
6,0.980,Pacific Ocean Water,16-23,0,0,0,0,NaN,NaN
6,0.980,Pacific Ocean Water,23-5,0,0,0,0,NaN,NaN
6,0.980,Cat,16-23,28,32,0,60,46.667,46.667
6,0.980,Cat,23-5,37,36,0,73,50.685,50.685
6,0.980,Horse,16-23,10,21,0,31,32.258,32.258
6,0.980,Horse,23-5,35,185,0,220,15.909,15.909
6,0.980,orangutan,16-23,0,0,0,0,NaN,NaN
6,0.980,orangutan,23-5,0,0,0,0,NaN,NaN
6,0.980,Bat,16-23,36,20,0,56,64.286,64.286
6,0.980,Bat,23-5,37,22,0,59,62.712,62.712
6,0.980,Deer,16-23,16,20,0,36,44.444,44.444
6,0.980,Deer,23-5,18,86,0,104,17.308,17.308
6,0.980,Great Horned Owl,16-23,0,0,0,0,NaN,NaN
6,0.980,Great Horned Owl,23-5,0,6,0,6,0.000,0.000
6,0.980,Freshwater Lagoon,16-23,0,0,0,0,NaN,NaN
6,0.980,Freshwater Lagoon,23-5,0,0,0,0,NaN,NaN
6,0.980,Unknown Avian,16-23,0,0,0,0,NaN,NaN
6,0.980,Unknown Avian,23-5,0,0,0,0,NaN,NaN
6,0.980,Human UTI,16-23,86,79,0,165,52.121,52.121
6,0.980,Human UTI,23-5,109,93,0,202,53.960,53.960
6,0.980,unknown,16-23,0,3,0,3,0.000,0.000
6,0.980,unknown,23-5,2,7,0,9,22.222,22.222
6,0.980,SLO Creek Water,16-23,0,0,0,0,NaN,NaN
6,0.980,SLO Creek Water,23-5,0,0,0,0,NaN,NaN
6,0.980,Pig/Swine,16-23,14,11,0,25,56.000,56.000
6,0.980,Pig/Swine,23-5,13,9,0,22,59.091,59.091
6,0.980,Klebsiella,16-23,0,0,0,0,NaN,NaN
6,0.980,Klebsiella,23-5,0,0,0,0,NaN,NaN
6,0.980,Hu Cw and Dg,16-23,10,23,0,33,30.303,30.303
6,0.980,Hu Cw and Dg,23-5,18,25,0,43,41.860,41.860
6,0.980,Ground Squirrel,16-23,103,78,0,181,56.906,56.906
6,0.980,Ground Squirrel,23-5,90,79,0,169,53.254,53.254
6,0.980,Opossum,16-23,0,2,0,2,0.000,0.000
6,0.980,Opossum,23-5,0,8,0,8,0.000,0.000
6,0.980,Cow,16-23,1517,934,0,2451,61.893,61.893
6,0.980,Cow,23-5,1473,1151,0,2624,56.136,56.136
6,0.980,Deer Mouse,16-23,0,0,0,0,NaN,NaN
6,0.980,Deer Mouse,23-5,0,0,0,0,NaN,NaN
6,0.980,OVERALL,16-23,3919,2359,0,6278,62.424,62.424
6,0.980,OVERALL,23-5,4598,2924,0,7522,61.127,61.127
6,0.990,Chicken,16-23,4,18,0,22,18.182,18.182
6,0.990,Chicken,23-5,14,10,0,24,58.333,58.333
6,0.990,Sea Lion,16-23,0,1,0,1,0.000,0.000
6,0.990,Sea Lion,23-5,4,6,0,10,40.000,40.000
6,0.990,Hu and Cw,16-23,9,18,0,27,33.333,33.333
6,0.990,Hu and Cw,23-5,9,30,0,39,23.077,23.077
6,0.990,Sheep,16-23,59,50,0,109,54.128,54.128
6,0.990,Sheep,23-5,70,37,0,107,65.421,65.421
6,0.990,Hu and Dg,16-23,10,18,0,28,35.714,35.714
6,0.990,Hu and Dg,23-5,19,11,0,30,63.333,63.333
6,0.990,Common Loon,16-23,0,0,0,0,NaN,NaN
6,0.990,Common Loon,23-5,0,5,0,5,0.000,0.000
6,0.990,Red-Winged Blackbird,16-23,0,11,0,11,0.000,0.000
6,0.990,Red-Winged Blackbird,23-5,0,6,0,6,0.000,0.000
6,0.990,Cw,16-23,12,12,0,24,50.000,50.000
6,0.990,Cw,23-5,25,45,0,70,35.714,35.714
6,0.990,Cliff Sparrow,16-23,3,30,0,33,9.091,9.091
6,0.990,Cliff Sparrow,23-5,2,10,0,12,16.667,16.667
6,0.990,Pig,16-23,13,9,0,22,59.091,59.091
6,0.990,Pig,23-5,8,11,0,19,42.105,42.105
6,0.990,Barn Owl,16-23,0,0,0,0,NaN,NaN
6,0.990,Barn Owl,23-5,0,0,0,0,NaN,NaN
6,0.990,Wild Pig,16-23,6,4,0,10,60.000,60.000
6,0.990,Wild Pig,23-5,4,1,0,5,80.000,80.000
6,0.990,Pennington Creek Water,16-23,0,0,0,0,NaN,NaN
6,0.990,Pennington Creek Water,23-5,0,0,0,0,NaN,NaN
6,0.990,Guinni,16-23,0,0,0,0,NaN,NaN
6,0.990,Guinni,23-5,0,0,0,0,NaN,NaN
6,0.990,Racoon,16-23,0,3,0,3,0.000,0.000
6,0.990,Racoon,23-5,0,1,0,1,0.000,0.000
6,0.990,Hu,16-23,17,17,0,34,50.000,50.000
6,0.990,Hu,23-5,19,8,0,27,70.370,70.370
6,0.990,Cw and Dg,16-23,4,16,0,20,20.000,20.000
6,0.990,Cw and Dg,23-5,15,14,0,29,51.724,51.724
6,0.990,Red Wind Blackbird,16-23,0,0,0,0,NaN,NaN
6,0.990,Red Wind Blackbird,23-5,0,0,0,0,NaN,NaN
6,0.990,Tree Swallow,16-23,0,1,0,1,0.000,0.000
6,0.990,Tree Swallow,23-5,0,1,0,1,0.000,0.000
6,0.990,Turkey Vulture,16-23,0,0,0,0,NaN,NaN
6,0.990,Turkey Vulture,23-5,0,0,0,0,NaN,NaN
6,0.990,Dg,16-23,8,16,0,24,33.333,33.333
6,0.990,Dg,23-5,30,20,0,50,60.000,60.000
6,0.990,Western Kingbird,16-23,0,0,0,0,NaN,NaN
6,0.990,Western Kingbird,23-5,0,0,0,0,NaN,NaN
6,0.990,White Crowned Sparrow,16-23,1,5,0,6,16.667,16.667
6,0.990,White Crowned Sparrow,23-5,3,10,0,13,23.077,23.077
6,0.990,Eared Grebe,16-23,0,0,0,0,NaN,NaN
6,0.990,Eared Grebe,23-5,2,15,0,17,11.765,11.765
6,0.990,cougar,16-23,0,1,0,1,0.000,0.000
6,0.990,cougar,23-5,0,0,0,0,NaN,NaN
6,0.990,Ocean Water,16-23,0,0,0,0,NaN,NaN
6,0.990,Ocean Water,23-5,0,0,0,0,NaN,NaN
6,0.990,Red Tailed Hawk,16-23,0,3,0,3,0.000,0.000
6,0.990,Red Tailed Hawk,23-5,0,9,0,9,0.000,0.000
6,0.990,Dog,16-23,73,80,0,153,47.712,47.712
6,0.990,Dog,23-5,119,115,0,234,50.855,50.855
6,0.990,Human,16-23,1748,601,0,2349,74.415,74.415
6,0.990,Human,23-5,2212,450,0,2662,83.095,83.095
6,0.990,Wild Turkey,16-23,14,28,0,42,33.333,33.333
6,0.990,Wild Turkey,23-5,6,35,0,41,14.634,14.634
6,0.990,Clark Grebe,16-23,0,0,0,0,NaN,NaN
6,0.990,Clark Grebe,23-5,2,3,0,5,40.000,40.000
6,0.990,Seagull,16-23,0,0,0,0,NaN,NaN
6,0.990,Seagull,23-5,49,6,0,55,89.091,89.091
6,0.990,Surf Scoter,16-23,0,0,0,0,NaN,NaN
6,0.990,Surf Scoter,23-5,2,0,0,2,100.000,100.000
6,0.990,Pigeon,16-23,111,166,0,277,40.072,40.072
6,0.990,Pigeon,23-5,155,281,0,436,35.550,35.550
6,0.990,Pacific Ocean Water,16-23,0,0,0,0,NaN,NaN
6,0.990,Pacific Ocean Water,23-5,0,0,0,0,NaN,NaN
6,0.990,Cat,16-23,27,30,0,57,47.368,47.368
6,0.990,Cat,23-5,37,37,0,74,50.000,50.000
6,0.990,Horse,16-23,12,21,0,33,36.364,36.364
6,0.990,Horse,23-5,34,185,0,219,15.525,15.525
6,0.990,orangutan,16-23,0,0,0,0,NaN,NaN
6,0.990,orangutan,23-5,0,0,0,0,NaN,NaN
6,0.990,Bat,16-23,36,19,0,55,65.455,65.455
6,0.990,Bat,23-5,37,22,0,59,62.712,62.712
6,0.990,Deer,16-23,16,21,0,37,43.243,43.243
6,0.990,Deer,23-5,18,85,0,103,17.476,17.476
6,0.990,Great Horned Owl,16-23,0,0,0,0,NaN,NaN
6,0.990,Great Horned Owl,23-5,0,6,0,6,0.000,0.000
6,0.990,Freshwater Lagoon,16-23,0,0,0,0,NaN,NaN
6,0.990,Freshwater Lagoon,23-5,0,0,0,0,NaN,NaN
6,0.990,Unknown Avian,16-23,0,0,0,0,NaN,NaN
6,0.990,Unknown Avian,23-5,0,0,0,0,NaN,NaN
6,0.990,Human UTI,16-23,90,71,0,161,55.901,55.901
6,0.990,Human UTI,23-5,110,82,0,192,57.292,57.292
6,0.990,unknown,16-23,0,3,0,3,0.000,0.000
6,0.990,unknown,23-5,2,8,0,10,20.000,20.000
6,0.990,SLO Creek Water,16-23,0,0,0,0,NaN,NaN
6,0.990,SLO Creek Water,23-5,0,0,0,0,NaN,NaN
6,0.990,Pig/Swine,16-23,14,12,0,26,53.846,53.846
6,0.990,Pig/Swine,23-5,13,10,0,23,56.522,56.522
6,0.990,Klebsiella,16-23,0,0,0,0,NaN,NaN
6,0.990,Klebsiella,23-5,0,0,0,0,NaN,NaN
6,0.990,Hu Cw and Dg,16-23,10,23,0,33,30.303,30.303
6,0.990,Hu Cw and Dg,23-5,18,27,0,45,40.000,40.000
6,0.990,Ground Squirrel,16-23,104,74,0,178,58.427,58.427
6,0.990,Ground Squirrel,23-5,91,77,0,168,54.167,54.167
6,0.990,Opossum,16-23,1,2,0,3,33.333,33.333
6,0.990,Opossum,23-5,2,8,0,10,20.000,20.000
6,0.990,Cow,16-23,1480,859,0,2339,63.275,63.275
6,0.990,Cow,23-5,1444,1064,0,2508,57.576,57.576
6,0.990,Deer Mouse,16-23,0,0,0,0,NaN,NaN
6,0.990,Deer Mouse,23-5,0,0,0,0,NaN,NaN
6,0.990,OVERALL,16-23,3882,2243,0,6125,63.380,63.380
6,0.990,OVERALL,23-5,4575,2751,0,7326,62.449,62.449
6,1.000,Chicken,16-23,0,0,0,0,NaN,NaN
6,1.000,Chicken,23-5,0,0,0,0,NaN,NaN
6,1.000,Sea Lion,16-23,0,0,0,0,NaN,NaN
6,1.000,Sea Lion,23-5,0,0,0,0,NaN,NaN
6,1.000,Hu and Cw,16-23,0,0,0,0,NaN,NaN
6,1.000,Hu and Cw,23-5,0,0,0,0,NaN,NaN
6,1.000,Sheep,16-23,0,0,0,0,NaN,NaN
6,1.000,Sheep,23-5,0,0,0,0,NaN,NaN
6,1.000,Hu and Dg,16-23,0,0,0,0,NaN,NaN
6,1.000,Hu and Dg,23-5,0,0,0,0,NaN,NaN
6,1.000,Common Loon,16-23,0,0,0,0,NaN,NaN
6,1.000,Common Loon,23-5,0,0,0,0,NaN,NaN
6,1.000,Red-Winged Blackbird,16-23,0,0,0,0,NaN,NaN
6,1.000,Red-Winged Blackbird,23-5,0,0,0,0,NaN,NaN
6,1.000,Cw,16-23,0,0,0,0,NaN,NaN
6,1.000,Cw,23-5,0,0,0,0,NaN,NaN
6,1.000,Cliff Sparrow,16-23,0,0,0,0,NaN,NaN
6,1.000,Cliff Sparrow,23-5,0,0,0,0,NaN,NaN
6,1.000,Pig,16-23,0,0,0,0,NaN,NaN
6,1.000,Pig,23-5,0,0,0,0,NaN,NaN
6,1.000,Barn Owl,16-23,0,0,0,0,NaN,NaN
6,1.000,Barn Owl,23-5,0,0,0,0,NaN,NaN
6,1.000,Wild Pig,16-23,0,0,0,0,NaN,NaN
6,1.000,Wild Pig,23-5,0,0,0,0,NaN,NaN
6,1.000,Pennington Creek Water,16-23,0,0,0,0,NaN,NaN
6,1.000,Pennington Creek Water,23-5,0,0,0,0,NaN,NaN
6,1.000,Guinni,16-23,0,0,0,0,NaN,NaN
6,1.000,Guinni,23-5,0,0,0,0,NaN,NaN
6,1.000,Racoon,16-23,0,0,0,0,NaN,NaN
6,1.000,Racoon,23-5,0,0,0,0,NaN,NaN
6,1.000,Hu,16-23,0,0,0,0,NaN,NaN
6,1.000,Hu,23-5,0,0,0,0,NaN,NaN
6,1.000,Cw and Dg,16-23,0,0,0,0,NaN,NaN
6,1.000,Cw and Dg,23-5,0,0,0,0,NaN,NaN
6,1.000,Red Wind Blackbird,16-23,0,0,0,0,NaN,NaN
6,1.000,Red Wind Blackbird,23-5,0,0,0,0,NaN,NaN
6,1.000,Tree Swallow,16-23,0,0,0,0,NaN,NaN
6,1.000,Tree Swallow,23-5,0,0,0,0,NaN,NaN
6,1.000,Turkey Vulture,16-23,0,0,0,0,NaN,NaN
6,1.000,Turkey Vulture,23-5,0,0,0,0,NaN,NaN
6,1.000,Dg,16-23,0,0,0,0,NaN,NaN
6,1.000,Dg,23-5,0,0,0,0,NaN,NaN
6,1.000,Western Kingbird,16-23,0,0,0,0,NaN,NaN
6,1.000,Western Kingbird,23-5,0,0,0,0,NaN,NaN
6,1.000,White Crowned Sparrow,16-23,0,0,0,0,NaN,NaN
6,1.000,White Crowned Sparrow,23-5,0,0,0,0,NaN,NaN
6,1.000,Eared Grebe,16-23,0,0,0,0,NaN,NaN
6,1.000,Eared Grebe,23-5,0,0,0,0,NaN,NaN
6,1.000,cougar,16-23,0,0,0,0,NaN,NaN
6,1.000,cougar,23-5,0,0,0,0,NaN,NaN
6,1.000,Ocean Water,16-23,0,0,0,0,NaN,NaN
6,1.000,Ocean Water,23-5,0,0,0,0,NaN,NaN
6,1.000,Red Tailed Hawk,16-23,0,0,0,0,NaN,NaN
6,1.000,Red Tailed Hawk,23-5,0,0,0,0,NaN,NaN
6,1.000,Dog,16-23,0,0,0,0,NaN,NaN
6,1.000,Dog,23-5,0,0,0,0,NaN,NaN
6,1.000,Human,16-23,68,0,0,68,100.000,100.000
6,1.000,Human,23-5,90,0,0,90,100.000,100.000
6,1.000,Wild Turkey,16-23,0,0,0,0,NaN,NaN
6,1.000,Wild Turkey,23-5,0,0,0,0,NaN,NaN
6,1.000,Clark Grebe,16-23,0,0,0,0,NaN,NaN
6,1.000,Clark Grebe,23-5,0,0,0,0,NaN,NaN
6,1.000,Seagull,16-23,0,0,0,0,NaN,NaN
6,1.000,Seagull,23-5,0,0,0,0,NaN,NaN
6,1.000,Surf Scoter,16-23,0,0,0,0,NaN,NaN
6,1.000,Surf Scoter,23-5,0,0,0,0,NaN,NaN
6,1.000,Pigeon,16-23,0,0,0,0,NaN,NaN
6,1.000,Pigeon,23-5,0,0,0,0,NaN,NaN
6,1.000,Pacific Ocean Water,16-23,0,0,0,0,NaN,NaN
6,1.000,Pacific Ocean Water,23-5,0,0,0,0,NaN,NaN
6,1.000,Cat,16-23,0,0,0,0,NaN,NaN
6,1.000,Cat,23-5,0,0,0,0,NaN,NaN
6,1.000,Horse,16-23,0,0,0,0,NaN,NaN
6,1.000,Horse,23-5,0,0,0,0,NaN,NaN
6,1.000,orangutan,16-23,0,0,0,0,NaN,NaN
6,1.000,orangutan,23-5,0,0,0,0,NaN,NaN
6,1.000,Bat,16-23,0,0,0,0,NaN,NaN
6,1.000,Bat,23-5,0,0,0,0,NaN,NaN
6,1.000,Deer,16-23,0,0,0,0,NaN,NaN
6,1.000,Deer,23-5,0,0,0,0,NaN,NaN
6,1.000,Great Horned Owl,16-23,0,0,0,0,NaN,NaN
6,1.000,Great Horned Owl,23-5,0,0,0,0,NaN,NaN
6,1.000,Freshwater Lagoon,16-23,0,0,0,0,NaN,NaN
6,1.000,Freshwater Lagoon,23-5,0,0,0,0,NaN,NaN
6,1.000,Unknown Avian,16-23,0,0,0,0,NaN,NaN
6,1.000,Unknown Avian,23-5,0,0,0,0,NaN,NaN
6,1.000,Human UTI,16-23,0,0,0,0,NaN,NaN
6,1.000,Human UTI,23-5,0,0,0,0,NaN,NaN
6,1.000,unknown,16-23,0,0,0,0,NaN,NaN
6,1.000,unknown,23-5,0,0,0,0,NaN,NaN
6,1.000,SLO Creek Water,16-23,0,0,0,0,NaN,NaN
6,1.000,SLO Creek Water,23-5,0,0,0,0,NaN,NaN
6,1.000,Pig/Swine,16-23,0,0,0,0,NaN,NaN
6,1.000,Pig/Swine,23-5,0,0,0,0,NaN,NaN
6,1.000,Klebsiella,16-23,0,0,0,0,NaN,NaN
6,1.000,Klebsiella,23-5,0,0,0,0,NaN,NaN
6,1.000,Hu Cw and Dg,16-23,0,0,0,0,NaN,NaN
6,1.000,Hu Cw and Dg,23-5,0,0,0,0,NaN,NaN
6,1.000,Ground Squirrel,16-23,0,0,0,0,NaN,NaN
6,1.000,Ground Squirrel,23-5,0,0,0,0,NaN,NaN
6,1.000,Opossum,16-23,0,0,0,0,NaN,NaN
6,1.000,Opossum,23-5,0,0,0,0,NaN,NaN
6,1.000,Cow,16-23,0,0,0,0,NaN,NaN
6,1.000,Cow,23-5,0,0,0,0,NaN,NaN
6,1.000,Deer Mouse,16-23,0,0,0,0,NaN,NaN
6,1.000,Deer Mouse,23-5,0,0,0,0,NaN,NaN
6,1.000,OVERALL,16-23,68,0,0,68,100.000,100.000
6,1.000,OVERALL,23-5,90,0,0,90,100.000,100.000
7,0.000,Chicken,16-23,3,14,0,17,17.647,17.647
7,0.000,Chicken,23-5,13,9,0,22,59.091,59.091
7,0.000,Sea Lion,16-23,0,1,0,1,0.000,0.000
7,0.000,Sea Lion,23-5,3,8,0,11,27.273,27.273
7,0.000,Hu and Cw,16-23,9,13,0,22,40.909,40.909
7,0.000,Hu and Cw,23-5,4,22,0,26,15.385,15.385
7,0.000,Sheep,16-23,57,53,0,110,51.818,51.818
7,0.000,Sheep,23-5,63,38,0,101,62.376,62.376
7,0.000,Hu and Dg,16-23,10,15,0,25,40.000,40.000
7,0.000,Hu and Dg,23-5,19,17,0,36,52.778,52.778
7,0.000,Common Loon,16-23,0,0,0,0,NaN,NaN
7,0.000,Common Loon,23-5,0,4,0,4,0.000,0.000
7,0.000,Red-Winged Blackbird,16-23,0,10,0,10,0.000,0.000
7,0.000,Red-Winged Blackbird,23-5,0,1,0,1,0.000,0.000
7,0.000,Cw,16-23,11,10,0,21,52.381,52.381
7,0.000,Cw,23-5,20,43,0,63,31.746,31.746
7,0.000,Cliff Sparrow,16-23,3,25,0,28,10.714,10.714
7,0.000,Cliff Sparrow,23-5,2,7,0,9,22.222,22.222
7,0.000,Pig,16-23,13,10,0,23,56.522,56.522
7,0.000,Pig,23-5,5,11,0,16,31.250,31.250
7,0.000,Barn Owl,16-23,0,0,0,0,NaN,NaN
7,0.000,Barn Owl,23-5,0,0,0,0,NaN,NaN
7,0.000,Wild Pig,16-23,3,1,0,4,75.000,75.000
7,0.000,Wild Pig,23-5,4,3,0,7,57.143,57.143
7,0.000,Pennington Creek Water,16-23,0,0,0,0,NaN,NaN
7,0.000,Pennington Creek Water,23-5,0,0,0,0,NaN,NaN
7,0.000,Guinni,16-23,0,0,0,0,NaN,NaN
7,0.000,Guinni,23-5,0,0,0,0,NaN,NaN
7,0.000,Racoon,16-23,0,0,0,0,NaN,NaN
7,0.000,Racoon,23-5,0,0,0,0,NaN,NaN
7,0.000,Hu,16-23,16,17,0,33,48.485,48.485
7,0.000,Hu,23-5,21,11,0,32,65.625,65.625
7,0.000,Cw and Dg,16-23,4,14,0,18,22.222,22.222
7,0.000,Cw and Dg,23-5,18,21,0,39,46.154,46.154
7,0.000,Red Wind Blackbird,16-23,0,0,0,0,NaN,NaN
7,0.000,Red Wind Blackbird,23-5,0,0,0,0,NaN,NaN
7,0.000,Tree Swallow,16-23,0,0,0,0,NaN,NaN
7,0.000,Tree Swallow,23-5,0,1,0,1,0.000,0.000
7,0.000,Turkey Vulture,16-23,0,0,0,0,NaN,NaN
7,0.000,Turkey Vulture,23-5,0,0,0,0,NaN,NaN
7,0.000,Dg,16-23,8,12,0,20,40.000,40.000
7,0.000,Dg,23-5,31,31,0,62,50.000,50.000
7,0.000,Western Kingbird,16-23,0,0,0,0,NaN,NaN
7,0.000,Western Kingbird,23-5,0,0,0,0,NaN,NaN
7,0.000,White Crowned Sparrow,16-23,0,5,0,5,0.000,0.000
7,0.000,White Crowned Sparrow,23-5,3,11,0,14,21.429,21.429
7,0.000,Eared Grebe,16-23,0,0,0,0,NaN,NaN
7,0.000,Eared Grebe,23-5,0,16,0,16,0.000,0.000
7,0.000,cougar,16-23,0,0,0,0,NaN,NaN
7,0.000,cougar,23-5,0,0,0,0,NaN,NaN
7,0.000,Ocean Water,16-23,0,0,0,0,NaN,NaN
7,0.000,Ocean Water,23-5,0,0,0,0,NaN,NaN
7,0.000,Red Tailed Hawk,16-23,0,1,0,1,0.000,0.000
7,0.000,Red Tailed Hawk,23-5,0,5,0,5,0.000,0.000
7,0.000,Dog,16-23,66,74,0,140,47.143,47.143
7,0.000,Dog,23-5,117,139,0,256,45.703,45.703
7,0.000,Human,16-23,1759,656,0,2415,72.836,72.836
7,0.000,Human,23-5,2220,523,0,2743,80.933,80.933
7,0.000,Wild Turkey,16-23,10,19,0,29,34.483,34.483
7,0.000,Wild Turkey,23-5,1,30,0,31,3.226,3.226
7,0.000,Clark Grebe,16-23,0,0,0,0,NaN,NaN
7,0.000,Clark Grebe,23-5,0,0,0,0,NaN,NaN
7,0.000,Seagull,16-23,0,0,0,0,NaN,NaN
7,0.000,Seagull,23-5,44,6,0,50,88.000,88.000
7,0.000,Surf Scoter,16-23,0,0,0,0,NaN,NaN
7,0.000,Surf Scoter,23-5,0,2,0,2,0.000,0.000
7,0.000,Pigeon,16-23,102,166,0,268,38.060,38.060
7,0.000,Pigeon,23-5,141,219,0,360,39.167,39.167
7,0.000,Pacific Ocean Water,16-23,0,0,0,0,NaN,NaN
7,0.000,Pacific Ocean Water,23-5,0,0,0,0,NaN,NaN
7,0.000,Cat,16-23,27,33,0,60,45.000,45.000
7,0.000,Cat,23-5,35,32,0,67,52.239,52.239
7,0.000,Horse,16-23,8,25,0,33,24.242,24.242
7,0.000,Horse,23-5,34,172,0,206,16.505,16.505
7,0.000,orangutan,16-23,0,0,0,0,NaN,NaN
7,0.000,orangutan,23-5,0,0,0,0,NaN,NaN
7,0.000,Bat,16-23,36,20,0,56,64.286,64.286
7,0.000,Bat,23-5,37,29,0,66,56.061,56.061
7,0.000,Deer,16-23,16,21,0,37,43.243,43.243
7,0.000,Deer,23-5,18,92,0,110,16.364,16.364
7,0.000,Great Horned Owl,16-23,0,0,0,0,NaN,NaN
7,0.000,Great Horned Owl,23-5,0,6,0,6,0.000,0.000
7,0.000,Freshwater Lagoon,16-23,0,0,0,0,NaN,NaN
7,0.000,Freshwater Lagoon,23-5,0,0,0,0,NaN,NaN
7,0.000,Unknown Avian,16-23,0,0,0,0,NaN,NaN
7,0.000,Unknown Avian,23-5,0,0,0,0,NaN,NaN
7,0.000,Human UTI,16-23,80,75,0,155,51.613,51.613
7,0.000,Human UTI,23-5,109,94,0,203,53.695,53.695
7,0.000,unknown,16-23,0,1,0,1,0.000,0.000
7,0.000,unknown,23-5,3,3,0,6,50.000,50.000
7,0.000,SLO Creek Water,16-23,0,0,0,0,NaN,NaN
7,0.000,SLO Creek Water,23-5,0,0,0,0,NaN,NaN
7,0.000,Pig/Swine,16-23,9,8,0,17,52.941,52.941
7,0.000,Pig/Swine,23-5,12,9,0,21,57.143,57.143
7,0.000,Klebsiella,16-23,0,0,0,0,NaN,NaN
7,0.000,Klebsiella,23-5,0,0,0,0,NaN,NaN
7,0.000,Hu Cw and Dg,16-23,11,24,0,35,31.429,31.429
7,0.000,Hu Cw and Dg,23-5,15,22,0,37,40.541,40.541
7,0.000,Ground Squirrel,16-23,97,71,0,168,57.738,57.738
7,0.000,Ground Squirrel,23-5,89,73,0,162,54.938,54.938
7,0.000,Opossum,16-23,0,2,0,2,0.000,0.000
7,0.000,Opossum,23-5,0,4,0,4,0.000,0.000
7,0.000,Cow,16-23,1562,1032,0,2594,60.216,60.216
7,0.000,Cow,23-5,1513,1302,0,2815,53.748,53.748
7,0.000,Deer Mouse,16-23,0,0,0,0,NaN,NaN
7,0.000,Deer Mouse,23-5,0,0,0,0,NaN,NaN
7,0.000,OVERALL,16-23,3920,2428,0,6348,61.752,61.752
7,0.000,OVERALL,23-5,4594,3016,0,7610,60.368,60.368
7,0.500,Chicken,16-23,3,14,0,17,17.647,17.647
7,0.500,Chicken,23-5,13,9,0,22,59.091,59.091
7,0.500,Sea Lion,16-23,0,1,0,1,0.000,0.000
7,0.500,Sea Lion,23-5,3,8,0,11,27.273,27.273
7,0.500,Hu and Cw,16-23,9,13,0,22,40.909,40.909
7,0.500,Hu and Cw,23-5,4,22,0,26,15.385,15.385
7,0.500,Sheep,16-23,57,53,0,110,51.818,51.818
7,0.500,Sheep,23-5,63,38,0,101,62.376,62.376
7,0.500,Hu and Dg,16-23,10,15,0,25,40.000,40.000
7,0.500,Hu and Dg,23-5,19,17,0,36,52.778,52.778
7,0.500,Common Loon,16-23,0,0,0,0,NaN,NaN
7,0.500,Common Loon,23-5,0,4,0,4,0.000,0.000
7,0.500,Red-Winged Blackbird,16-23,0,10,0,10,0.000,0.000
7,0.500,Red-Winged Blackbird,23-5,0,1,0,1,0.000,0.000
7,0.500,Cw,16-23,11,10,0,21,52.381,52.381
7,0.500,Cw,23-5,20,43,0,63,31.746,31.746
7,0.500,Cliff Sparrow,16-23,3,25,0,28,10.714,10.714
7,0.500,Cliff Sparrow,23-5,2,7,0,9,22.222,22.222
7,0.500,Pig,16-23,13,10,0,23,56.522,56.522
7,0.500,Pig,23-5,5,11,0,16,31.250,31.250
7,0.500,Barn Owl,16-23,0,0,0,0,NaN,NaN
7,0.500,Barn Owl,23-5,0,0,0,0,NaN,NaN
7,0.500,Wild Pig,16-23,3,1,0,4,75.000,75.000
7,0.500,Wild Pig,23-5,4,3,0,7,57.143,57.143
7,0.500,Pennington Creek Water,16-23,0,0,0,0,NaN,NaN
7,0.500,Pennington Creek Water,23-5,0,0,0,0,NaN,NaN
7,0.500,Guinni,16-23,0,0,0,0,NaN,NaN
7,0.500,Guinni,23-5,0,0,0,0,NaN,NaN
7,0.500,Racoon,16-23,0,0,0,0,NaN,NaN
7,0.500,Racoon,23-5,0,0,0,0,NaN,NaN
7,0.500,Hu,16-23,16,17,0,33,48.485,48.485
7,0.500,Hu,23-5,21,11,0,32,65.625,65.625
7,0.500,Cw and Dg,16-23,4,14,0,18,22.222,22.222
7,0.500,Cw and Dg,23-5,18,21,0,39,46.154,46.154
7,0.500,Red Wind Blackbird,16-23,0,0,0,0,NaN,NaN
7,0.500,Red Wind Blackbird,23-5,0,0,0,0,NaN,NaN
7,0.500,Tree Swallow,16-23,0,0,0,0,NaN,NaN
7,0.500,Tree Swallow,23-5,0,1,0,1,0.000,0.000
7,0.500,Turkey Vulture,16-23,0,0,0,0,NaN,NaN
7,0.500,Turkey Vulture,23-5,0,0,0,0,NaN,NaN
7,0.500,Dg,16-23,8,12,0,20,40.000,40.000
7,0.500,Dg,23-5,31,31,0,62,50.000,50.000
7,0.500,Western Kingbird,16-23,0,0,0,0,NaN,NaN
7,0.500,Western Kingbird,23-5,0,0,0,0,NaN,NaN
7,0.500,White Crowned Sparrow,16-23,0,5,0,5,0.000,0.000
7,0.500,White Crowned Sparrow,23-5,3,11,0,14,21.429,21.429
7,0.500,Eared Grebe,16-23,0,0,0,0,NaN,NaN
7,0.500,Eared Grebe,23-5,0,16,0,16,0.000,0.000
7,0.500,cougar,16-23,0,0,0,0,NaN,NaN
7,0.500,cougar,23-5,0,0,0,0,NaN,NaN
7,0.500,Ocean Water,16-23,0,0,0,0,NaN,NaN
7,0.500,Ocean Water,23-5,0,0,0,0,NaN,NaN
7,0.500,Red Tailed Hawk,16-23,0,1,0,1,0.000,0.000
7,0.500,Red Tailed Hawk,23-5,0,5,0,5,0.000,0.000
7,0.500,Dog,16-23,66,74,0,140,47.143,47.143
7,0.500,Dog,23-5,117,139,0,256,45.703,45.703
7,0.500,Human,16-23,1759,656,0,2415,72.836,72.836
7,0.500,Human,23-5,2220,523,0,2743,80.933,80.933
7,0.500,Wild Turkey,16-23,10,19,0,29,34.483,34.483
7,0.500,Wild Turkey,23-5,1,30,0,31,3.226,3.226
7,0.500,Clark Grebe,16-23,0,0,0,0,NaN,NaN
7,0.500,Clark Grebe,23-5,0,0,0,0,NaN,NaN
7,0.500,Seagull,16-23,0,0,0,0,NaN,NaN
7,0.500,Seagull,23-5,44,6,0,50,88.000,88.000
7,0.500,Surf Scoter,16-23,0,0,0,0,NaN,NaN
7,0.500,Surf Scoter,23-5,0,2,0,2,0.000,0.000
7,0.500,Pigeon,16-23,102,166,0,268,38.060,38.060
7,0.500,Pigeon,23-5,141,219,0,360,39.167,39.167
7,0.500,Pacific Ocean Water,16-23,0,0,0,0,NaN,NaN
7,0.500,Pacific Ocean Water,23-5,0,0,0,0,NaN,NaN
7,0.500,Cat,16-23,27,33,0,60,45.000,45.000
7,0.500,Cat,23-5,35,32,0,67,52.239,52.239
7,0.500,Horse,16-23,8,25,0,33,24.242,24.242
7,0.500,Horse,23-5,34,172,0,206,16.505,16.505
7,0.500,orangutan,16-23,0,0,0,0,NaN,NaN
7,0.500,orangutan,23-5,0,0,0,0,NaN,NaN
7,0.500,Bat,16-23,36,20,0,56,64.286,64.286
7,0.500,Bat,23-5,37,29,0,66,56.061,56.061
7,0.500,Deer,16-23,16,21,0,37,43.243,43.243
7,0.500,Deer,23-5,18,92,0,110,16.364,16.364
7,0.500,Great Horned Owl,16-23,0,0,0,0,NaN,NaN
7,0.500,Great Horned Owl,23-5,0,6,0,6,0.000,0.000
7,0.500,Freshwater Lagoon,16-23,0,0,0,0,NaN,NaN
7,0.500,Freshwater Lagoon,23-5,0,0,0,0,NaN,NaN
7,0.500,Unknown Avian,16-23,0,0,0,0,NaN,NaN
7,0.500,Unknown Avian,23-5,0,0,0,0,NaN,NaN
7,0.500,Human UTI,16-23,80,75,0,155,51.613,51.613
7,0.500,Human UTI,23-5,109,94,0,203,53.695,53.695
7,0.500,unknown,16-23,0,1,0,1,0.000,0.000
7,0.500,unknown,23-5,3,3,0,6,50.000,50.000
7,0.500,SLO Creek Water,16-23,0,0,0,0,NaN,NaN
7,0.500,SLO Creek Water,23-5,0,0,0,0,NaN,NaN
7,0.500,Pig/Swine,16-23,9,8,0,17,52.941,52.941
7,0.500,Pig/Swine,23-5,12,9,0,21,57.143,57.143
7,0.500,Klebsiella,16-23,0,0,0,0,NaN,NaN
7,0.500,Klebsiella,23-5,0,0,0,0,NaN,NaN
7,0.500,Hu Cw and Dg,16-23,11,24,0,35,31.429,31.429
7,0.500,Hu Cw and Dg,23-5,15,22,0,37,40.541,40.541
7,0.500,Ground Squirrel,16-23,97,71,0,168,57.738,57.738
7,0.500,Ground Squirrel,23-5,89,73,0,162,54.938,54.938
7,0.500,Opossum,16-23,0,2,0,2,0.000,0.000
7,0.500,Opossum,23-5,0,4,0,4,0.000,0.000
7,0.500,Cow,16-23,1562,1032,0,2594,60.216,60.216
7,0.500,Cow,23-5,1513,1302,0,2815,53.748,53.748
7,0.500,Deer Mouse,16-23,0,0,0,0,NaN,NaN
7,0.500,Deer Mouse,23-5,0,0,0,0,NaN,NaN
7,0.500,OVERALL,16-23,3920,2428,0,6348,61.752,61.752
7,0.500,OVERALL,23-5,4594,3016,0,7610,60.368,60.368
7,0.900,Chicken,16-23,3,14,0,17,17.647,17.647
7,0.900,Chicken,23-5,13,9,0,22,59.091,59.091
7,0.900,Sea Lion,16-23,0,1,0,1,0.000,0.000
7,0.900,Sea Lion,23-5,3,8,0,11,27.273,27.273
7,0.900,Hu and Cw,16-23,9,13,0,22,40.909,40.909
7,0.900,Hu and Cw,23-5,4,22,0,26,15.385,15.385
7,0.900,Sheep,16-23,57,53,0,110,51.818,51.818
7,0.900,Sheep,23-5,63,38,0,101,62.376,62.376
7,0.900,Hu and Dg,16-23,10,15,0,25,40.000,40.000
7,0.900,Hu and Dg,23-5,19,17,0,36,52.778,52.778
7,0.900,Common Loon,16-23,0,0,0,0,NaN,NaN
7,0.900,Common Loon,23-5,0,4,0,4,0.000,0.000
7,0.900,Red-Winged Blackbird,16-23,0,10,0,10,0.000,0.000
7,0.900,Red-Winged Blackbird,23-5,0,1,0,1,0.000,0.000
7,0.900,Cw,16-23,11,10,0,21,52.381,52.381
7,0.900,Cw,23-5,20,43,0,63,31.746,31.746
7,0.900,Cliff Sparrow,16-23,3,25,0,28,10.714,10.714
7,0.900,Cliff Sparrow,23-5,2,7,0,9,22.222,22.222
7,0.900,Pig,16-23,13,10,0,23,56.522,56.522
7,0.900,Pig,23-5,5,11,0,16,31.250,31.250
7,0.900,Barn Owl,16-23,0,0,0,0,NaN,NaN
7,0.900,Barn Owl,23-5,0,0,0,0,NaN,NaN
7,0.900,Wild Pig,16-23,3,1,0,4,75.000,75.000
7,0.900,Wild Pig,23-5,4,3,0,7,57.143,57.143
7,0.900,Pennington Creek Water,16-23,0,0,0,0,NaN,NaN
7,0.900,Pennington Creek Water,23-5,0,0,0,0,NaN,NaN
7,0.900,Guinni,16-23,0,0,0,0,NaN,NaN
7,0.900,Guinni,23-5,0,0,0,0,NaN,NaN
7,0.900,Racoon,16-23,0,0,0,0,NaN,NaN
7,0.900,Racoon,23-5,0,0,0,0,NaN,NaN
7,0.900,Hu,16-23,16,17,0,33,48.485,48.485
7,0.900,Hu,23-5,21,11,0,32,65.625,65.625
7,0.900,Cw and Dg,16-23,4,14,0,18,22.222,22.222
7,0.900,Cw and Dg,23-5,18,21,0,39,46.154,46.154
7,0.900,Red Wind Blackbird,16-23,0,0,0,0,NaN,NaN
7,0.900,Red Wind Blackbird,23-5,0,0,0,0,NaN,NaN
7,0.900,Tree Swallow,16-23,0,0,0,0,NaN,NaN
7,0.900,Tree Swallow,23-5,0,1,0,1,0.000,0.000
7,0.900,Turkey Vulture,16-23,0,0,0,0,NaN,NaN
7,0.900,Turkey Vulture,23-5,0,0,0,0,NaN,NaN
7,0.900,Dg,16-23,8,12,0,20,40.000,40.000
7,0.900,Dg,23-5,31,31,0,62,50.000,50.000
7,0.900,Western Kingbird,16-23,0,0,0,0,NaN,NaN
7,0.900,Western Kingbird,23-5,0,0,0,0,NaN,NaN
7,0.900,White Crowned Sparrow,16-23,0,5,0,5,0.000,0.000
7,0.900,White Crowned Sparrow,23-5,3,11,0,14,21.429,21.429
7,0.900,Eared Grebe,16-23,0,0,0,0,NaN,NaN
7,0.900,Eared Grebe,23-5,0,16,0,16,0.000,0.000
7,0.900,cougar,16-23,0,0,0,0,NaN,NaN
7,0.900,cougar,23-5,0,0,0,0,NaN,NaN
7,0.900,Ocean Water,16-23,0,0,0,0,NaN,NaN
7,0.900,Ocean Water,23-5,0,0,0,0,NaN,NaN
7,0.900,Red Tailed Hawk,16-23,0,1,0,1,0.000,0.000
7,0.900,Red Tailed Hawk,23-5,0,5,0,5,0.000,0.000
7,0.900,Dog,16-23,66,74,0,140,47.143,47.143
7,0.900,Dog,23-5,117,136,0,253,46.245,46.245
7,0.900,Human,16-23,1759,655,0,2414,72.867,72.867
7,0.900,Human,23-5,2220,518,0,2738,81.081,81.081
7,0.900,Wild Turkey,16-23,10,19,0,29,34.483,34.483
7,0.900,Wild Turkey,23-5,1,30,0,31,3.226,3.226
7,0.900,Clark Grebe,16-23,0,0,0,0,NaN,NaN
7,0.900,Clark Grebe,23-5,0,0,0,0,NaN,NaN
7,0.900,Seagull,16-23,0,0,0,0,NaN,NaN
7,0.900,Seagull,23-5,44,7,0,51,86.275,86.275
7,0.900,Surf Scoter,16-23,0,0,0,0,NaN,NaN
7,0.900,Surf Scoter,23-5,0,2,0,2,0.000,0.000
7,0.900,Pigeon,16-23,102,166,0,268,38.060,38.060
7,0.900,Pigeon,23-5,141,219,0,360,39.167,39.167
7,0.900,Pacific Ocean Water,16-23,0,0,0,0,NaN,NaN
7,0.900,Pacific Ocean Water,23-5,0,0,0,0,NaN,NaN
7,0.900,Cat,16-23,27,33,0,60,45.000,45.000
7,0.900,Cat,23-5,35,32,0,67,52.239,52.239
7,0.900,Horse,16-23,8,25,0,33,24.242,24.242
7,0.900,Horse,23-5,34,172,0,206,16.505,16.505
7,0.900,orangutan,16-23,0,0,0,0,NaN,NaN
7,0.900,orangutan,23-5,0,0,0,0,NaN,NaN
7,0.900,Bat,16-23,36,20,0,56,64.286,64.286
7,0.900,Bat,23-5,37,29,0,66,56.061,56.061
7,0.900,Deer,16-23,16,21,0,37,43.243,43.243
7,0.900,Deer,23-5,18,92,0,110,16.364,16.364
7,0.900,Great Horned Owl,16-23,0,0,0,0,NaN,NaN
7,0.900,Great Horned Owl,23-5,0,6,0,6,0.000,0.000
7,0.900,Freshwater Lagoon,16-23,0,0,0,0,NaN,NaN
7,0.900,Freshwater Lagoon,23-5,0,0,0,0,NaN,NaN
7,0.900,Unknown Avian,16-23,0,0,0,0,NaN,NaN
7,0.900,Unknown Avian,23-5,0,0,0,0,NaN,NaN
7,0.900,Human UTI,16-23,80,75,0,155,51.613,51.613
7,0.900,Human UTI,23-5,110,94,0,204,53.922,53.922
7,0.900,unknown,16-23,0,1,0,1,0.000,0.000
7,0.900,unknown,23-5,3,3,0,6,50.000,50.000
7,0.900,SLO Creek Water,16-23,0,0,0,0,NaN,NaN
7,0.900,SLO Creek Water,23-5,0,0,0,0,NaN,NaN
7,0.900,Pig/Swine,16-23,9,8,0,17,52.941,52.941
7,0.900,Pig/Swine,23-5,12,9,0,21,57.143,57.143
7,0.900,Klebsiella,16-23,0,0,0,0,NaN,NaN
7,0.900,Klebsiella,23-5,0,0,0,0,NaN,NaN
7,0.900,Hu Cw and Dg,16-23,11,24,0,35,31.429,31.429
7,0.900,Hu Cw and Dg,23-5,15,22,0,37,40.541,40.541
7,0.900,Ground Squirrel,16-23,97,71,0,168,57.738,57.738
7,0.900,Ground Squirrel,23-5,89,73,0,162,54.938,54.938
7,0.900,Opossum,16-23,0,2,0,2,0.000,0.000
7,0.900,Opossum,23-5,0,4,0,4,0.000,0.000
7,0.900,Cow,16-23,1562,1029,0,2591,60.286,60.286
7,0.900,Cow,23-5,1513,1300,0,2813,53.786,53.786
7,0.900,Deer Mouse,16-23,0,0,0,0,NaN,NaN
7,0.900,Deer Mouse,23-5,0,0,0,0,NaN,NaN
7,0.900,OVERALL,16-23,3920,2424,0,6344,61.791,61.791
7,0.900,OVERALL,23-5,4595,3007,0,7602,60.445,60.445
7,0.950,Chicken,16-23,3,14,0,17,17.647,17.647
7,0.950,Chicken,23-5,13,9,0,22,59.091,59.091
7,0.950,Sea Lion,16-23,0,1,0,1,0.000,0.000
7,0.950,Sea Lion,23-5,3,8,0,11,27.273,27.273
7,0.950,Hu and Cw,16-23,9,13,0,22,40.909,40.909
7,0.950,Hu and Cw,23-5,4,22,0,26,15.385,15.385
7,0.950,Sheep,16-23,57,53,0,110,51.818,51.818
7,0.950,Sheep,23-5,63,38,0,101,62.376,62.376
7,0.950,Hu and Dg,16-23,10,15,0,25,40.000,40.000
7,0.950,Hu and Dg,23-5,19,17,0,36,52.778,52.778
7,0.950,Common Loon,16-23,0,0,0,0,NaN,NaN
7,0.950,Common Loon,23-5,0,4,0,4,0.000,0.000
7,0.950,Red-Winged Blackbird,16-23,0,10,0,10,0.000,0.000
7,0.950,Red-Winged Blackbird,23-5,0,1,0,1,0.000,0.000
7,0.950,Cw,16-23,11,10,0,21,52.381,52.381
7,0.950,Cw,23-5,20,43,0,63,31.746,31.746
7,0.950,Cliff Sparrow,16-23,3,25,0,28,10.714,10.714
7,0.950,Cliff Sparrow,23-5,2,7,0,9,22.222,22.222
7,0.950,Pig,16-23,13,10,0,23,56.522,56.522
7,0.950,Pig,23-5,5,11,0,16,31.250,31.250
7,0.950,Barn Owl,16-23,0,0,0,0,NaN,NaN
7,0.950,Barn Owl,23-5,0,0,0,0,NaN,NaN
7,0.950,Wild Pig,16-23,3,1,0,4,75.000,75.000
7,0.950,Wild Pig,23-5,4,2,0,6,66.667,66.667
7,0.950,Pennington Creek Water,16-23,0,0,0,0,NaN,NaN
7,0.950,Pennington Creek Water,23-5,0,0,0,0,NaN,NaN
7,0.950,Guinni,16-23,0,0,0,0,NaN,NaN
7,0.950,Guinni,23-5,0,0,0,0,NaN,NaN
7,0.950,Racoon,16-23,0,0,0,0,NaN,NaN
7,0.950,Racoon,23-5,0,0,0,0,NaN,NaN
7,0.950,Hu,16-23,16,17,0,33,48.485,48.485
7,0.950,Hu,23-5,21,11,0,32,65.625,65.625
7,0.950,Cw and Dg,16-23,4,14,0,18,22.222,22.222
7,0.950,Cw and Dg,23-5,18,21,0,39,46.154,46.154
7,0.950,Red Wind Blackbird,16-23,0,0,0,0,NaN,NaN
7,0.950,Red Wind Blackbird,23-5,0,0,0,0,NaN,NaN
7,0.950,Tree Swallow,16-23,0,0,0,0,NaN,NaN
7,0.950,Tree Swallow,23-5,0,1,0,1,0.000,0.000
7,0.950,Turkey Vulture,16-23,0,0,0,0,NaN,NaN
7,0.950,Turkey Vulture,23-5,0,0,0,0,NaN,NaN
7,0.950,Dg,16-23,8,12,0,20,40.000,40.000
7,0.950,Dg,23-5,31,31,0,62,50.000,50.000
7,0.950,Western Kingbird,16-23,0,0,0,0,NaN,NaN
7,0.950,Western Kingbird,23-5,0,0,0,0,NaN,NaN
7,0.950,White Crowned Sparrow,16-23,0,5,0,5,0.000,0.000
7,0.950,White Crowned Sparrow,23-5,3,11,0,14,21.429,21.429
7,0.950,Eared Grebe,16-23,0,0,0,0,NaN,NaN
7,0.950,Eared Grebe,23-5,0,16,0,16,0.000,0.000
7,0.950,cougar,16-23,0,0,0,0,NaN,NaN
7,0.950,cougar,23-5,0,0,0,0,NaN,NaN
7,0.950,Ocean Water,16-23,0,0,0,0,NaN,NaN
7,0.950,Ocean Water,23-5,0,0,0,0,NaN,NaN
7,0.950,Red Tailed Hawk,16-23,0,1,0,1,0.000,0.000
7,0.950,Red Tailed Hawk,23-5,0,5,0,5,0.000,0.000
7,0.950,Dog,16-23,66,74,0,140,47.143,47.143
7,0.950,Dog,23-5,117,135,0,252,46.429,46.429
7,0.950,Human,16-23,1759,655,0,2414,72.867,72.867
7,0.950,Human,23-5,2222,512,0,2734,81.273,81.273
7,0.950,Wild Turkey,16-23,10,19,0,29,34.483,34.483
7,0.950,Wild Turkey,23-5,1,30,0,31,3.226,3.226
7,0.950,Clark Grebe,16-23,0,0,0,0,NaN,NaN
7,0.950,Clark Grebe,23-5,0,0,0,0,NaN,NaN
7,0.950,Seagull,16-23,0,0,0,0,NaN,NaN
7,0.950,Seagull,23-5,44,6,0,50,88.000,88.000
7,0.950,Surf Scoter,16-23,0,0,0,0,NaN,NaN
7,0.950,Surf Scoter,23-5,0,1,0,1,0.000,0.000
7,0.950,Pigeon,16-23,102,165,0,267,38.202,38.202
7,0.950,Pigeon,23-5,141,220,0,361,39.058,39.058
7,0.950,Pacific Ocean Water,16-23,0,0,0,0,NaN,NaN
7,0.950,Pacific Ocean Water,23-5,0,0,0,0,NaN,NaN
7,0.950,Cat,16-23,27,33,0,60,45.000,45.000
7,0.950,Cat,23-5,35,32,0,67,52.239,52.239
7,0.950,Horse,16-23,8,25,0,33,24.242,24.242
7,0.950,Horse,23-5,34,172,0,206,16.505,16.505
7,0.950,orangutan,16-23,0,0,0,0,NaN,NaN
7,0.950,orangutan,23-5,0,0,0,0,NaN,NaN
7,0.950,Bat,16-23,36,20,0,56,64.286,64.286
7,0.950,Bat,23-5,37,28,0,65,56.923,56.923
7,0.950,Deer,16-23,16,21,0,37,43.243,43.243
7,0.950,Deer,23-5,18,92,0,110,16.364,16.364
7,0.950,Great Horned Owl,16-23,0,0,0,0,NaN,NaN
7,0.950,Great Horned Owl,23-5,0,6,0,6,0.000,0.000
7,0.950,Freshwater Lagoon,16-23,0,0,0,0,NaN,NaN
7,0.950,Freshwater Lagoon,23-5,0,0,0,0,NaN,NaN
7,0.950,Unknown Avian,16-23,0,0,0,0,NaN,NaN
7,0.950,Unknown Avian,23-5,0,0,0,0,NaN,NaN
7,0.950,Human UTI,16-23,83,75,0,158,52.532,52.532
7,0.950,Human UTI,23-5,109,96,0,205,53.171,53.171
7,0.950,unknown,16-23,0,1,0,1,0.000,0.000
7,0.950,unknown,23-5,3,3,0,6,50.000,50.000
7,0.950,SLO Creek Water,16-23,0,0,0,0,NaN,NaN
7,0.950,SLO Creek Water,23-5,0,0,0,0,NaN,NaN
7,0.950,Pig/Swine,16-23,9,8,0,17,52.941,52.941
7,0.950,Pig/Swine,23-5,12,9,0,21,57.143,57.143
7,0.950,Klebsiella,16-23,0,0,0,0,NaN,NaN
7,0.950,Klebsiella,23-5,0,0,0,0,NaN,NaN
7,0.950,Hu Cw and Dg,16-23,11,24,0,35,31.429,31.429
7,0.950,Hu Cw and Dg,23-5,15,22,0,37,40.541,40.541
7,0.950,Ground Squirrel,16-23,97,71,0,168,57.738,57.738
7,0.950,Ground Squirrel,23-5,89,71,0,160,55.625,55.625
7,0.950,Opossum,16-23,0,2,0,2,0.000,0.000
7,0.950,Opossum,23-5,0,4,0,4,0.000,0.000
7,0.950,Cow,16-23,1562,1010,0,2572,60.731,60.731
7,0.950,Cow,23-5,1512,1298,0,2810,53.808,53.808
7,0.950,Deer Mouse,16-23,0,0,0,0,NaN,NaN
7,0.950,Deer Mouse,23-5,0,0,0,0,NaN,NaN
7,0.950,OVERALL,16-23,3923,2404,0,6327,62.004,62.004
7,0.950,OVERALL,23-5,4595,2995,0,7590,60.540,60.540
7,0.960,Chicken,16-23,3,14,0,17,17.647,17.647
7,0.960,Chicken,23-5,13,9,0,22,59.091,59.091
7,0.960,Sea Lion,16-23,0,1,0,1,0.000,0.000
7,0.960,Sea Lion,23-5,3,8,0,11,27.273,27.273
7,0.960,Hu and Cw,16-23,9,13,0,22,40.909,40.909
7,0.960,Hu and Cw,23-5,4,22,0,26,15.385,15.385
7,0.960,Sheep,16-23,57,53,0,110,51.818,51.818
7,0.960,Sheep,23-5,63,39,0,102,61.765,61.765
7,0.960,Hu and Dg,16-23,10,15,0,25,40.000,40.000
7,0.960,Hu and Dg,23-5,19,17,0,36,52.778,52.778
7,0.960,Common Loon,16-23,0,0,0,0,NaN,NaN
7,0.960,Common Loon,23-5,0,4,0,4,0.000,0.000
7,0.960,Red-Winged Blackbird,16-23,0,10,0,10,0.000,0.000
7,0.960,Red-Winged Blackbird,23-5,0,1,0,1,0.000,0.000
7,0.960,Cw,16-23,11,10,0,21,52.381,52.381
7,0.960,Cw,23-5,20,43,0,63,31.746,31.746
7,0.960,Cliff Sparrow,16-23,3,25,0,28,10.714,10.714
7,0.960,Cliff Sparrow,23-5,2,7,0,9,22.222,22.222
7,0.960,Pig,16-23,13,10,0,23,56.522,56.522
7,0.960,Pig,23-5,5,11,0,16,31.250,31.250
7,0.960,Barn Owl,16-23,0,0,0,0,NaN,NaN
7,0.960,Barn Owl,23-5,0,0,0,0,NaN,NaN
7,0.960,Wild Pig,16-23,3,1,0,4,75.000,75.000
7,0.960,Wild Pig,23-5,4,2,0,6,66.667,66.667
7,0.960,Pennington Creek Water,16-23,0,0,0,0,NaN,NaN
7,0.960,Pennington Creek Water,23-5,0,0,0,0,NaN,NaN
7,0.960,Guinni,16-23,0,0,0,0,NaN,NaN
7,0.960,Guinni,23-5,0,0,0,0,NaN,NaN
7,0.960,Racoon,16-23,0,0,0,0,NaN,NaN
7,0.960,Racoon,23-5,0,0,0,0,NaN,NaN
7,0.960,Hu,16-23,16,17,0,33,48.485,48.485
7,0.960,Hu,23-5,21,11,0,32,65.625,65.625
7,0.960,Cw and Dg,16-23,4,14,0,18,22.222,22.222
7,0.960,Cw and Dg,23-5,18,21,0,39,46.154,46.154
7,0.960,Red Wind Blackbird,16-23,0,0,0,0,NaN,NaN
7,0.960,Red Wind Blackbird,23-5,0,0,0,0,NaN,NaN
7,0.960,Tree Swallow,16-23,0,0,0,0,NaN,NaN
7,0.960,Tree Swallow,23-5,0,1,0,1,0.000,0.000
7,0.960,Turkey Vulture,16-23,0,0,0,0,NaN,NaN
7,0.960,Turkey Vulture,23-5,0,0,0,0,NaN,NaN
7,0.960,Dg,16-23,8,12,0,20,40.000,40.000
7,0.960,Dg,23-5,31,31,0,62,50.000,50.000
7,0.960,Western Kingbird,16-23,0,0,0,0,NaN,NaN
7,0.960,Western Kingbird,23-5,0,0,0,0,NaN,NaN
7,0.960,White Crowned Sparrow,16-23,0,5,0,5,0.000,0.000
7,0.960,White Crowned Sparrow,23-5,3,11,0,14,21.429,21.429
7,0.960,Eared Grebe,16-23,0,0,0,0,NaN,NaN
7,0.960,Eared Grebe,23-5,0,16,0,16,0.000,0.000
7,0.960,cougar,16-23,0,0,0,0,NaN,NaN
7,0.960,cougar,23-5,0,0,0,0,NaN,NaN
7,0.960,Ocean Water,16-23,0,0,0,0,NaN,NaN
7,0.960,Ocean Water,23-5,0,0,0,0,NaN,NaN
7,0.960,Red Tailed Hawk,16-23,0,1,0,1,0.000,0.000
7,0.960,Red Tailed Hawk,23-5,0,5,0,5,0.000,0.000
7,0.960,Dog,16-23,66,74,0,140,47.143,47.143
7,0.960,Dog,23-5,117,132,0,249,46.988,46.988
7,0.960,Human,16-23,1759,654,0,2413,72.897,72.897
7,0.960,Human,23-5,2222,499,0,2721,81.661,81.661
7,0.960,Wild Turkey,16-23,10,19,0,29,34.483,34.483
7,0.960,Wild Turkey,23-5,1,34,0,35,2.857,2.857
7,0.960,Clark Grebe,16-23,0,0,0,0,NaN,NaN
7,0.960,Clark Grebe,23-5,0,0,0,0,NaN,NaN
7,0.960,Seagull,16-23,0,0,0,0,NaN,NaN
7,0.960,Seagull,23-5,44,7,0,51,86.275,86.275
7,0.960,Surf Scoter,16-23,0,0,0,0,NaN,NaN
7,0.960,Surf Scoter,23-5,0,2,0,2,0.000,0.000
7,0.960,Pigeon,16-23,100,165,0,265,37.736,37.736
7,0.960,Pigeon,23-5,142,233,0,375,37.867,37.867
7,0.960,Pacific Ocean Water,16-23,0,0,0,0,NaN,NaN
7,0.960,Pacific Ocean Water,23-5,0,0,0,0,NaN,NaN
7,0.960,Cat,16-23,27,33,0,60,45.000,45.000
7,0.960,Cat,23-5,35,32,0,67,52.239,52.239
7,0.960,Horse,16-23,8,25,0,33,24.242,24.242
7,0.960,Horse,23-5,34,172,0,206,16.505,16.505
7,0.960,orangutan,16-23,0,0,0,0,NaN,NaN
7,0.960,orangutan,23-5,0,0,0,0,NaN,NaN
7,0.960,Bat,16-23,36,20,0,56,64.286,64.286
7,0.960,Bat,23-5,37,28,0,65,56.923,56.923
7,0.960,Deer,16-23,16,21,0,37,43.243,43.243
7,0.960,Deer,23-5,18,92,0,110,16.364,16.364
7,0.960,Great Horned Owl,16-23,0,0,0,0,NaN,NaN
7,0.960,Great Horned Owl,23-5,0,6,0,6,0.000,0.000
7,0.960,Freshwater Lagoon,16-23,0,0,0,0,NaN,NaN
7,0.960,Freshwater Lagoon,23-5,0,0,0,0,NaN,NaN
7,0.960,Unknown Avian,16-23,0,0,0,0,NaN,NaN
7,0.960,Unknown Avian,23-5,0,0,0,0,NaN,NaN
7,0.960,Human UTI,16-23,83,76,0,159,52.201,52.201
7,0.960,Human UTI,23-5,109,95,0,204,53.431,53.431
7,0.960,unknown,16-23,0,1,0,1,0.000,0.000
7,0.960,unknown,23-5,3,3,0,6,50.000,50.000
7,0.960,SLO Creek Water,16-23,0,0,0,0,NaN,NaN
7,0.960,SLO Creek Water,23-5,0,0,0,0,NaN,NaN
7,0.960,Pig/Swine,16-23,9,8,0,17,52.941,52.941
7,0.960,Pig/Swine,23-5,12,9,0,21,57.143,57.143
7,0.960,Klebsiella,16-23,0,0,0,0,NaN,NaN
7,0.960,Klebsiella,23-5,0,0,0,0,NaN,NaN
7,0.960,Hu Cw and Dg,16-23,11,24,0,35,31.429,31.429
7,0.960,Hu Cw and Dg,23-5,15,22,0,37,40.541,40.541
7,0.960,Ground Squirrel,16-23,97,71,0,168,57.738,57.738
7,0.960,Ground Squirrel,23-5,89,73,0,162,54.938,54.938
7,0.960,Opossum,16-23,0,2,0,2,0.000,0.000
7,0.960,Opossum,23-5,0,4,0,4,0.000,0.000
7,0.960,Cow,16-23,1560,1003,0,2563,60.866,60.866
7,0.960,Cow,23-5,1512,1282,0,2794,54.116,54.116
7,0.960,Deer Mouse,16-23,0,0,0,0,NaN,NaN
7,0.960,Deer Mouse,23-5,0,0,0,0,NaN,NaN
7,0.960,OVERALL,16-23,3919,2397,0,6316,62.049,62.049
7,0.960,OVERALL,23-5,4596,2984,0,7580,60.633,60.633
7,0.970,Chicken,16-23,3,14,0,17,17.647,17.647
7,0.970,Chicken,23-5,13,9,0,22,59.091,59.091
7,0.970,Sea Lion,16-23,0,1,0,1,0.000,0.000
7,0.970,Sea Lion,23-5,3,8,0,11,27.273,27.273
7,0.970,Hu and Cw,16-23,9,13,0,22,40.909,40.909
7,0.970,Hu and Cw,23-5,4,22,0,26,15.385,15.385
7,0.970,Sheep,16-23,57,54,0,111,51.351,51.351
7,0.970,Sheep,23-5,63,38,0,101,62.376,62.376
7,0.970,Hu and Dg,16-23,10,15,0,25,40.000,40.000
7,0.970,Hu and Dg,23-5,19,17,0,36,52.778,52.778
7,0.970,Common Loon,16-23,0,0,0,0,NaN,NaN
7,0.970,Common Loon,23-5,0,4,0,4,0.000,0.000
7,0.970,Red-Winged Blackbird,16-23,0,10,0,10,0.000,0.000
7,0.970,Red-Winged Blackbird,23-5,0,1,0,1,0.000,0.000
7,0.970,Cw,16-23,11,11,0,22,50.000,50.000
7,0.970,Cw,23-5,20,43,0,63,31.746,31.746
7,0.970,Cliff Sparrow,16-23,3,25,0,28,10.714,10.714
7,0.970,Cliff Sparrow,23-5,2,7,0,9,22.222,22.222
7,0.970,Pig,16-23,13,10,0,23,56.522,56.522
7,0.970,Pig,23-5,5,11,0,16,31.250,31.250
7,0.970,Barn Owl,16-23,0,0,0,0,NaN,NaN
7,0.970,Barn Owl,23-5,0,0,0,0,NaN,NaN
7,0.970,Wild Pig,16-23,3,1,0,4,75.000,75.000
7,0.970,Wild Pig,23-5,3,2,0,5,60.000,60.000
7,0.970,Pennington Creek Water,16-23,0,0,0,0,NaN,NaN
7,0.970,Pennington Creek Water,23-5,0,0,0,0,NaN,NaN
7,0.970,Guinni,16-23,0,0,0,0,NaN,NaN
7,0.970,Guinni,23-5,0,0,0,0,NaN,NaN
7,0.970,Racoon,16-23,0,0,0,0,NaN,NaN
7,0.970,Racoon,23-5,0,0,0,0,NaN,NaN
7,0.970,Hu,16-23,16,17,0,33,48.485,48.485
7,0.970,Hu,23-5,21,11,0,32,65.625,65.625
7,0.970,Cw and Dg,16-23,4,14,0,18,22.222,22.222
7,0.970,Cw and Dg,23-5,18,21,0,39,46.154,46.154
7,0.970,Red Wind Blackbird,16-23,0,0,0,0,NaN,NaN
7,0.970,Red Wind Blackbird,23-5,0,0,0,0,NaN,NaN
7,0.970,Tree Swallow,16-23,0,0,0,0,NaN,NaN
7,0.970,Tree Swallow,23-5,0,1,0,1,0.000,0.000
7,0.970,Turkey Vulture,16-23,0,0,0,0,NaN,NaN
7,0.970,Turkey Vulture,23-5,0,0,0,0,NaN,NaN
7,0.970,Dg,16-23,8,12,0,20,40.000,40.000
7,0.970,Dg,23-5,31,30,0,61,50.820,50.820
7,0.970,Western Kingbird,16-23,0,0,0,0,NaN,NaN
7,0.970,Western Kingbird,23-5,0,0,0,0,NaN,NaN
7,0.970,White Crowned Sparrow,16-23,0,5,0,5,0.000,0.000
7,0.970,White Crowned Sparrow,23-5,3,11,0,14,21.429,21.429
7,0.970,Eared Grebe,16-23,0,0,0,0,NaN,NaN
7,0.970,Eared Grebe,23-5,0,16,0,16,0.000,0.000
7,0.970,cougar,16-23,0,0,0,0,NaN,NaN
7,0.970,cougar,23-5,0,0,0,0,NaN,NaN
7,0.970,Ocean Water,16-23,0,0,0,0,NaN,NaN
7,0.970,Ocean Water,23-5,0,0,0,0,NaN,NaN
7,0.970,Red Tailed Hawk,16-23,0,1,0,1,0.000,0.000
7,0.970,Red Tailed Hawk,23-5,0,5,0,5,0.000,0.000
7,0.970,Dog,16-23,66,74,0,140,47.143,47.143
7,0.970,Dog,23-5,117,131,0,248,47.177,47.177
7,0.970,Human,16-23,1757,654,0,2411,72.874,72.874
7,0.970,Human,23-5,2220,498,0,2718,81.678,81.678
7,0.970,Wild Turkey,16-23,10,20,0,30,33.333,33.333
7,0.970,Wild Turkey,23-5,3,33,0,36,8.333,8.333
7,0.970,Clark Grebe,16-23,0,0,0,0,NaN,NaN
7,0.970,Clark Grebe,23-5,0,0,0,0,NaN,NaN
7,0.970,Seagull,16-23,0,0,0,0,NaN,NaN
7,0.970,Seagull,23-5,44,8,0,52,84.615,84.615
7,0.970,Surf Scoter,16-23,0,0,0,0,NaN,NaN
7,0.970,Surf Scoter,23-5,0,2,0,2,0.000,0.000
7,0.970,Pigeon,16-23,98,164,0,262,37.405,37.405
7,0.970,Pigeon,23-5,142,251,0,393,36.132,36.132
7,0.970,Pacific Ocean Water,16-23,0,0,0,0,NaN,NaN
7,0.970,Pacific Ocean Water,23-5,0,0,0,0,NaN,NaN
7,0.970,Cat,16-23,27,33,0,60,45.000,45.000
7,0.970,Cat,23-5,35,32,0,67,52.239,52.239
7,0.970,Horse,16-23,8,25,0,33,24.242,24.242
7,0.970,Horse,23-5,34,172,0,206,16.505,16.505
7,0.970,orangutan,16-23,0,0,0,0,NaN,NaN
7,0.970,orangutan,23-5,0,0,0,0,NaN,NaN
7,0.970,Bat,16-23,36,20,0,56,64.286,64.286
7,0.970,Bat,23-5,37,28,0,65,56.923,56.923
7,0.970,Deer,16-23,16,21,0,37,43.243,43.243
7,0.970,Deer,23-5,18,92,0,110,16.364,16.364
7,0.970,Great Horned Owl,16-23,0,0,0,0,NaN,NaN
7,0.970,Great Horned Owl,23-5,0,6,0,6,0.000,0.000
7,0.970,Freshwater Lagoon,16-23,0,0,0,0,NaN,NaN
7,0.970,Freshwater Lagoon,23-5,0,0,0,0,NaN,NaN
7,0.970,Unknown Avian,16-23,0,0,0,0,NaN,NaN
7,0.970,Unknown Avian,23-5,0,0,0,0,NaN,NaN
7,0.970,Human UTI,16-23,83,77,0,160,51.875,51.875
7,0.970,Human UTI,23-5,108,94,0,202,53.465,53.465
7,0.970,unknown,16-23,0,1,0,1,0.000,0.000
7,0.970,unknown,23-5,3,3,0,6,50.000,50.000
7,0.970,SLO Creek Water,16-23,0,0,0,0,NaN,NaN
7,0.970,SLO Creek Water,23-5,0,0,0,0,NaN,NaN
7,0.970,Pig/Swine,16-23,9,8,0,17,52.941,52.941
7,0.970,Pig/Swine,23-5,12,9,0,21,57.143,57.143
7,0.970,Klebsiella,16-23,0,0,0,0,NaN,NaN
7,0.970,Klebsiella,23-5,0,0,0,0,NaN,NaN
7,0.970,Hu Cw and Dg,16-23,11,24,0,35,31.429,31.429
7,0.970,Hu Cw and Dg,23-5,15,22,0,37,40.541,40.541
7,0.970,Ground Squirrel,16-23,96,68,0,164,58.537,58.537
7,0.970,Ground Squirrel,23-5,89,71,0,160,55.625,55.625
7,0.970,Opossum,16-23,0,2,0,2,0.000,0.000
7,0.970,Opossum,23-5,0,4,0,4,0.000,0.000
7,0.970,Cow,16-23,1554,1004,0,2558,60.751,60.751
7,0.970,Cow,23-5,1509,1257,0,2766,54.555,54.555
7,0.970,Deer Mouse,16-23,0,0,0,0,NaN,NaN
7,0.970,Deer Mouse,23-5,0,0,0,0,NaN,NaN
7,0.970,OVERALL,16-23,3908,2398,0,6306,61.973,61.973
7,0.970,OVERALL,23-5,4591,2970,0,7561,60.719,60.719
7,0.980,Chicken,16-23,3,14,0,17,17.647,17.647
7,0.980,Chicken,23-5,14,9,0,23,60.870,60.870
7,0.980,Sea Lion,16-23,0,1,0,1,0.000,0.000
7,0.980,Sea Lion,23-5,3,7,0,10,30.000,30.000
7,0.980,Hu and Cw,16-23,9,13,0,22,40.909,40.909
7,0.980,Hu and Cw,23-5,4,32,0,36,11.111,11.111
7,0.980,Sheep,16-23,57,52,0,109,52.294,52.294
7,0.980,Sheep,23-5,62,37,0,99,62.626,62.626
7,0.980,Hu and Dg,16-23,10,15,0,25,40.000,40.000
7,0.980,Hu and Dg,23-5,19,15,0,34,55.882,55.882
7,0.980,Common Loon,16-23,0,0,0,0,NaN,NaN
7,0.980,Common Loon,23-5,0,4,0,4,0.000,0.000
7,0.980,Red-Winged Blackbird,16-23,0,10,0,10,0.000,0.000
7,0.980,Red-Winged Blackbird,23-5,0,1,0,1,0.000,0.000
7,0.980,Cw,16-23,11,10,0,21,52.381,52.381
7,0.980,Cw,23-5,20,43,0,63,31.746,31.746
7,0.980,Cliff Sparrow,16-23,3,24,0,27,11.111,11.111
7,0.980,Cliff Sparrow,23-5,2,7,0,9,22.222,22.222
7,0.980,Pig,16-23,13,10,0,23,56.522,56.522
7,0.980,Pig,23-5,5,11,0,16,31.250,31.250
7,0.980,Barn Owl,16-23,0,0,0,0,NaN,NaN
7,0.980,Barn Owl,23-5,0,0,0,0,NaN,NaN
7,0.980,Wild Pig,16-23,3,1,0,4,75.000,75.000
7,0.980,Wild Pig,23-5,3,2,0,5,60.000,60.000
7,0.980,Pennington Creek Water,16-23,0,0,0,0,NaN,NaN
7,0.980,Pennington Creek Water,23-5,0,0,0,0,NaN,NaN
7,0.980,Guinni,16-23,0,0,0,0,NaN,NaN
7,0.980,Guinni,23-5,0,0,0,0,NaN,NaN
7,0.980,Racoon,16-23,0,0,0,0,NaN,NaN
7,0.980,Racoon,23-5,0,0,0,0,NaN,NaN
7,0.980,Hu,16-23,16,17,0,33,48.485,48.485
7,0.980,Hu,23-5,21,12,0,33,63.636,63.636
7,0.980,Cw and Dg,16-23,4,14,0,18,22.222,22.222
7,0.980,Cw and Dg,23-5,18,20,0,38,47.368,47.368
7,0.980,Red Wind Blackbird,16-23,0,0,0,0,NaN,NaN
7,0.980,Red Wind Blackbird,23-5,0,0,0,0,NaN,NaN
7,0.980,Tree Swallow,16-23,0,0,0,0,NaN,NaN
7,0.980,Tree Swallow,23-5,0,1,0,1,0.000,0.000
7,0.980,Turkey Vulture,16-23,0,0,0,0,NaN,NaN
7,0.980,Turkey Vulture,23-5,0,0,0,0,NaN,NaN
7,0.980,Dg,16-23,8,12,0,20,40.000,40.000
7,0.980,Dg,23-5,31,24,0,55,56.364,56.364
7,0.980,Western Kingbird,16-23,0,0,0,0,NaN,NaN
7,0.980,Western Kingbird,23-5,0,0,0,0,NaN,NaN
7,0.980,White Crowned Sparrow,16-23,0,3,0,3,0.000,0.000
7,0.980,White Crowned Sparrow,23-5,3,11,0,14,21.429,21.429
7,0.980,Eared Grebe,16-23,0,0,0,0,NaN,NaN
7,0.980,Eared Grebe,23-5,0,16,0,16,0.000,0.000
7,0.980,cougar,16-23,0,0,0,0,NaN,NaN
7,0.980,cougar,23-5,0,0,0,0,NaN,NaN
7,0.980,Ocean Water,16-23,0,0,0,0,NaN,NaN
7,0.980,Ocean Water,23-5,0,0,0,0,NaN,NaN
7,0.980,Red Tailed Hawk,16-23,0,1,0,1,0.000,0.000
7,0.980,Red Tailed Hawk,23-5,0,4,0,4,0.000,0.000
7,0.980,Dog,16-23,65,78,0,143,45.455,45.455
7,0.980,Dog,23-5,117,128,0,245,47.755,47.755
7,0.980,Human,16-23,1760,644,0,2404,73.211,73.211
7,0.980,Human,23-5,2222,488,0,2710,81.993,81.993
7,0.980,Wild Turkey,16-23,10,20,0,30,33.333,33.333
7,0.980,Wild Turkey,23-5,5,37,0,42,11.905,11.905
7,0.980,Clark Grebe,16-23,0,0,0,0,NaN,NaN
7,0.980,Clark Grebe,23-5,0,0,0,0,NaN,NaN
7,0.980,Seagull,16-23,0,0,0,0,NaN,NaN
7,0.980,Seagull,23-5,46,6,0,52,88.462,88.462
7,0.980,Surf Scoter,16-23,0,0,0,0,NaN,NaN
7,0.980,Surf Scoter,23-5,2,0,0,2,100.000,100.000
7,0.980,Pigeon,16-23,98,162,0,260,37.692,37.692
7,0.980,Pigeon,23-5,141,257,0,398,35.427,35.427
7,0.980,Pacific Ocean Water,16-23,0,0,0,0,NaN,NaN
7,0.980,Pacific Ocean Water,23-5,0,0,0,0,NaN,NaN
7,0.980,Cat,16-23,27,31,0,58,46.552,46.552
7,0.980,Cat,23-5,35,30,0,65,53.846,53.846
7,0.980,Horse,16-23,8,25,0,33,24.242,24.242
7,0.980,Horse,23-5,34,169,0,203,16.749,16.749
7,0.980,orangutan,16-23,0,0,0,0,NaN,NaN
7,0.980,orangutan,23-5,0,0,0,0,NaN,NaN
7,0.980,Bat,16-23,36,20,0,56,64.286,64.286
7,0.980,Bat,23-5,37,27,0,64,57.813,57.813
7,0.980,Deer,16-23,16,21,0,37,43.243,43.243
7,0.980,Deer,23-5,18,92,0,110,16.364,16.364
7,0.980,Great Horned Owl,16-23,0,0,0,0,NaN,NaN
7,0.980,Great Horned Owl,23-5,0,6,0,6,0.000,0.000
7,0.980,Freshwater Lagoon,16-23,0,0,0,0,NaN,NaN
7,0.980,Freshwater Lagoon,23-5,0,0,0,0,NaN,NaN
7,0.980,Unknown Avian,16-23,0,0,0,0,NaN,NaN
7,0.980,Unknown Avian,23-5,0,0,0,0,NaN,NaN
7,0.980,Human UTI,16-23,83,80,0,163,50.920,50.920
7,0.980,Human UTI,23-5,108,92,0,200,54.000,54.000
7,0.980,unknown,16-23,0,1,0,1,0.000,0.000
7,0.980,unknown,23-5,3,4,0,7,42.857,42.857
7,0.980,SLO Creek Water,16-23,0,0,0,0,NaN,NaN
7,0.980,SLO Creek Water,23-5,0,0,0,0,NaN,NaN
7,0.980,Pig/Swine,16-23,9,8,0,17,52.941,52.941
7,0.980,Pig/Swine,23-5,12,9,0,21,57.143,57.143
7,0.980,Klebsiella,16-23,0,0,0,0,NaN,NaN
7,0.980,Klebsiella,23-5,0,0,0,0,NaN,NaN
7,0.980,Hu Cw and Dg,16-23,11,24,0,35,31.429,31.429
7,0.980,Hu Cw and Dg,23-5,15,20,0,35,42.857,42.857
7,0.980,Ground Squirrel,16-23,97,70,0,167,58.084,58.084
7,0.980,Ground Squirrel,23-5,89,70,0,159,55.975,55.975
7,0.980,Opossum,16-23,0,2,0,2,0.000,0.000
7,0.980,Opossum,23-5,0,4,0,4,0.000,0.000
7,0.980,Cow,16-23,1547,991,0,2538,60.954,60.954
7,0.980,Cow,23-5,1503,1235,0,2738,54.894,54.894
7,0.980,Deer Mouse,16-23,0,0,0,0,NaN,NaN
7,0.980,Deer Mouse,23-5,0,0,0,0,NaN,NaN
7,0.980,OVERALL,16-23,3904,2374,0,6278,62.185,62.185
7,0.980,OVERALL,23-5,4592,2930,0,7522,61.048,61.048
7,0.990,Chicken,16-23,4,18,0,22,18.182,18.182
7,0.990,Chicken,23-5,15,8,0,23,65.217,65.217
7,0.990,Sea Lion,16-23,0,1,0,1,0.000,0.000
7,0.990,Sea Lion,23-5,4,6,0,10,40.000,40.000
7,0.990,Hu and Cw,16-23,10,13,0,23,43.478,43.478
7,0.990,Hu and Cw,23-5,5,33,0,38,13.158,13.158
7,0.990,Sheep,16-23,56,51,0,107,52.336,52.336
7,0.990,Sheep,23-5,63,36,0,99,63.636,63.636
7,0.990,Hu and Dg,16-23,10,16,0,26,38.462,38.462
7,0.990,Hu and Dg,23-5,19,10,0,29,65.517,65.517
7,0.990,Common Loon,16-23,0,0,0,0,NaN,NaN
7,0.990,Common Loon,23-5,0,5,0,5,0.000,0.000
7,0.990,Red-Winged Blackbird,16-23,0,9,0,9,0.000,0.000
7,0.990,Red-Winged Blackbird,23-5,0,1,0,1,0.000,0.000
7,0.990,Cw,16-23,11,10,0,21,52.381,52.381
7,0.990,Cw,23-5,20,41,0,61,32.787,32.787
7,0.990,Cliff Sparrow,16-23,3,24,0,27,11.111,11.111
7,0.990,Cliff Sparrow,23-5,2,10,0,12,16.667,16.667
7,0.990,Pig,16-23,13,11,0,24,54.167,54.167
7,0.990,Pig,23-5,9,9,0,18,50.000,50.000
7,0.990,Barn Owl,16-23,0,0,0,0,NaN,NaN
7,0.990,Barn Owl,23-5,0,0,0,0,NaN,NaN
7,0.990,Wild Pig,16-23,3,2,0,5,60.000,60.000
7,0.990,Wild Pig,23-5,3,2,0,5,60.000,60.000
7,0.990,Pennington Creek Water,16-23,0,0,0,0,NaN,NaN
7,0.990,Pennington Creek Water,23-5,0,0,0,0,NaN,NaN
7,0.990,Guinni,16-23,0,0,0,0,NaN,NaN
7,0.990,Guinni,23-5,0,0,0,0,NaN,NaN
7,0.990,Racoon,16-23,0,0,0,0,NaN,NaN
7,0.990,Racoon,23-5,0,1,0,1,0.000,0.000
7,0.990,Hu,16-23,16,15,0,31,51.613,51.613
7,0.990,Hu,23-5,21,9,0,30,70.000,70.000
7,0.990,Cw and Dg,16-23,4,14,0,18,22.222,22.222
7,0.990,Cw and Dg,23-5,18,14,0,32,56.250,56.250
7,0.990,Red Wind Blackbird,16-23,0,0,0,0,NaN,NaN
7,0.990,Red Wind Blackbird,23-5,0,0,0,0,NaN,NaN
7,0.990,Tree Swallow,16-23,0,0,0,0,NaN,NaN
7,0.990,Tree Swallow,23-5,0,1,0,1,0.000,0.000
7,0.990,Turkey Vulture,16-23,0,0,0,0,NaN,NaN
7,0.990,Turkey Vulture,23-5,0,0,0,0,NaN,NaN
7,0.990,Dg,16-23,8,13,0,21,38.095,38.095
7,0.990,Dg,23-5,31,20,0,51,60.784,60.784
7,0.990,Western Kingbird,16-23,0,0,0,0,NaN,NaN
7,0.990,Western Kingbird,23-5,0,0,0,0,NaN,NaN
7,0.990,White Crowned Sparrow,16-23,0,3,0,3,0.000,0.000
7,0.990,White Crowned Sparrow,23-5,3,10,0,13,23.077,23.077
7,0.990,Eared Grebe,16-23,0,0,0,0,NaN,NaN
7,0.990,Eared Grebe,23-5,0,14,0,14,0.000,0.000
7,0.990,cougar,16-23,0,1,0,1,0.000,0.000
7,0.990,cougar,23-5,0,0,0,0,NaN,NaN
7,0.990,Ocean Water,16-23,0,0,0,0,NaN,NaN
7,0.990,Ocean Water,23-5,0,0,0,0,NaN,NaN
7,0.990,Red Tailed Hawk,16-23,0,1,0,1,0.000,0.000
7,0.990,Red Tailed Hawk,23-5,0,5,0,5,0.000,0.000
7,0.990,Dog,16-23,67,76,0,143,46.853,46.853
7,0.990,Dog,23-5,118,120,0,238,49.580,49.580
7,0.990,Human,16-23,1747,617,0,2364,73.900,73.900
7,0.990,Human,23-5,2210,453,0,2663,82.989,82.989
7,0.990,Wild Turkey,16-23,11,24,0,35,31.429,31.429
7,0.990,Wild Turkey,23-5,5,35,0,40,12.500,12.500
7,0.990,Clark Grebe,16-23,0,0,0,0,NaN,NaN
7,0.990,Clark Grebe,23-5,2,3,0,5,40.000,40.000
7,0.990,Seagull,16-23,0,0,0,0,NaN,NaN
7,0.990,Seagull,23-5,48,5,0,53,90.566,90.566
7,0.990,Surf Scoter,16-23,0,0,0,0,NaN,NaN
7,0.990,Surf Scoter,23-5,2,0,0,2,100.000,100.000
7,0.990,Pigeon,16-23,101,153,0,254,39.764,39.764
7,0.990,Pigeon,23-5,146,247,0,393,37.150,37.150
7,0.990,Pacific Ocean Water,16-23,0,0,0,0,NaN,NaN
7,0.990,Pacific Ocean Water,23-5,0,0,0,0,NaN,NaN
7,0.990,Cat,16-23,27,28,0,55,49.091,49.091
7,0.990,Cat,23-5,35,32,0,67,52.239,52.239
7,0.990,Horse,16-23,11,25,0,36,30.556,30.556
7,0.990,Horse,23-5,33,175,0,208,15.865,15.865
7,0.990,orangutan,16-23,0,0,0,0,NaN,NaN
7,0.990,orangutan,23-5,0,0,0,0,NaN,NaN
7,0.990,Bat,16-23,36,19,0,55,65.455,65.455
7,0.990,Bat,23-5,37,27,0,64,57.813,57.813
7,0.990,Deer,16-23,16,22,0,38,42.105,42.105
7,0.990,Deer,23-5,18,90,0,108,16.667,16.667
7,0.990,Great Horned Owl,16-23,0,0,0,0,NaN,NaN
7,0.990,Great Horned Owl,23-5,0,6,0,6,0.000,0.000
7,0.990,Freshwater Lagoon,16-23,0,0,0,0,NaN,NaN
7,0.990,Freshwater Lagoon,23-5,0,0,0,0,NaN,NaN
7,0.990,Unknown Avian,16-23,0,0,0,0,NaN,NaN
7,0.990,Unknown Avian,23-5,0,0,0,0,NaN,NaN
7,0.990,Human UTI,16-23,87,73,0,160,54.375,54.375
7,0.990,Human UTI,23-5,109,79,0,188,57.979,57.979
7,0.990,unknown,16-23,0,1,0,1,0.000,0.000
7,0.990,unknown,23-5,3,5,0,8,37.500,37.500
7,0.990,SLO Creek Water,16-23,0,0,0,0,NaN,NaN
7,0.990,SLO Creek Water,23-5,0,0,0,0,NaN,NaN
7,0.990,Pig/Swine,16-23,9,9,0,18,50.000,50.000
7,0.990,Pig/Swine,23-5,12,9,0,21,57.143,57.143
7,0.990,Klebsiella,16-23,0,0,0,0,NaN,NaN
7,0.990,Klebsiella,23-5,0,0,0,0,NaN,NaN
7,0.990,Hu Cw and Dg,16-23,11,24,0,35,31.429,31.429
7,0.990,Hu Cw and Dg,23-5,15,21,0,36,41.667,41.667
7,0.990,Ground Squirrel,16-23,98,66,0,164,59.756,59.756
7,0.990,Ground Squirrel,23-5,90,70,0,160,56.250,56.250
7,0.990,Opossum,16-23,1,2,0,3,33.333,33.333
7,0.990,Opossum,23-5,2,4,0,6,33.333,33.333
7,0.990,Cow,16-23,1512,912,0,2424,62.376,62.376
7,0.990,Cow,23-5,1472,1140,0,2612,56.355,56.355
7,0.990,Deer Mouse,16-23,0,0,0,0,NaN,NaN
7,0.990,Deer Mouse,23-5,0,0,0,0,NaN,NaN
7,0.990,OVERALL,16-23,3872,2253,0,6125,63.216,63.216
7,0.990,OVERALL,23-5,4570,2756,0,7326,62.381,62.381
7,1.000,Chicken,16-23,0,0,0,0,NaN,NaN
7,1.000,Chicken,23-5,0,0,0,0,NaN,NaN
7,1.000,Sea Lion,16-23,0,0,0,0,NaN,NaN
7,1.000,Sea Lion,23-5,0,0,0,0,NaN,NaN
7,1.000,Hu and Cw,16-23,0,0,0,0,NaN,NaN
7,1.000,Hu and Cw,23-5,0,0,0,0,NaN,NaN
7,1.000,Sheep,16-23,0,0,0,0,NaN,NaN
7,1.000,Sheep,23-5,0,0,0,0,NaN,NaN
7,1.000,Hu and Dg,16-23,0,0,0,0,NaN,NaN
7,1.000,Hu and Dg,23-5,0,0,0,0,NaN,NaN
7,1.000,Common Loon,16-23,0,0,0,0,NaN,NaN
7,1.000,Common Loon,23-5,0,0,0,0,NaN,NaN
7,1.000,Red-Winged Blackbird,16-23,0,0,0,0,NaN,NaN
7,1.000,Red-Winged Blackbird,23-5,0,0,0,0,NaN,NaN
7,1.000,Cw,16-23,0,0,0,0,NaN,NaN
7,1.000,Cw,23-5,0,0,0,0,NaN,NaN
7,1.000,Cliff Sparrow,16-23,0,0,0,0,NaN,NaN
7,1.000,Cliff Sparrow,23-5,0,0,0,0,NaN,NaN
7,1.000,Pig,16-23,0,0,0,0,NaN,NaN
7,1.000,Pig,23-5,0,0,0,0,NaN,NaN
7,1.000,Barn Owl,16-23,0,0,0,0,NaN,NaN
7,1.000,Barn Owl,23-5,0,0,0,0,NaN,NaN
7,1.000,Wild Pig,16-23,0,0,0,0,NaN,NaN
7,1.000,Wild Pig,23-5,0,0,0,0,NaN,NaN
7,1.000,Pennington Creek Water,16-23,0,0,0,0,NaN,NaN
7,1.000,Pennington Creek Water,23-5,0,0,0,0,NaN,NaN
7,1.000,Guinni,16-23,0,0,0,0,NaN,NaN
7,1.000,Guinni,23-5,0,0,0,0,NaN,NaN
7,1.000,Racoon,16-23,0,0,0,0,NaN,NaN
7,1.000,Racoon,23-5,0,0,0,0,NaN,NaN
7,1.000,Hu,16-23,0,0,0,0,NaN,NaN
7,1.000,Hu,23-5,0,0,0,0,NaN,NaN
7,1.000,Cw and Dg,16-23,0,0,0,0,NaN,NaN
7,1.000,Cw and Dg,23-5,0,0,0,0,NaN,NaN
7,1.000,Red Wind Blackbird,16-23,0,0,0,0,NaN,NaN
7,1.000,Red Wind Blackbird,23-5,0,0,0,0,NaN,NaN
7,1.000,Tree Swallow,16-23,0,0,0,0,NaN,NaN
7,1.000,Tree Swallow,23-5,0,0,0,0,NaN,NaN
7,1.000,Turkey Vulture,16-23,0,0,0,0,NaN,NaN
7,1.000,Turkey Vulture,23-5,0,0,0,0,NaN,NaN
7,1.000,Dg,16-23,0,0,0,0,NaN,NaN
7,1.000,Dg,23-5,0,0,0,0,NaN,NaN
7,1.000,Western Kingbird,16-23,0,0,0,0,NaN,NaN
7,1.000,Western Kingbird,23-5,0,0,0,0,NaN,NaN
7,1.000,White Crowned Sparrow,16-23,0,0,0,0,NaN,NaN
7,1.000,White Crowned Sparrow,23-5,0,0,0,0,NaN,NaN
7,1.000,Eared Grebe,16-23,0,0,0,0,NaN,NaN
7,1.000,Eared Grebe,23-5,0,0,0,0,NaN,NaN
7,1.000,cougar,16-23,0,0,0,0,NaN,NaN
7,1.000,cougar,23-5,0,0,0,0,NaN,NaN
7,1.000,Ocean Water,16-23,0,0,0,0,NaN,NaN
7,1.000,Ocean Water,23-5,0,0,0,0,NaN,NaN
7,1.000,Red Tailed Hawk,16-23,0,0,0,0,NaN,NaN
7,1.000,Red Tailed Hawk,23-5,0,0,0,0,NaN,NaN
7,1.000,Dog,16-23,0,0,0,0,NaN,NaN
7,1.000,Dog,23-5,0,0,0,0,NaN,NaN
7,1.000,Human,16-23,68,0,0,68,100.000,100.000
7,1.000,Human,23-5,90,0,0,90,100.000,100.000
7,1.000,Wild Turkey,16-23,0,0,0,0,NaN,NaN
7,1.000,Wild Turkey,23-5,0,0,0,0,NaN,NaN
7,1.000,Clark Grebe,16-23,0,0,0,0,NaN,NaN
7,1.000,Clark Grebe,23-5,0,0,0,0,NaN,NaN
7,1.000,Seagull,16-23,0,0,0,0,NaN,NaN
7,1.000,Seagull,23-5,0,0,0,0,NaN,NaN
7,1.000,Surf Scoter,16-23,0,0,0,0,NaN,NaN
7,1.000,Surf Scoter,23-5,0,0,0,0,NaN,NaN
7,1.000,Pigeon,16-23,0,0,0,0,NaN,NaN
7,1.000,Pigeon,23-5,0,0,0,0,NaN,NaN
7,1.000,Pacific Ocean Water,16-23,0,0,0,0,NaN,NaN
7,1.000,Pacific Ocean Water,23-5,0,0,0,0,NaN,NaN
7,1.000,Cat,16-23,0,0,0,0,NaN,NaN
7,1.000,Cat,23-5,0,0,0,0,NaN,NaN
7,1.000,Horse,16-23,0,0,0,0,NaN,NaN
7,1.000,Horse,23-5,0,0,0,0,NaN,NaN
7,1.000,orangutan,16-23,0,0,0,0,NaN,NaN
7,1.000,orangutan,23-5,0,0,0,0,NaN,NaN
7,1.000,Bat,16-23,0,0,0,0,NaN,NaN
7,1.000,Bat,23-5,0,0,0,0,NaN,NaN
7,1.000,Deer,16-23,0,0,0,0,NaN,NaN
7,1.000,Deer,23-5,0,0,0,0,NaN,NaN
7,1.000,Great Horned Owl,16-23,0,0,0,0,NaN,NaN
7,1.000,Great Horned Owl,23-5,0,0,0,0,NaN,NaN
7,1.000,Freshwater Lagoon,16-23,0,0,0,0,NaN,NaN
7,1.000,Freshwater Lagoon,23-5,0,0,0,0,NaN,NaN
7,1.000,Unknown Avian,16-23,0,0,0,0,NaN,NaN
7,1.000,Unknown Avian,23-5,0,0,0,0,NaN,NaN
7,1.000,Human UTI,16-23,0,0,0,0,NaN,NaN
7,1.000,Human UTI,23-5,0,0,0,0,NaN,NaN
7,1.000,unknown,16-23,0,0,0,0,NaN,NaN
7,1.000,unknown,23-5,0,0,0,0,NaN,NaN
7,1.000,SLO Creek Water,16-23,0,0,0,0,NaN,NaN
7,1.000,SLO Creek Water,23-5,0,0,0,0,NaN,NaN
7,1.000,Pig/Swine,16-23,0,0,0,0,NaN,NaN
7,1.000,Pig/Swine,23-5,0,0,0,0,NaN,NaN
7,1.000,Klebsiella,16-23,0,0,0,0,NaN,NaN
7,1.000,Klebsiella,23-5,0,0,0,0,NaN,NaN
7,1.000,Hu Cw and Dg,16-23,0,0,0,0,NaN,NaN
7,1.000,Hu Cw and Dg,23-5,0,0,0,0,NaN,NaN
7,1.000,Ground Squirrel,16-23,0,0,0,0,NaN,NaN
7,1.000,Ground Squirrel,23-5,0,0,0,0,NaN,NaN
7,1.000,Opossum,16-23,0,0,0,0,NaN,NaN
7,1.000,Opossum,23-5,0,0,0,0,NaN,NaN
7,1.000,Cow,16-23,0,0,0,0,NaN,NaN
7,1.000,Cow,23-5,0,0,0,0,NaN,NaN
7,1.000,Deer Mouse,16-23,0,0,0,0,NaN,NaN
7,1.000,Deer Mouse,23-5,0,0,0,0,NaN,NaN
7,1.000,OVERALL,16-23,68,0,0,68,100.000,100.000
7,1.000,OVERALL,23-5,90,0,0,90,100.000,100.000
8,0.000,Chicken,16-23,0,6,0,6,0.000,0.000
8,0.000,Chicken,23-5,8,8,0,16,50.000,50.000
8,0.000,Sea Lion,16-23,0,1,0,1,0.000,0.000
8,0.000,Sea Lion,23-5,3,9,0,12,25.000,25.000
8,0.000,Hu and Cw,16-23,6,14,0,20,30.000,30.000
8,0.000,Hu and Cw,23-5,3,11,0,14,21.429,21.429
8,0.000,Sheep,16-23,54,52,0,106,50.943,50.943
8,0.000,Sheep,23-5,61,44,0,105,58.095,58.095
8,0.000,Hu and Dg,16-23,10,16,0,26,38.462,38.462
8,0.000,Hu and Dg,23-5,20,17,0,37,54.054,54.054
8,0.000,Common Loon,16-23,0,0,0,0,NaN,NaN
8,0.000,Common Loon,23-5,0,4,0,4,0.000,0.000
8,0.000,Red-Winged Blackbird,16-23,0,4,0,4,0.000,0.000
8,0.000,Red-Winged Blackbird,23-5,0,2,0,2,0.000,0.000
8,0.000,Cw,16-23,12,10,0,22,54.545,54.545
8,0.000,Cw,23-5,15,42,0,57,26.316,26.316
8,0.000,Cliff Sparrow,16-23,3,19,0,22,13.636,13.636
8,0.000,Cliff Sparrow,23-5,0,7,0,7,0.000,0.000
8,0.000,Pig,16-23,10,9,0,19,52.632,52.632
8,0.000,Pig,23-5,5,8,0,13,38.462,38.462
8,0.000,Barn Owl,16-23,0,0,0,0,NaN,NaN
8,0.000,Barn Owl,23-5,0,0,0,0,NaN,NaN
8,0.000,Wild Pig,16-23,2,1,0,3,66.667,66.667
8,0.000,Wild Pig,23-5,2,2,0,4,50.000,50.000
8,0.000,Pennington Creek Water,16-23,0,0,0,0,NaN,NaN
8,0.000,Pennington Creek Water,23-5,0,0,0,0,NaN,NaN
8,0.000,Guinni,16-23,0,0,0,0,NaN,NaN
8,0.000,Guinni,23-5,0,0,0,0,NaN,NaN
8,0.000,Racoon,16-23,0,0,0,0,NaN,NaN
8,0.000,Racoon,23-5,0,0,0,0,NaN,NaN
8,0.000,Hu,16-23,15,17,0,32,46.875,46.875
8,0.000,Hu,23-5,22,16,0,38,57.895,57.895
8,0.000,Cw and Dg,16-23,9,17,0,26,34.615,34.615
8,0.000,Cw and Dg,23-5,15,19,0,34,44.118,44.118
8,0.000,Red Wind Blackbird,16-23,0,0,0,0,NaN,NaN
8,0.000,Red Wind Blackbird,23-5,0,0,0,0,NaN,NaN
8,0.000,Tree Swallow,16-23,0,0,0,0,NaN,NaN
8,0.000,Tree Swallow,23-5,0,0,0,0,NaN,NaN
8,0.000,Turkey Vulture,16-23,0,0,0,0,NaN,NaN
8,0.000,Turkey Vulture,23-5,0,0,0,0,NaN,NaN
8,0.000,Dg,16-23,6,11,0,17,35.294,35.294
8,0.000,Dg,23-5,31,31,0,62,50.000,50.000
8,0.000,Western Kingbird,16-23,0,0,0,0,NaN,NaN
8,0.000,Western Kingbird,23-5,0,0,0,0,NaN,NaN
8,0.000,White Crowned Sparrow,16-23,0,4,0,4,0.000,0.000
8,0.000,White Crowned Sparrow,23-5,1,9,0,10,10.000,10.000
8,0.000,Eared Grebe,16-23,0,0,0,0,NaN,NaN
8,0.000,Eared Grebe,23-5,0,18,0,18,0.000,0.000
8,0.000,cougar,16-23,0,0,0,0,NaN,NaN
8,0.000,cougar,23-5,0,0,0,0,NaN,NaN
8,0.000,Ocean Water,16-23,0,0,0,0,NaN,NaN
8,0.000,Ocean Water,23-5,0,0,0,0,NaN,NaN
8,0.000,Red Tailed Hawk,16-23,0,1,0,1,0.000,0.000
8,0.000,Red Tailed Hawk,23-5,0,5,0,5,0.000,0.000
8,0.000,Dog,16-23,58,71,0,129,44.961,44.961
8,0.000,Dog,23-5,113,131,0,244,46.311,46.311
8,0.000,Human,16-23,1770,714,0,2484,71.256,71.256
8,0.000,Human,23-5,2208,562,0,2770,79.711,79.711
8,0.000,Wild Turkey,16-23,4,15,0,19,21.053,21.053
8,0.000,Wild Turkey,23-5,0,20,0,20,0.000,0.000
8,0.000,Clark Grebe,16-23,0,0,0,0,NaN,NaN
8,0.000,Clark Grebe,23-5,0,0,0,0,NaN,NaN
8,0.000,Seagull,16-23,0,0,0,0,NaN,NaN
8,0.000,Seagull,23-5,44,7,0,51,86.275,86.275
8,0.000,Surf Scoter,16-23,0,0,0,0,NaN,NaN
8,0.000,Surf Scoter,23-5,0,0,0,0,NaN,NaN
8,0.000,Pigeon,16-23,96,156,0,252,38.095,38.095
8,0.000,Pigeon,23-5,144,204,0,348,41.379,41.379
8,0.000,Pacific Ocean Water,16-23,0,0,0,0,NaN,NaN
8,0.000,Pacific Ocean Water,23-5,0,0,0,0,NaN,NaN
8,0.000,Cat,16-23,21,32,0,53,39.623,39.623
8,0.000,Cat,23-5,30,30,0,60,50.000,50.000
8,0.000,Horse,16-23,7,24,0,31,22.581,22.581
8,0.000,Horse,23-5,34,162,0,196,17.347,17.347
8,0.000,orangutan,16-23,0,0,0,0,NaN,NaN
8,0.000,orangutan,23-5,0,0,0,0,NaN,NaN
8,0.000,Bat,16-23,36,21,0,57,63.158,63.158
8,0.000,Bat,23-5,37,29,0,66,56.061,56.061
8,0.000,Deer,16-23,16,25,0,41,39.024,39.024
8,0.000,Deer,23-5,18,104,0,122,14.754,14.754
8,0.000,Great Horned Owl,16-23,0,0,0,0,NaN,NaN
8,0.000,Great Horned Owl,23-5,0,4,0,4,0.000,0.000
8,0.000,Freshwater Lagoon,16-23,0,0,0,0,NaN,NaN
8,0.000,Freshwater Lagoon,23-5,0,0,0,0,NaN,NaN
8,0.000,Unknown Avian,16-23,0,0,0,0,NaN,NaN
8,0.000,Unknown Avian,23-5,0,0,0,0,NaN,NaN
8,0.000,Human UTI,16-23,78,64,0,142,54.930,54.930
8,0.000,Human UTI,23-5,102,94,0,196,52.041,52.041
8,0.000,unknown,16-23,0,0,0,0,NaN,NaN
8,0.000,unknown,23-5,3,2,0,5,60.000,60.000
8,0.000,SLO Creek Water,16-23,0,0,0,0,NaN,NaN
8,0.000,SLO Creek Water,23-5,0,0,0,0,NaN,NaN
8,0.000,Pig/Swine,16-23,10,7,0,17,58.824,58.824
8,0.000,Pig/Swine,23-5,11,8,0,19,57.895,57.895
8,0.000,Klebsiella,16-23,0,0,0,0,NaN,NaN
8,0.000,Klebsiella,23-5,0,0,0,0,NaN,NaN
8,0.000,Hu Cw and Dg,16-23,12,16,0,28,42.857,42.857
8,0.000,Hu Cw and Dg,23-5,15,24,0,39,38.462,38.462
8,0.000,Ground Squirrel,16-23,95,66,0,161,59.006,59.006
8,0.000,Ground Squirrel,23-5,88,87,0,175,50.286,50.286
8,0.000,Opossum,16-23,0,1,0,1,0.000,0.000
8,0.000,Opossum,23-5,0,0,0,0,NaN,NaN
8,0.000,Cow,16-23,1554,1070,0,2624,59.223,59.223
8,0.000,Cow,23-5,1506,1351,0,2857,52.713,52.713
8,0.000,Deer Mouse,16-23,0,0,0,0,NaN,NaN
8,0.000,Deer Mouse,23-5,0,0,0,0,NaN,NaN
8,0.000,OVERALL,16-23,3884,2464,0,6348,61.185,61.185
8,0.000,OVERALL,23-5,4539,3071,0,7610,59.645,59.645
8,0.500,Chicken,16-23,0,6,0,6,0.000,0.000
8,0.500,Chicken,23-5,8,8,0,16,50.000,50.000
8,0.500,Sea Lion,16-23,0,1,0,1,0.000,0.000
8,0.500,Sea Lion,23-5,3,9,0,12,25.000,25.000
8,0.500,Hu and Cw,16-23,6,14,0,20,30.000,30.000
8,0.500,Hu and Cw,23-5,3,11,0,14,21.429,21.429
8,0.500,Sheep,16-23,54,52,0,106,50.943,50.943
8,0.500,Sheep,23-5,61,44,0,105,58.095,58.095
8,0.500,Hu and Dg,16-23,10,16,0,26,38.462,38.462
8,0.500,Hu and Dg,23-5,20,17,0,37,54.054,54.054
8,0.500,Common Loon,16-23,0,0,0,0,NaN,NaN
8,0.500,Common Loon,23-5,0,4,0,4,0.000,0.000
8,0.500,Red-Winged Blackbird,16-23,0,4,0,4,0.000,0.000
8,0.500,Red-Winged Blackbird,23-5,0,2,0,2,0.000,0.000
8,0.500,Cw,16-23,12,10,0,22,54.545,54.545
8,0.500,Cw,23-5,15,42,0,57,26.316,26.316
8,0.500,Cliff Sparrow,16-23,3,19,0,22,13.636,13.636
8,0.500,Cliff Sparrow,23-5,0,7,0,7,0.000,0.000
8,0.500,Pig,16-23,10,9,0,19,52.632,52.632
8,0.500,Pig,23-5,5,8,0,13,38.462,38.462
8,0.500,Barn Owl,16-23,0,0,0,0,NaN,NaN
8,0.500,Barn Owl,23-5,0,0,0,0,NaN,NaN
8,0.500,Wild Pig,16-23,2,1,0,3,66.667,66.667
8,0.500,Wild Pig,23-5,2,2,0,4,50.000,50.000
8,0.500,Pennington Creek Water,16-23,0,0,0,0,NaN,NaN
8,0.500,Pennington Creek Water,23-5,0,0,0,0,NaN,NaN
8,0.500,Guinni,16-23,0,0,0,0,NaN,NaN
8,0.500,Guinni,23-5,0,0,0,0,NaN,NaN
8,0.500,Racoon,16-23,0,0,0,0,NaN,NaN
8,0.500,Racoon,23-5,0,0,0,0,NaN,NaN
8,0.500,Hu,16-23,15,17,0,32,46.875,46.875
8,0.500,Hu,23-5,22,16,0,38,57.895,57.895
8,0.500,Cw and Dg,16-23,9,17,0,26,34.615,34.615
8,0.500,Cw and Dg,23-5,15,19,0,34,44.118,44.118
8,0.500,Red Wind Blackbird,16-23,0,0,0,0,NaN,NaN
8,0.500,Red Wind Blackbird,23-5,0,0,0,0,NaN,NaN
8,0.500,Tree Swallow,16-23,0,0,0,0,NaN,NaN
8,0.500,Tree Swallow,23-5,0,0,0,0,NaN,NaN
8,0.500,Turkey Vulture,16-23,0,0,0,0,NaN,NaN
8,0.500,Turkey Vulture,23-5,0,0,0,0,NaN,NaN
8,0.500,Dg,16-23,6,11,0,17,35.294,35.294
8,0.500,Dg,23-5,31,31,0,62,50.000,50.000
8,0.500,Western Kingbird,16-23,0,0,0,0,NaN,NaN
8,0.500,Western Kingbird,23-5,0,0,0,0,NaN,NaN
8,0.500,White Crowned Sparrow,16-23,0,4,0,4,0.000,0.000
8,0.500,White Crowned Sparrow,23-5,1,9,0,10,10.000,10.000
8,0.500,Eared Grebe,16-23,0,0,0,0,NaN,NaN
8,0.500,Eared Grebe,23-5,0,18,0,18,0.000,0.000
8,0.500,cougar,16-23,0,0,0,0,NaN,NaN
8,0.500,cougar,23-5,0,0,0,0,NaN,NaN
8,0.500,Ocean Water,16-23,0,0,0,0,NaN,NaN
8,0.500,Ocean Water,23-5,0,0,0,0,NaN,NaN
8,0.500,Red Tailed Hawk,16-23,0,1,0,1,0.000,0.000
8,0.500,Red Tailed Hawk,23-5,0,5,0,5,0.000,0.000
8,0.500,Dog,16-23,58,71,0,129,44.961,44.961
8,0.500,Dog,23-5,113,131,0,244,46.311,46.311
8,0.500,Human,16-23,1770,714,0,2484,71.256,71.256
8,0.500,Human,23-5,2208,562,0,2770,79.711,79.711
8,0.500,Wild Turkey,16-23,4,15,0,19,21.053,21.053
8,0.500,Wild Turkey,23-5,0,20,0,20,0.000,0.000
8,0.500,Clark Grebe,16-23,0,0,0,0,NaN,NaN
8,0.500,Clark Grebe,23-5,0,0,0,0,NaN,NaN
8,0.500,Seagull,16-23,0,0,0,0,NaN,NaN
8,0.500,Seagull,23-5,44,7,0,51,86.275,86.275
8,0.500,Surf Scoter,16-23,0,0,0,0,NaN,NaN
8,0.500,Surf Scoter,23-5,0,0,0,0,NaN,NaN
8,0.500,Pigeon,16-23,96,156,0,252,38.095,38.095
8,0.500,Pigeon,23-5,144,204,0,348,41.379,41.379
8,0.500,Pacific Ocean Water,16-23,0,0,0,0,NaN,NaN
8,0.500,Pacific Ocean Water,23-5,0,0,0,0,NaN,NaN
8,0.500,Cat,16-23,21,32,0,53,39.623,39.623
8,0.500,Cat,23-5,30,30,0,60,50.000,50.000
8,0.500,Horse,16-23,7,24,0,31,22.581,22.581
8,0.500,Horse,23-5,34,162,0,196,17.347,17.347
8,0.500,orangutan,16-23,0,0,0,0,NaN,NaN
8,0.500,orangutan,23-5,0,0,0,0,NaN,NaN
8,0.500,Bat,16-23,36,21,0,57,63.158,63.158
8,0.500,Bat,23-5,37,29,0,66,56.061,56.061
8,0.500,Deer,16-23,16,25,0,41,39.024,39.024
8,0.500,Deer,23-5,18,104,0,122,14.754,14.754
8,0.500,Great Horned Owl,16-23,0,0,0,0,NaN,NaN
8,0.500,Great Horned Owl,23-5,0,4,0,4,0.000,0.000
8,0.500,Freshwater Lagoon,16-23,0,0,0,0,NaN,NaN
8,0.500,Freshwater Lagoon,23-5,0,0,0,0,NaN,NaN
8,0.500,Unknown Avian,16-23,0,0,0,0,NaN,NaN
8,0.500,Unknown Avian,23-5,0,0,0,0,NaN,NaN
8,0.500,Human UTI,16-23,78,64,0,142,54.930,54.930
8,0.500,Human UTI,23-5,102,94,0,196,52.041,52.041
8,0.500,unknown,16-23,0,0,0,0,NaN,NaN
8,0.500,unknown,23-5,3,2,0,5,60.000,60.000
8,0.500,SLO Creek Water,16-23,0,0,0,0,NaN,NaN
8,0.500,SLO Creek Water,23-5,0,0,0,0,NaN,NaN
8,0.500,Pig/Swine,16-23,10,7,0,17,58.824,58.824
8,0.500,Pig/Swine,23-5,11,8,0,19,57.895,57.895
8,0.500,Klebsiella,16-23,0,0,0,0,NaN,NaN
8,0.500,Klebsiella,23-5,0,0,0,0,NaN,NaN
8,0.500,Hu Cw and Dg,16-23,12,16,0,28,42.857,42.857
8,0.500,Hu Cw and Dg,23-5,15,24,0,39,38.462,38.462
8,0.500,Ground Squirrel,16-23,95,66,0,161,59.006,59.006
8,0.500,Ground Squirrel,23-5,88,87,0,175,50.286,50.286
8,0.500,Opossum,16-23,0,1,0,1,0.000,0.000
8,0.500,Opossum,23-5,0,0,0,0,NaN,NaN
8,0.500,Cow,16-23,1554,1070,0,2624,59.223,59.223
8,0.500,Cow,23-5,1506,1351,0,2857,52.713,52.713
8,0.500,Deer Mouse,16-23,0,0,0,0,NaN,NaN
8,0.500,Deer Mouse,23-5,0,0,0,0,NaN,NaN
8,0.500,OVERALL,16-23,3884,2464,0,6348,61.185,61.185
8,0.500,OVERALL,23-5,4539,3071,0,7610,59.645,59.645
8,0.900,Chicken,16-23,0,6,0,6,0.000,0.000
8,0.900,Chicken,23-5,8,8,0,16,50.000,50.000
8,0.900,Sea Lion,16-23,0,1,0,1,0.000,0.000
8,0.900,Sea Lion,23-5,3,9,0,12,25.000,25.000
8,0.900,Hu and Cw,16-23,6,14,0,20,30.000,30.000
8,0.900,Hu and Cw,23-5,3,11,0,14,21.429,21.429
8,0.900,Sheep,16-23,54,52,0,106,50.943,50.943
8,0.900,Sheep,23-5,61,44,0,105,58.095,58.095
8,0.900,Hu and Dg,16-23,10,16,0,26,38.462,38.462
8,0.900,Hu and Dg,23-5,20,17,0,37,54.054,54.054
8,0.900,Common Loon,16-23,0,0,0,0,NaN,NaN
8,0.900,Common Loon,23-5,0,4,0,4,0.000,0.000
8,0.900,Red-Winged Blackbird,16-23,0,4,0,4,0.000,0.000
8,0.900,Red-Winged Blackbird,23-5,0,2,0,2,0.000,0.000
8,0.900,Cw,16-23,12,10,0,22,54.545,54.545
8,0.900,Cw,23-5,15,42,0,57,26.316,26.316
8,0.900,Cliff Sparrow,16-23,3,19,0,22,13.636,13.636
8,0.900,Cliff Sparrow,23-5,0,7,0,7,0.000,0.000
8,0.900,Pig,16-23,10,9,0,19,52.632,52.632
8,0.900,Pig,23-5,5,8,0,13,38.462,38.462
8,0.900,Barn Owl,16-23,0,0,0,0,NaN,NaN
8,0.900,Barn Owl,23-5,0,0,0,0,NaN,NaN
8,0.900,Wild Pig,16-23,2,1,0,3,66.667,66.667
8,0.900,Wild Pig,23-5,2,2,0,4,50.000,50.000
8,0.900,Pennington Creek Water,16-23,0,0,0,0,NaN,NaN
8,0.900,Pennington Creek Water,23-5,0,0,0,0,NaN,NaN
8,0.900,Guinni,16-23,0,0,0,0,NaN,NaN
8,0.900,Guinni,23-5,0,0,0,0,NaN,NaN
8,0.900,Racoon,16-23,0,0,0,0,NaN,NaN
8,0.900,Racoon,23-5,0,0,0,0,NaN,NaN
8,0.900,Hu,16-23,15,17,0,32,46.875,46.875
8,0.900,Hu,23-5,22,16,0,38,57.895,57.895
8,0.900,Cw and Dg,16-23,9,17,0,26,34.615,34.615
8,0.900,Cw and Dg,23-5,15,19,0,34,44.118,44.118
8,0.900,Red Wind Blackbird,16-23,0,0,0,0,NaN,NaN
8,0.900,Red Wind Blackbird,23-5,0,0,0,0,NaN,NaN
8,0.900,Tree Swallow,16-23,0,0,0,0,NaN,NaN
8,0.900,Tree Swallow,23-5,0,0,0,0,NaN,NaN
8,0.900,Turkey Vulture,16-23,0,0,0,0,NaN,NaN
8,0.900,Turkey Vulture,23-5,0,0,0,0,NaN,NaN
8,0.900,Dg,16-23,6,11,0,17,35.294,35.294
8,0.900,Dg,23-5,31,31,0,62,50.000,50.000
8,0.900,Western Kingbird,16-23,0,0,0,0,NaN,NaN
8,0.900,Western Kingbird,23-5,0,0,0,0,NaN,NaN
8,0.900,White Crowned Sparrow,16-23,0,4,0,4,0.000,0.000
8,0.900,White Crowned Sparrow,23-5,1,9,0,10,10.000,10.000
8,0.900,Eared Grebe,16-23,0,0,0,0,NaN,NaN
8,0.900,Eared Grebe,23-5,0,18,0,18,0.000,0.000
8,0.900,cougar,16-23,0,0,0,0,NaN,NaN
8,0.900,cougar,23-5,0,0,0,0,NaN,NaN
8,0.900,Ocean Water,16-23,0,0,0,0,NaN,NaN
8,0.900,Ocean Water,23-5,0,0,0,0,NaN,NaN
8,0.900,Red Tailed Hawk,16-23,0,1,0,1,0.000,0.000
8,0.900,Red Tailed Hawk,23-5,0,5,0,5,0.000,0.000
8,0.900,Dog,16-23,58,71,0,129,44.961,44.961
8,0.900,Dog,23-5,113,126,0,239,47.280,47.280
8,0.900,Human,16-23,1770,713,0,2483,71.285,71.285
8,0.900,Human,23-5,2208,557,0,2765,79.855,79.855
8,0.900,Wild Turkey,16-23,4,15,0,19,21.053,21.053
8,0.900,Wild Turkey,23-5,0,20,0,20,0.000,0.000
8,0.900,Clark Grebe,16-23,0,0,0,0,NaN,NaN
8,0.900,Clark Grebe,23-5,0,0,0,0,NaN,NaN
8,0.900,Seagull,16-23,0,0,0,0,NaN,NaN
8,0.900,Seagull,23-5,44,8,0,52,84.615,84.615
8,0.900,Surf Scoter,16-23,0,0,0,0,NaN,NaN
8,0.900,Surf Scoter,23-5,0,0,0,0,NaN,NaN
8,0.900,Pigeon,16-23,96,156,0,252,38.095,38.095
8,0.900,Pigeon,23-5,144,204,0,348,41.379,41.379
8,0.900,Pacific Ocean Water,16-23,0,0,0,0,NaN,NaN
8,0.900,Pacific Ocean Water,23-5,0,0,0,0,NaN,NaN
8,0.900,Cat,16-23,21,32,0,53,39.623,39.623
8,0.900,Cat,23-5,30,30,0,60,50.000,50.000
8,0.900,Horse,16-23,7,24,0,31,22.581,22.581
8,0.900,Horse,23-5,34,162,0,196,17.347,17.347
8,0.900,orangutan,16-23,0,0,0,0,NaN,NaN
8,0.900,orangutan,23-5,0,0,0,0,NaN,NaN
8,0.900,Bat,16-23,36,21,0,57,63.158,63.158
8,0.900,Bat,23-5,37,29,0,66,56.061,56.061
8,0.900,Deer,16-23,16,25,0,41,39.024,39.024
8,0.900,Deer,23-5,18,104,0,122,14.754,14.754
8,0.900,Great Horned Owl,16-23,0,0,0,0,NaN,NaN
8,0.900,Great Horned Owl,23-5,0,4,0,4,0.000,0.000
8,0.900,Freshwater Lagoon,16-23,0,0,0,0,NaN,NaN
8,0.900,Freshwater Lagoon,23-5,0,0,0,0,NaN,NaN
8,0.900,Unknown Avian,16-23,0,0,0,0,NaN,NaN
8,0.900,Unknown Avian,23-5,0,0,0,0,NaN,NaN
8,0.900,Human UTI,16-23,78,64,0,142,54.930,54.930
8,0.900,Human UTI,23-5,105,94,0,199,52.764,52.764
8,0.900,unknown,16-23,0,0,0,0,NaN,NaN
8,0.900,unknown,23-5,3,2,0,5,60.000,60.000
8,0.900,SLO Creek Water,16-23,0,0,0,0,NaN,NaN
8,0.900,SLO Creek Water,23-5,0,0,0,0,NaN,NaN
8,0.900,Pig/Swine,16-23,10,7,0,17,58.824,58.824
8,0.900,Pig/Swine,23-5,11,8,0,19,57.895,57.895
8,0.900,Klebsiella,16-23,0,0,0,0,NaN,NaN
8,0.900,Klebsiella,23-5,0,0,0,0,NaN,NaN
8,0.900,Hu Cw and Dg,16-23,12,16,0,28,42.857,42.857
8,0.900,Hu Cw and Dg,23-5,15,24,0,39,38.462,38.462
8,0.900,Ground Squirrel,16-23,95,66,0,161,59.006,59.006
8,0.900,Ground Squirrel,23-5,88,87,0,175,50.286,50.286
8,0.900,Opossum,16-23,0,1,0,1,0.000,0.000
8,0.900,Opossum,23-5,0,0,0,0,NaN,NaN
8,0.900,Cow,16-23,1554,1067,0,2621,59.290,59.290
8,0.900,Cow,23-5,1506,1349,0,2855,52.750,52.750
8,0.900,Deer Mouse,16-23,0,0,0,0,NaN,NaN
8,0.900,Deer Mouse,23-5,0,0,0,0,NaN,NaN
8,0.900,OVERALL,16-23,3884,2460,0,6344,61.223,61.223
8,0.900,OVERALL,23-5,4542,3060,0,7602,59.747,59.747
8,0.950,Chicken,16-23,0,6,0,6,0.000,0.000
8,0.950,Chicken,23-5,8,8,0,16,50.000,50.000
8,0.950,Sea Lion,16-23,0,1,0,1,0.000,0.000
8,0.950,Sea Lion,23-5,3,9,0,12,25.000,25.000
8,0.950,Hu and Cw,16-23,6,14,0,20,30.000,30.000
8,0.950,Hu and Cw,23-5,3,11,0,14,21.429,21.429
8,0.950,Sheep,16-23,54,52,0,106,50.943,50.943
8,0.950,Sheep,23-5,61,44,0,105,58.095,58.095
8,0.950,Hu and Dg,16-23,10,16,0,26,38.462,38.462
8,0.950,Hu and Dg,23-5,20,17,0,37,54.054,54.054
8,0.950,Common Loon,16-23,0,0,0,0,NaN,NaN
8,0.950,Common Loon,23-5,0,4,0,4,0.000,0.000
8,0.950,Red-Winged Blackbird,16-23,0,4,0,4,0.000,0.000
8,0.950,Red-Winged Blackbird,23-5,0,2,0,2,0.000,0.000
8,0.950,Cw,16-23,12,10,0,22,54.545,54.545
8,0.950,Cw,23-5,15,42,0,57,26.316,26.316
8,0.950,Cliff Sparrow,16-23,3,19,0,22,13.636,13.636
8,0.950,Cliff Sparrow,23-5,0,7,0,7,0.000,0.000
8,0.950,Pig,16-23,10,9,0,19,52.632,52.632
8,0.950,Pig,23-5,5,8,0,13,38.462,38.462
8,0.950,Barn Owl,16-23,0,0,0,0,NaN,NaN
8,0.950,Barn Owl,23-5,0,0,0,0,NaN,NaN
8,0.950,Wild Pig,16-23,2,1,0,3,66.667,66.667
8,0.950,Wild Pig,23-5,2,2,0,4,50.000,50.000
8,0.950,Pennington Creek Water,16-23,0,0,0,0,NaN,NaN
8,0.950,Pennington Creek Water,23-5,0,0,0,0,NaN,NaN
8,0.950,Guinni,16-23,0,0,0,0,NaN,NaN
8,0.950,Guinni,23-5,0,0,0,0,NaN,NaN
8,0.950,Racoon,16-23,0,0,0,0,NaN,NaN
8,0.950,Racoon,23-5,0,0,0,0,NaN,NaN
8,0.950,Hu,16-23,15,17,0,32,46.875,46.875
8,0.950,Hu,23-5,22,16,0,38,57.895,57.895
8,0.950,Cw and Dg,16-23,9,17,0,26,34.615,34.615
8,0.950,Cw and Dg,23-5,15,19,0,34,44.118,44.118
8,0.950,Red Wind Blackbird,16-23,0,0,0,0,NaN,NaN
8,0.950,Red Wind Blackbird,23-5,0,0,0,0,NaN,NaN
8,0.950,Tree Swallow,16-23,0,0,0,0,NaN,NaN
8,0.950,Tree Swallow,23-5,0,0,0,0,NaN,NaN
8,0.950,Turkey Vulture,16-23,0,0,0,0,NaN,NaN
8,0.950,Turkey Vulture,23-5,0,0,0,0,NaN,NaN
8,0.950,Dg,16-23,6,11,0,17,35.294,35.294
8,0.950,Dg,23-5,31,31,0,62,50.000,50.000
8,0.950,Western Kingbird,16-23,0,0,0,0,NaN,NaN
8,0.950,Western Kingbird,23-5,0,0,0,0,NaN,NaN
8,0.950,White Crowned Sparrow,16-23,0,4,0,4,0.000,0.000
8,0.950,White Crowned Sparrow,23-5,1,9,0,10,10.000,10.000
8,0.950,Eared Grebe,16-23,0,0,0,0,NaN,NaN
8,0.950,Eared Grebe,23-5,0,18,0,18,0.000,0.000
8,0.950,cougar,16-23,0,0,0,0,NaN,NaN
8,0.950,cougar,23-5,0,0,0,0,NaN,NaN
8,0.950,Ocean Water,16-23,0,0,0,0,NaN,NaN
8,0.950,Ocean Water,23-5,0,0,0,0,NaN,NaN
8,0.950,Red Tailed Hawk,16-23,0,1,0,1,0.000,0.000
8,0.950,Red Tailed Hawk,23-5,0,5,0,5,0.000,0.000
8,0.950,Dog,16-23,58,71,0,129,44.961,44.961
8,0.950,Dog,23-5,113,124,0,237,47.679,47.679
8,0.950,Human,16-23,1770,712,0,2482,71.313,71.313
8,0.950,Human,23-5,2210,551,0,2761,80.043,80.043
8,0.950,Wild Turkey,16-23,4,15,0,19,21.053,21.053
8,0.950,Wild Turkey,23-5,0,20,0,20,0.000,0.000
8,0.950,Clark Grebe,16-23,0,0,0,0,NaN,NaN
8,0.950,Clark Grebe,23-5,0,0,0,0,NaN,NaN
8,0.950,Seagull,16-23,0,0,0,0,NaN,NaN
8,0.950,Seagull,23-5,44,7,0,51,86.275,86.275
8,0.950,Surf Scoter,16-23,0,0,0,0,NaN,NaN
8,0.950,Surf Scoter,23-5,0,0,0,0,NaN,NaN
8,0.950,Pigeon,16-23,97,156,0,253,38.340,38.340
8,0.950,Pigeon,23-5,144,205,0,349,41.261,41.261
8,0.950,Pacific Ocean Water,16-23,0,0,0,0,NaN,NaN
8,0.950,Pacific Ocean Water,23-5,0,0,0,0,NaN,NaN
8,0.950,Cat,16-23,21,32,0,53,39.623,39.623
8,0.950,Cat,23-5,30,30,0,60,50.000,50.000
8,0.950,Horse,16-23,7,24,0,31,22.581,22.581
8,0.950,Horse,23-5,34,162,0,196,17.347,17.347
8,0.950,orangutan,16-23,0,0,0,0,NaN,NaN
8,0.950,orangutan,23-5,0,0,0,0,NaN,NaN
8,0.950,Bat,16-23,36,21,0,57,63.158,63.158
8,0.950,Bat,23-5,37,28,0,65,56.923,56.923
8,0.950,Deer,16-23,16,25,0,41,39.024,39.024
8,0.950,Deer,23-5,18,104,0,122,14.754,14.754
8,0.950,Great Horned Owl,16-23,0,0,0,0,NaN,NaN
8,0.950,Great Horned Owl,23-5,0,4,0,4,0.000,0.000
8,0.950,Freshwater Lagoon,16-23,0,0,0,0,NaN,NaN
8,0.950,Freshwater Lagoon,23-5,0,0,0,0,NaN,NaN
8,0.950,Unknown Avian,16-23,0,0,0,0,NaN,NaN
8,0.950,Unknown Avian,23-5,0,0,0,0,NaN,NaN
8,0.950,Human UTI,16-23,81,64,0,145,55.862,55.862
8,0.950,Human UTI,23-5,104,96,0,200,52.000,52.000
8,0.950,unknown,16-23,0,0,0,0,NaN,NaN
8,0.950,unknown,23-5,3,2,0,5,60.000,60.000
8,0.950,SLO Creek Water,16-23,0,0,0,0,NaN,NaN
8,0.950,SLO Creek Water,23-5,0,0,0,0,NaN,NaN
8,0.950,Pig/Swine,16-23,10,7,0,17,58.824,58.824
8,0.950,Pig/Swine,23-5,11,8,0,19,57.895,57.895
8,0.950,Klebsiella,16-23,0,0,0,0,NaN,NaN
8,0.950,Klebsiella,23-5,0,0,0,0,NaN,NaN
8,0.950,Hu Cw and Dg,16-23,12,16,0,28,42.857,42.857
8,0.950,Hu Cw and Dg,23-5,15,24,0,39,38.462,38.462
8,0.950,Ground Squirrel,16-23,95,66,0,161,59.006,59.006
8,0.950,Ground Squirrel,23-5,88,85,0,173,50.867,50.867
8,0.950,Opossum,16-23,0,1,0,1,0.000,0.000
8,0.950,Opossum,23-5,0,0,0,0,NaN,NaN
8,0.950,Cow,16-23,1554,1047,0,2601,59.746,59.746
8,0.950,Cow,23-5,1505,1346,0,2851,52.788,52.788
8,0.950,Deer Mouse,16-23,0,0,0,0,NaN,NaN
8,0.950,Deer Mouse,23-5,0,0,0,0,NaN,NaN
8,0.950,OVERALL,16-23,3888,2439,0,6327,61.451,61.451
8,0.950,OVERALL,23-5,4542,3048,0,7590,59.842,59.842
8,0.960,Chicken,16-23,0,6,0,6,0.000,0.000
8,0.960,Chicken,23-5,8,8,0,16,50.000,50.000
8,0.960,Sea Lion,16-23,0,1,0,1,0.000,0.000
8,0.960,Sea Lion,23-5,3,9,0,12,25.000,25.000
8,0.960,Hu and Cw,16-23,6,14,0,20,30.000,30.000
8,0.960,Hu and Cw,23-5,3,11,0,14,21.429,21.429
8,0.960,Sheep,16-23,54,52,0,106,50.943,50.943
8,0.960,Sheep,23-5,61,45,0,106,57.547,57.547
8,0.960,Hu and Dg,16-23,10,16,0,26,38.462,38.462
8,0.960,Hu and Dg,23-5,20,17,0,37,54.054,54.054
8,0.960,Common Loon,16-23,0,0,0,0,NaN,NaN
8,0.960,Common Loon,23-5,0,4,0,4,0.000,0.000
8,0.960,Red-Winged Blackbird,16-23,0,4,0,4,0.000,0.000
8,0.960,Red-Winged Blackbird,23-5,0,2,0,2,0.000,0.000
8,0.960,Cw,16-23,12,10,0,22,54.545,54.545
8,0.960,Cw,23-5,15,42,0,57,26.316,26.316
8,0.960,Cliff Sparrow,16-23,3,19,0,22,13.636,13.636
8,0.960,Cliff Sparrow,23-5,0,7,0,7,0.000,0.000
8,0.960,Pig,16-23,10,9,0,19,52.632,52.632
8,0.960,Pig,23-5,5,8,0,13,38.462,38.462
8,0.960,Barn Owl,16-23,0,0,0,0,NaN,NaN
8,0.960,Barn Owl,23-5,0,0,0,0,NaN,NaN
8,0.960,Wild Pig,16-23,2,1,0,3,66.667,66.667
8,0.960,Wild Pig,23-5,2,2,0,4,50.000,50.000
8,0.960,Pennington Creek Water,16-23,0,0,0,0,NaN,NaN
8,0.960,Pennington Creek Water,23-5,0,0,0,0,NaN,NaN
8,0.960,Guinni,16-23,0,0,0,0,NaN,NaN
8,0.960,Guinni,23-5,0,0,0,0,NaN,NaN
8,0.960,Racoon,16-23,0,0,0,0,NaN,NaN
8,0.960,Racoon,23-5,0,0,0,0,NaN,NaN
8,0.960,Hu,16-23,15,17,0,32,46.875,46.875
8,0.960,Hu,23-5,22,16,0,38,57.895,57.895
8,0.960,Cw and Dg,16-23,9,17,0,26,34.615,34.615
8,0.960,Cw and Dg,23-5,15,19,0,34,44.118,44.118
8,0.960,Red Wind Blackbird,16-23,0,0,0,0,NaN,NaN
8,0.960,Red Wind Blackbird,23-5,0,0,0,0,NaN,NaN
8,0.960,Tree Swallow,16-23,0,0,0,0,NaN,NaN
8,0.960,Tree Swallow,23-5,0,0,0,0,NaN,NaN
8,0.960,Turkey Vulture,16-23,0,0,0,0,NaN,NaN
8,0.960,Turkey Vulture,23-5,0,0,0,0,NaN,NaN
8,0.960,Dg,16-23,6,11,0,17,35.294,35.294
8,0.960,Dg,23-5,31,31,0,62,50.000,50.000
8,0.960,Western Kingbird,16-23,0,0,0,0,NaN,NaN
8,0.960,Western Kingbird,23-5,0,0,0,0,NaN,NaN
8,0.960,White Crowned Sparrow,16-23,0,4,0,4,0.000,0.000
8,0.960,White Crowned Sparrow,23-5,1,9,0,10,10.000,10.000
8,0.960,Eared Grebe,16-23,0,0,0,0,NaN,NaN
8,0.960,Eared Grebe,23-5,0,18,0,18,0.000,0.000
8,0.960,cougar,16-23,0,0,0,0,NaN,NaN
8,0.960,cougar,23-5,0,0,0,0,NaN,NaN
8,0.960,Ocean Water,16-23,0,0,0,0,NaN,NaN
8,0.960,Ocean Water,23-5,0,0,0,0,NaN,NaN
8,0.960,Red Tailed Hawk,16-23,0,1,0,1,0.000,0.000
8,0.960,Red Tailed Hawk,23-5,0,5,0,5,0.000,0.000
8,0.960,Dog,16-23,58,71,0,129,44.961,44.961
8,0.960,Dog,23-5,113,120,0,233,48.498,48.498
8,0.960,Human,16-23,1770,711,0,2481,71.342,71.342
8,0.960,Human,23-5,2210,538,0,2748,80.422,80.422
8,0.960,Wild Turkey,16-23,4,15,0,19,21.053,21.053
8,0.960,Wild Turkey,23-5,0,24,0,24,0.000,0.000
8,0.960,Clark Grebe,16-23,0,0,0,0,NaN,NaN
8,0.960,Clark Grebe,23-5,0,0,0,0,NaN,NaN
8,0.960,Seagull,16-23,0,0,0,0,NaN,NaN
8,0.960,Seagull,23-5,44,8,0,52,84.615,84.615
8,0.960,Surf Scoter,16-23,0,0,0,0,NaN,NaN
8,0.960,Surf Scoter,23-5,0,2,0,2,0.000,0.000
8,0.960,Pigeon,16-23,95,156,0,251,37.849,37.849
8,0.960,Pigeon,23-5,145,218,0,363,39.945,39.945
8,0.960,Pacific Ocean Water,16-23,0,0,0,0,NaN,NaN
8,0.960,Pacific Ocean Water,23-5,0,0,0,0,NaN,NaN
8,0.960,Cat,16-23,21,32,0,53,39.623,39.623
8,0.960,Cat,23-5,30,30,0,60,50.000,50.000
8,0.960,Horse,16-23,7,24,0,31,22.581,22.581
8,0.960,Horse,23-5,34,162,0,196,17.347,17.347
8,0.960,orangutan,16-23,0,0,0,0,NaN,NaN
8,0.960,orangutan,23-5,0,0,0,0,NaN,NaN
8,0.960,Bat,16-23,36,21,0,57,63.158,63.158
8,0.960,Bat,23-5,37,28,0,65,56.923,56.923
8,0.960,Deer,16-23,16,25,0,41,39.024,39.024
8,0.960,Deer,23-5,18,104,0,122,14.754,14.754
8,0.960,Great Horned Owl,16-23,0,0,0,0,NaN,NaN
8,0.960,Great Horned Owl,23-5,0,4,0,4,0.000,0.000
8,0.960,Freshwater Lagoon,16-23,0,0,0,0,NaN,NaN
8,0.960,Freshwater Lagoon,23-5,0,0,0,0,NaN,NaN
8,0.960,Unknown Avian,16-23,0,0,0,0,NaN,NaN
8,0.960,Unknown Avian,23-5,0,0,0,0,NaN,NaN
8,0.960,Human UTI,16-23,81,65,0,146,55.479,55.479
8,0.960,Human UTI,23-5,104,95,0,199,52.261,52.261
8,0.960,unknown,16-23,0,0,0,0,NaN,NaN
8,0.960,unknown,23-5,3,2,0,5,60.000,60.000
8,0.960,SLO Creek Water,16-23,0,0,0,0,NaN,NaN
8,0.960,SLO Creek Water,23-5,0,0,0,0,NaN,NaN
8,0.960,Pig/Swine,16-23,10,7,0,17,58.824,58.824
8,0.960,Pig/Swine,23-5,11,8,0,19,57.895,57.895
8,0.960,Klebsiella,16-23,0,0,0,0,NaN,NaN
8,0.960,Klebsiella,23-5,0,0,0,0,NaN,NaN
8,0.960,Hu Cw and Dg,16-23,12,16,0,28,42.857,42.857
8,0.960,Hu Cw and Dg,23-5,15,24,0,39,38.462,38.462
8,0.960,Ground Squirrel,16-23,95,66,0,161,59.006,59.006
8,0.960,Ground Squirrel,23-5,88,87,0,175,50.286,50.286
8,0.960,Opossum,16-23,0,1,0,1,0.000,0.000
8,0.960,Opossum,23-5,0,0,0,0,NaN,NaN
8,0.960,Cow,16-23,1552,1040,0,2592,59.877,59.877
8,0.960,Cow,23-5,1505,1330,0,2835,53.086,53.086
8,0.960,Deer Mouse,16-23,0,0,0,0,NaN,NaN
8,0.960,Deer Mouse,23-5,0,0,0,0,NaN,NaN
8,0.960,OVERALL,16-23,3884,2432,0,6316,61.495,61.495
8,0.960,OVERALL,23-5,4543,3037,0,7580,59.934,59.934
8,0.970,Chicken,16-23,0,6,0,6,0.000,0.000
8,0.970,Chicken,23-5,8,8,0,16,50.000,50.000
8,0.970,Sea Lion,16-23,0,1,0,1,0.000,0.000
8,0.970,Sea Lion,23-5,3,9,0,12,25.000,25.000
8,0.970,Hu and Cw,16-23,6,14,0,20,30.000,30.000
8,0.970,Hu and Cw,23-5,3,11,0,14,21.429,21.429
8,0.970,Sheep,16-23,54,53,0,107,50.467,50.467
8,0.970,Sheep,23-5,61,44,0,105,58.095,58.095
8,0.970,Hu and Dg,16-23,10,16,0,26,38.462,38.462
8,0.970,Hu and Dg,23-5,20,17,0,37,54.054,54.054
8,0.970,Common Loon,16-23,0,0,0,0,NaN,NaN
8,0.970,Common Loon,23-5,0,4,0,4,0.000,0.000
8,0.970,Red-Winged Blackbird,16-23,0,4,0,4,0.000,0.000
8,0.970,Red-Winged Blackbird,23-5,0,2,0,2,0.000,0.000
8,0.970,Cw,16-23,12,11,0,23,52.174,52.174
8,0.970,Cw,23-5,15,42,0,57,26.316,26.316
8,0.970,Cliff Sparrow,16-23,3,19,0,22,13.636,13.636
8,0.970,Cliff Sparrow,23-5,0,7,0,7,0.000,0.000
8,0.970,Pig,16-23,10,9,0,19,52.632,52.632
8,0.970,Pig,23-5,5,8,0,13,38.462,38.462
8,0.970,Barn Owl,16-23,0,0,0,0,NaN,NaN
8,0.970,Barn Owl,23-5,0,0,0,0,NaN,NaN
8,0.970,Wild Pig,16-23,2,1,0,3,66.667,66.667
8,0.970,Wild Pig,23-5,1,2,0,3,33.333,33.333
8,0.970,Pennington Creek Water,16-23,0,0,0,0,NaN,NaN
8,0.970,Pennington Creek Water,23-5,0,0,0,0,NaN,NaN
8,0.970,Guinni,16-23,0,0,0,0,NaN,NaN
8,0.970,Guinni,23-5,0,0,0,0,NaN,NaN
8,0.970,Racoon,16-23,0,0,0,0,NaN,NaN
8,0.970,Racoon,23-5,0,0,0,0,NaN,NaN
8,0.970,Hu,16-23,15,17,0,32,46.875,46.875
8,0.970,Hu,23-5,22,16,0,38,57.895,57.895
8,0.970,Cw and Dg,16-23,9,17,0,26,34.615,34.615
8,0.970,Cw and Dg,23-5,15,19,0,34,44.118,44.118
8,0.970,Red Wind Blackbird,16-23,0,0,0,0,NaN,NaN
8,0.970,Red Wind Blackbird,23-5,0,0,0,0,NaN,NaN
8,0.970,Tree Swallow,16-23,0,0,0,0,NaN,NaN
8,0.970,Tree Swallow,23-5,0,0,0,0,NaN,NaN
8,0.970,Turkey Vulture,16-23,0,0,0,0,NaN,NaN
8,0.970,Turkey Vulture,23-5,0,0,0,0,NaN,NaN
8,0.970,Dg,16-23,6,11,0,17,35.294,35.294
8,0.970,Dg,23-5,31,30,0,61,50.820,50.820
8,0.970,Western Kingbird,16-23,0,0,0,0,NaN,NaN
8,0.970,Western Kingbird,23-5,0,0,0,0,NaN,NaN
8,0.970,White Crowned Sparrow,16-23,0,4,0,4,0.000,0.000
8,0.970,White Crowned Sparrow,23-5,1,9,0,10,10.000,10.000
8,0.970,Eared Grebe,16-23,0,0,0,0,NaN,NaN
8,0.970,Eared Grebe,23-5,0,18,0,18,0.000,0.000
8,0.970,cougar,16-23,0,0,0,0,NaN,NaN
8,0.970,cougar,23-5,0,0,0,0,NaN,NaN
8,0.970,Ocean Water,16-23,0,0,0,0,NaN,NaN
8,0.970,Ocean Water,23-5,0,0,0,0,NaN,NaN
8,0.970,Red Tailed Hawk,16-23,0,1,0,1,0.000,0.000
8,0.970,Red Tailed Hawk,23-5,0,5,0,5,0.000,0.000
8,0.970,Dog,16-23,58,71,0,129,44.961,44.961
8,0.970,Dog,23-5,113,119,0,232,48.707,48.707
8,0.970,Human,16-23,1768,711,0,2479,71.319,71.319
8,0.970,Human,23-5,2208,537,0,2745,80.437,80.437
8,0.970,Wild Turkey,16-23,4,17,0,21,19.048,19.048
8,0.970,Wild Turkey,23-5,2,23,0,25,8.000,8.000
8,0.970,Clark Grebe,16-23,0,0,0,0,NaN,NaN
8,0.970,Clark Grebe,23-5,0,0,0,0,NaN,NaN
8,0.970,Seagull,16-23,0,0,0,0,NaN,NaN
8,0.970,Seagull,23-5,44,9,0,53,83.019,83.019
8,0.970,Surf Scoter,16-23,0,0,0,0,NaN,NaN
8,0.970,Surf Scoter,23-5,0,2,0,2,0.000,0.000
8,0.970,Pigeon,16-23,93,155,0,248,37.500,37.500
8,0.970,Pigeon,23-5,145,236,0,381,38.058,38.058
8,0.970,Pacific Ocean Water,16-23,0,0,0,0,NaN,NaN
8,0.970,Pacific Ocean Water,23-5,0,0,0,0,NaN,NaN
8,0.970,Cat,16-23,21,32,0,53,39.623,39.623
8,0.970,Cat,23-5,30,30,0,60,50.000,50.000
8,0.970,Horse,16-23,7,24,0,31,22.581,22.581
8,0.970,Horse,23-5,34,162,0,196,17.347,17.347
8,0.970,orangutan,16-23,0,0,0,0,NaN,NaN
8,0.970,orangutan,23-5,0,0,0,0,NaN,NaN
8,0.970,Bat,16-23,36,21,0,57,63.158,63.158
8,0.970,Bat,23-5,37,28,0,65,56.923,56.923
8,0.970,Deer,16-23,16,25,0,41,39.024,39.024
8,0.970,Deer,23-5,18,104,0,122,14.754,14.754
8,0.970,Great Horned Owl,16-23,0,0,0,0,NaN,NaN
8,0.970,Great Horned Owl,23-5,0,4,0,4,0.000,0.000
8,0.970,Freshwater Lagoon,16-23,0,0,0,0,NaN,NaN
8,0.970,Freshwater Lagoon,23-5,0,0,0,0,NaN,NaN
8,0.970,Unknown Avian,16-23,0,0,0,0,NaN,NaN
8,0.970,Unknown Avian,23-5,0,0,0,0,NaN,NaN
8,0.970,Human UTI,16-23,81,66,0,147,55.102,55.102
8,0.970,Human UTI,23-5,103,95,0,198,52.020,52.020
8,0.970,unknown,16-23,0,0,0,0,NaN,NaN
8,0.970,unknown,23-5,3,2,0,5,60.000,60.000
8,0.970,SLO Creek Water,16-23,0,0,0,0,NaN,NaN
8,0.970,SLO Creek Water,23-5,0,0,0,0,NaN,NaN
8,0.970,Pig/Swine,16-23,10,7,0,17,58.824,58.824
8,0.970,Pig/Swine,23-5,11,8,0,19,57.895,57.895
8,0.970,Klebsiella,16-23,0,0,0,0,NaN,NaN
8,0.970,Klebsiella,23-5,0,0,0,0,NaN,NaN
8,0.970,Hu Cw and Dg,16-23,12,16,0,28,42.857,42.857
8,0.970,Hu Cw and Dg,23-5,15,24,0,39,38.462,38.462
8,0.970,Ground Squirrel,16-23,94,64,0,158,59.494,59.494
8,0.970,Ground Squirrel,23-5,88,85,0,173,50.867,50.867
8,0.970,Opossum,16-23,0,1,0,1,0.000,0.000
8,0.970,Opossum,23-5,0,0,0,0,NaN,NaN
8,0.970,Cow,16-23,1546,1039,0,2585,59.807,59.807
8,0.970,Cow,23-5,1502,1304,0,2806,53.528,53.528
8,0.970,Deer Mouse,16-23,0,0,0,0,NaN,NaN
8,0.970,Deer Mouse,23-5,0,0,0,0,NaN,NaN
8,0.970,OVERALL,16-23,3873,2433,0,6306,61.418,61.418
8,0.970,OVERALL,23-5,4538,3023,0,7561,60.019,60.019
8,0.980,Chicken,16-23,0,6,0,6,0.000,0.000
8,0.980,Chicken,23-5,9,8,0,17,52.941,52.941
8,0.980,Sea Lion,16-23,0,1,0,1,0.000,0.000
8,0.980,Sea Lion,23-5,3,8,0,11,27.273,27.273
8,0.980,Hu and Cw,16-23,6,14,0,20,30.000,30.000
8,0.980,Hu and Cw,23-5,3,21,0,24,12.500,12.500
8,0.980,Sheep,16-23,54,51,0,105,51.429,51.429
8,0.980,Sheep,23-5,60,43,0,103,58.252,58.252
8,0.980,Hu and Dg,16-23,10,16,0,26,38.462,38.462
8,0.980,Hu and Dg,23-5,20,15,0,35,57.143,57.143
8,0.980,Common Loon,16-23,0,0,0,0,NaN,NaN
8,0.980,Common Loon,23-5,0,4,0,4,0.000,0.000
8,0.980,Red-Winged Blackbird,16-23,0,4,0,4,0.000,0.000
8,0.980,Red-Winged Blackbird,23-5,0,2,0,2,0.000,0.000
8,0.980,Cw,16-23,12,10,0,22,54.545,54.545
8,0.980,Cw,23-5,15,42,0,57,26.316,26.316
8,0.980,Cliff Sparrow,16-23,3,19,0,22,13.636,13.636
8,0.980,Cliff Sparrow,23-5,0,7,0,7,0.000,0.000
8,0.980,Pig,16-23,10,9,0,19,52.632,52.632
8,0.980,Pig,23-5,5,7,0,12,41.667,41.667
8,0.980,Barn Owl,16-23,0,0,0,0,NaN,NaN
8,0.980,Barn Owl,23-5,0,0,0,0,NaN,NaN
8,0.980,Wild Pig,16-23,2,1,0,3,66.667,66.667
8,0.980,Wild Pig,23-5,1,2,0,3,33.333,33.333
8,0.980,Pennington Creek Water,16-23,0,0,0,0,NaN,NaN
8,0.980,Pennington Creek Water,23-5,0,0,0,0,NaN,NaN
8,0.980,Guinni,16-23,0,0,0,0,NaN,NaN
8,0.980,Guinni,23-5,0,0,0,0,NaN,NaN
8,0.980,Racoon,16-23,0,0,0,0,NaN,NaN
8,0.980,Racoon,23-5,0,0,0,0,NaN,NaN
8,0.980,Hu,16-23,15,17,0,32,46.875,46.875
8,0.980,Hu,23-5,22,17,0,39,56.410,56.410
8,0.980,Cw and Dg,16-23,9,17,0,26,34.615,34.615
8,0.980,Cw and Dg,23-5,15,20,0,35,42.857,42.857
8,0.980,Red Wind Blackbird,16-23,0,0,0,0,NaN,NaN
8,0.980,Red Wind Blackbird,23-5,0,0,0,0,NaN,NaN
8,0.980,Tree Swallow,16-23,0,0,0,0,NaN,NaN
8,0.980,Tree Swallow,23-5,0,0,0,0,NaN,NaN
8,0.980,Turkey Vulture,16-23,0,0,0,0,NaN,NaN
8,0.980,Turkey Vulture,23-5,0,0,0,0,NaN,NaN
8,0.980,Dg,16-23,6,11,0,17,35.294,35.294
8,0.980,Dg,23-5,31,23,0,54,57.407,57.407
8,0.980,Western Kingbird,16-23,0,0,0,0,NaN,NaN
8,0.980,Western Kingbird,23-5,0,0,0,0,NaN,NaN
8,0.980,White Crowned Sparrow,16-23,0,2,0,2,0.000,0.000
8,0.980,White Crowned Sparrow,23-5,1,9,0,10,10.000,10.000
8,0.980,Eared Grebe,16-23,0,0,0,0,NaN,NaN
8,0.980,Eared Grebe,23-5,0,18,0,18,0.000,0.000
8,0.980,cougar,16-23,0,0,0,0,NaN,NaN
8,0.980,cougar,23-5,0,0,0,0,NaN,NaN
8,0.980,Ocean Water,16-23,0,0,0,0,NaN,NaN
8,0.980,Ocean Water,23-5,0,0,0,0,NaN,NaN
8,0.980,Red Tailed Hawk,16-23,0,1,0,1,0.000,0.000
8,0.980,Red Tailed Hawk,23-5,0,4,0,4,0.000,0.000
8,0.980,Dog,16-23,57,76,0,133,42.857,42.857
8,0.980,Dog,23-5,113,117,0,230,49.130,49.130
8,0.980,Human,16-23,1771,702,0,2473,71.613,71.613
8,0.980,Human,23-5,2210,527,0,2737,80.745,80.745
8,0.980,Wild Turkey,16-23,4,17,0,21,19.048,19.048
8,0.980,Wild Turkey,23-5,4,29,0,33,12.121,12.121
8,0.980,Clark Grebe,16-23,0,0,0,0,NaN,NaN
8,0.980,Clark Grebe,23-5,0,0,0,0,NaN,NaN
8,0.980,Seagull,16-23,0,0,0,0,NaN,NaN
8,0.980,Seagull,23-5,46,7,0,53,86.792,86.792
8,0.980,Surf Scoter,16-23,0,0,0,0,NaN,NaN
8,0.980,Surf Scoter,23-5,2,0,0,2,100.000,100.000
8,0.980,Pigeon,16-23,93,151,0,244,38.115,38.115
8,0.980,Pigeon,23-5,144,244,0,388,37.113,37.113
8,0.980,Pacific Ocean Water,16-23,0,0,0,0,NaN,NaN
8,0.980,Pacific Ocean Water,23-5,0,0,0,0,NaN,NaN
8,0.980,Cat,16-23,21,31,0,52,40.385,40.385
8,0.980,Cat,23-5,31,28,0,59,52.542,52.542
8,0.980,Horse,16-23,7,24,0,31,22.581,22.581
8,0.980,Horse,23-5,34,158,0,192,17.708,17.708
8,0.980,orangutan,16-23,0,0,0,0,NaN,NaN
8,0.980,orangutan,23-5,0,0,0,0,NaN,NaN
8,0.980,Bat,16-23,36,21,0,57,63.158,63.158
8,0.980,Bat,23-5,37,27,0,64,57.813,57.813
8,0.980,Deer,16-23,16,25,0,41,39.024,39.024
8,0.980,Deer,23-5,18,104,0,122,14.754,14.754
8,0.980,Great Horned Owl,16-23,0,0,0,0,NaN,NaN
8,0.980,Great Horned Owl,23-5,0,4,0,4,0.000,0.000
8,0.980,Freshwater Lagoon,16-23,0,0,0,0,NaN,NaN
8,0.980,Freshwater Lagoon,23-5,0,0,0,0,NaN,NaN
8,0.980,Unknown Avian,16-23,0,0,0,0,NaN,NaN
8,0.980,Unknown Avian,23-5,0,0,0,0,NaN,NaN
8,0.980,Human UTI,16-23,81,68,0,149,54.362,54.362
8,0.980,Human UTI,23-5,103,91,0,194,53.093,53.093
8,0.980,unknown,16-23,0,0,0,0,NaN,NaN
8,0.980,unknown,23-5,3,3,0,6,50.000,50.000
8,0.980,SLO Creek Water,16-23,0,0,0,0,NaN,NaN
8,0.980,SLO Creek Water,23-5,0,0,0,0,NaN,NaN
8,0.980,Pig/Swine,16-23,10,7,0,17,58.824,58.824
8,0.980,Pig/Swine,23-5,11,8,0,19,57.895,57.895
8,0.980,Klebsiella,16-23,0,0,0,0,NaN,NaN
8,0.980,Klebsiella,23-5,0,0,0,0,NaN,NaN
8,0.980,Hu Cw and Dg,16-23,12,16,0,28,42.857,42.857
8,0.980,Hu Cw and Dg,23-5,15,22,0,37,40.541,40.541
8,0.980,Ground Squirrel,16-23,95,65,0,160,59.375,59.375
8,0.980,Ground Squirrel,23-5,88,82,0,170,51.765,51.765
8,0.980,Opossum,16-23,0,1,0,1,0.000,0.000
8,0.980,Opossum,23-5,0,0,0,0,NaN,NaN
8,0.980,Cow,16-23,1539,1026,0,2565,60.000,60.000
8,0.980,Cow,23-5,1497,1280,0,2777,53.907,53.907
8,0.980,Deer Mouse,16-23,0,0,0,0,NaN,NaN
8,0.980,Deer Mouse,23-5,0,0,0,0,NaN,NaN
8,0.980,OVERALL,16-23,3869,2409,0,6278,61.628,61.628
8,0.980,OVERALL,23-5,4541,2981,0,7522,60.370,60.370
8,0.990,Chicken,16-23,2,10,0,12,16.667,16.667
8,0.990,Chicken,23-5,10,8,0,18,55.556,55.556
8,0.990,Sea Lion,16-23,0,1,0,1,0.000,0.000
8,0.990,Sea Lion,23-5,4,6,0,10,40.000,40.000
8,0.990,Hu and Cw,16-23,7,14,0,21,33.333,33.333
8,0.990,Hu and Cw,23-5,5,24,0,29,17.241,17.241
8,0.990,Sheep,16-23,53,50,0,103,51.456,51.456
8,0.990,Sheep,23-5,61,41,0,102,59.804,59.804
8,0.990,Hu and Dg,16-23,10,17,0,27,37.037,37.037
8,0.990,Hu and Dg,23-5,20,12,0,32,62.500,62.500
8,0.990,Common Loon,16-23,0,0,0,0,NaN,NaN
8,0.990,Common Loon,23-5,0,4,0,4,0.000,0.000
8,0.990,Red-Winged Blackbird,16-23,0,5,0,5,0.000,0.000
8,0.990,Red-Winged Blackbird,23-5,0,2,0,2,0.000,0.000
8,0.990,Cw,16-23,12,10,0,22,54.545,54.545
8,0.990,Cw,23-5,19,42,0,61,31.148,31.148
8,0.990,Cliff Sparrow,16-23,3,19,0,22,13.636,13.636
8,0.990,Cliff Sparrow,23-5,0,11,0,11,0.000,0.000
8,0.990,Pig,16-23,10,10,0,20,50.000,50.000
8,0.990,Pig,23-5,9,8,0,17,52.941,52.941
8,0.990,Barn Owl,16-23,0,0,0,0,NaN,NaN
8,0.990,Barn Owl,23-5,0,0,0,0,NaN,NaN
8,0.990,Wild Pig,16-23,2,2,0,4,50.000,50.000
8,0.990,Wild Pig,23-5,1,2,0,3,33.333,33.333
8,0.990,Pennington Creek Water,16-23,0,0,0,0,NaN,NaN
8,0.990,Pennington Creek Water,23-5,0,0,0,0,NaN,NaN
8,0.990,Guinni,16-23,0,0,0,0,NaN,NaN
8,0.990,Guinni,23-5,0,0,0,0,NaN,NaN
8,0.990,Racoon,16-23,0,0,0,0,NaN,NaN
8,0.990,Racoon,23-5,0,1,0,1,0.000,0.000
8,0.990,Hu,16-23,15,15,0,30,50.000,50.000
8,0.990,Hu,23-5,22,14,0,36,61.111,61.111
8,0.990,Cw and Dg,16-23,9,17,0,26,34.615,34.615
8,0.990,Cw and Dg,23-5,16,13,0,29,55.172,55.172
8,0.990,Red Wind Blackbird,16-23,0,0,0,0,NaN,NaN
8,0.990,Red Wind Blackbird,23-5,0,0,0,0,NaN,NaN
8,0.990,Tree Swallow,16-23,0,0,0,0,NaN,NaN
8,0.990,Tree Swallow,23-5,0,0,0,0,NaN,NaN
8,0.990,Turkey Vulture,16-23,0,0,0,0,NaN,NaN
8,0.990,Turkey Vulture,23-5,0,0,0,0,NaN,NaN
8,0.990,Dg,16-23,6,11,0,17,35.294,35.294
8,0.990,Dg,23-5,31,19,0,50,62.000,62.000
8,0.990,Western Kingbird,16-23,0,0,0,0,NaN,NaN
8,0.990,Western Kingbird,23-5,0,0,0,0,NaN,NaN
8,0.990,White Crowned Sparrow,16-23,0,2,0,2,0.000,0.000
8,0.990,White Crowned Sparrow,23-5,1,9,0,10,10.000,10.000
8,0.990,Eared Grebe,16-23,0,0,0,0,NaN,NaN
8,0.990,Eared Grebe,23-5,0,16,0,16,0.000,0.000
8,0.990,cougar,16-23,0,1,0,1,0.000,0.000
8,0.990,cougar,23-5,0,0,0,0,NaN,NaN
8,0.990,Ocean Water,16-23,0,0,0,0,NaN,NaN
8,0.990,Ocean Water,23-5,0,0,0,0,NaN,NaN
8,0.990,Red Tailed Hawk,16-23,0,1,0,1,0.000,0.000
8,0.990,Red Tailed Hawk,23-5,0,5,0,5,0.000,0.000
8,0.990,Dog,16-23,60,76,0,136,44.118,44.118
8,0.990,Dog,23-5,115,109,0,224,51.339,51.339
8,0.990,Human,16-23,1759,674,0,2433,72.298,72.298
8,0.990,Human,23-5,2198,489,0,2687,81.801,81.801
8,0.990,Wild Turkey,16-23,5,22,0,27,18.519,18.519
8,0.990,Wild Turkey,23-5,4,28,0,32,12.500,12.500
8,0.990,Clark Grebe,16-23,0,0,0,0,NaN,NaN
8,0.990,Clark Grebe,23-5,2,3,0,5,40.000,40.000
8,0.990,Seagull,16-23,0,0,0,0,NaN,NaN
8,0.990,Seagull,23-5,48,6,0,54,88.889,88.889
8,0.990,Surf Scoter,16-23,0,0,0,0,NaN,NaN
8,0.990,Surf Scoter,23-5,2,0,0,2,100.000,100.000
8,0.990,Pigeon,16-23,99,142,0,241,41.079,41.079
8,0.990,Pigeon,23-5,149,238,0,387,38.501,38.501
8,0.990,Pacific Ocean Water,16-23,0,0,0,0,NaN,NaN
8,0.990,Pacific Ocean Water,23-5,0,0,0,0,NaN,NaN
8,0.990,Cat,16-23,22,28,0,50,44.000,44.000
8,0.990,Cat,23-5,32,30,0,62,51.613,51.613
8,0.990,Horse,16-23,10,24,0,34,29.412,29.412
8,0.990,Horse,23-5,33,161,0,194,17.010,17.010
8,0.990,orangutan,16-23,0,0,0,0,NaN,NaN
8,0.990,orangutan,23-5,0,0,0,0,NaN,NaN
8,0.990,Bat,16-23,36,20,0,56,64.286,64.286
8,0.990,Bat,23-5,37,26,0,63,58.730,58.730
8,0.990,Deer,16-23,16,26,0,42,38.095,38.095
8,0.990,Deer,23-5,18,102,0,120,15.000,15.000
8,0.990,Great Horned Owl,16-23,0,0,0,0,NaN,NaN
8,0.990,Great Horned Owl,23-5,0,4,0,4,0.000,0.000
8,0.990,Freshwater Lagoon,16-23,0,0,0,0,NaN,NaN
8,0.990,Freshwater Lagoon,23-5,0,0,0,0,NaN,NaN
8,0.990,Unknown Avian,16-23,0,0,0,0,NaN,NaN
8,0.990,Unknown Avian,23-5,0,0,0,0,NaN,NaN
8,0.990,Human UTI,16-23,85,62,0,147,57.823,57.823
8,0.990,Human UTI,23-5,104,76,0,180,57.778,57.778
8,0.990,unknown,16-23,0,0,0,0,NaN,NaN
8,0.990,unknown,23-5,3,4,0,7,42.857,42.857
8,0.990,SLO Creek Water,16-23,0,0,0,0,NaN,NaN
8,0.990,SLO Creek Water,23-5,0,0,0,0,NaN,NaN
8,0.990,Pig/Swine,16-23,10,8,0,18,55.556,55.556
8,0.990,Pig/Swine,23-5,11,8,0,19,57.895,57.895
8,0.990,Klebsiella,16-23,0,0,0,0,NaN,NaN
8,0.990,Klebsiella,23-5,0,0,0,0,NaN,NaN
8,0.990,Hu Cw and Dg,16-23,12,16,0,28,42.857,42.857
8,0.990,Hu Cw and Dg,23-5,15,21,0,36,41.667,41.667
8,0.990,Ground Squirrel,16-23,97,65,0,162,59.877,59.877
8,0.990,Ground Squirrel,23-5,89,84,0,173,51.445,51.445
8,0.990,Opossum,16-23,1,1,0,2,50.000,50.000
8,0.990,Opossum,23-5,2,0,0,2,100.000,100.000
8,0.990,Cow,16-23,1501,934,0,2435,61.643,61.643
8,0.990,Cow,23-5,1465,1174,0,2639,55.513,55.513
8,0.990,Deer Mouse,16-23,0,0,0,0,NaN,NaN
8,0.990,Deer Mouse,23-5,0,0,0,0,NaN,NaN
8,0.990,OVERALL,16-23,3842,2283,0,6125,62.727,62.727
8,0.990,OVERALL,23-5,4526,2800,0,7326,61.780,61.780
8,1.000,Chicken,16-23,0,0,0,0,NaN,NaN
8,1.000,Chicken,23-5,0,0,0,0,NaN,NaN
8,1.000,Sea Lion,16-23,0,0,0,0,NaN,NaN
8,1.000,Sea Lion,23-5,0,0,0,0,NaN,NaN
8,1.000,Hu and Cw,16-23,0,0,0,0,NaN,NaN
8,1.000,Hu and Cw,23-5,0,0,0,0,NaN,NaN
8,1.000,Sheep,16-23,0,0,0,0,NaN,NaN
8,1.000,Sheep,23-5,0,0,0,0,NaN,NaN
8,1.000,Hu and Dg,16-23,0,0,0,0,NaN,NaN
8,1.000,Hu and Dg,23-5,0,0,0,0,NaN,NaN
8,1.000,Common Loon,16-23,0,0,0,0,NaN,NaN
8,1.000,Common Loon,23-5,0,0,0,0,NaN,NaN
8,1.000,Red-Winged Blackbird,16-23,0,0,0,0,NaN,NaN
8,1.000,Red-Winged Blackbird,23-5,0,0,0,0,NaN,NaN
8,1.000,Cw,16-23,0,0,0,0,NaN,NaN
8,1.000,Cw,23-5,0,0,0,0,NaN,NaN
8,1.000,Cliff Sparrow,16-23,0,0,0,0,NaN,NaN
8,1.000,Cliff Sparrow,23-5,0,0,0,0,NaN,NaN
8,1.000,Pig,16-23,0,0,0,0,NaN,NaN
8,1.000,Pig,23-5,0,0,0,0,NaN,NaN
8,1.000,Barn Owl,16-23,0,0,0,0,NaN,NaN
8,1.000,Barn Owl,23-5,0,0,0,0,NaN,NaN
8,1.000,Wild Pig,16-23,0,0,0,0,NaN,NaN
8,1.000,Wild Pig,23-5,0,0,0,0,NaN,NaN
8,1.000,Pennington Creek Water,16-23,0,0,0,0,NaN,NaN
8,1.000,Pennington Creek Water,23-5,0,0,0,0,NaN,NaN
8,1.000,Guinni,16-23,0,0,0,0,NaN,NaN
8,1.000,Guinni,23-5,0,0,0,0,NaN,NaN
8,1.000,Racoon,16-23,0,0,0,0,NaN,NaN
8,1.000,Racoon,23-5,0,0,0,0,NaN,NaN
8,1.000,Hu,16-23,0,0,0,0,NaN,NaN
8,1.000,Hu,23-5,0,0,0,0,NaN,NaN
8,1.000,Cw and Dg,16-23,0,0,0,0,NaN,NaN
8,1.000,Cw and Dg,23-5,0,0,0,0,NaN,NaN
8,1.000,Red Wind Blackbird,16-23,0,0,0,0,NaN,NaN
8,1.000,Red Wind Blackbird,23-5,0,0,0,0,NaN,NaN
8,1.000,Tree Swallow,16-23,0,0,0,0,NaN,NaN
8,1.000,Tree Swallow,23-5,0,0,0,0,NaN,NaN
8,1.000,Turkey Vulture,16-23,0,0,0,0,NaN,NaN
8,1.000,Turkey Vulture,23-5,0,0,0,0,NaN,NaN
8,1.000,Dg,16-23,0,0,0,0,NaN,NaN
8,1.000,Dg,23-5,0,0,0,0,NaN,NaN
8,1.000,Western Kingbird,16-23,0,0,0,0,NaN,NaN
8,1.000,Western Kingbird,23-5,0,0,0,0,NaN,NaN
8,1.000,White Crowned Sparrow,16-23,0,0,0,0,NaN,NaN
8,1.000,White Crowned Sparrow,23-5,0,0,0,0,NaN,NaN
8,1.000,Eared Grebe,16-23,0,0,0,0,NaN,NaN
8,1.000,Eared Grebe,23-5,0,0,0,0,NaN,NaN
8,1.000,cougar,16-23,0,0,0,0,NaN,NaN
8,1.000,cougar,23-5,0,0,0,0,NaN,NaN
8,1.000,Ocean Water,16-23,0,0,0,0,NaN,NaN
8,1.000,Ocean Water,23-5,0,0,0,0,NaN,NaN
8,1.000,Red Tailed Hawk,16-23,0,0,0,0,NaN,NaN
8,1.000,Red Tailed Hawk,23-5,0,0,0,0,NaN,NaN
8,1.000,Dog,16-23,0,0,0,0,NaN,NaN
8,1.000,Dog,23-5,0,0,0,0,NaN,NaN
8,1.000,Human,16-23,68,0,0,68,100.000,100.000
8,1.000,Human,23-5,90,0,0,90,100.000,100.000
8,1.000,Wild Turkey,16-23,0,0,0,0,NaN,NaN
8,1.000,Wild Turkey,23-5,0,0,0,0,NaN,NaN
8,1.000,Clark Grebe,16-23,0,0,0,0,NaN,NaN
8,1.000,Clark Grebe,23-5,0,0,0,0,NaN,NaN
8,1.000,Seagull,16-23,0,0,0,0,NaN,NaN
8,1.000,Seagull,23-5,0,0,0,0,NaN,NaN
8,1.000,Surf Scoter,16-23,0,0,0,0,NaN,NaN
8,1.000,Surf Scoter,23-5,0,0,0,0,NaN,NaN
8,1.000,Pigeon,16-23,0,0,0,0,NaN,NaN
8,1.000,Pigeon,23-5,0,0,0,0,NaN,NaN
8,1.000,Pacific Ocean Water,16-23,0,0,0,0,NaN,NaN
8,1.000,Pacific Ocean Water,23-5,0,0,0,0,NaN,NaN
8,1.000,Cat,16-23,0,0,0,0,NaN,NaN
8,1.000,Cat,23-5,0,0,0,0,NaN,NaN
8,1.000,Horse,16-23,0,0,0,0,NaN,NaN
8,1.000,Horse,23-5,0,0,0,0,NaN,NaN
8,1.000,orangutan,16-23,0,0,0,0,NaN,NaN
8,1.000,orangutan,23-5,0,0,0,0,NaN,NaN
8,1.000,Bat,16-23,0,0,0,0,NaN,NaN
8,1.000,Bat,23-5,0,0,0,0,NaN,NaN
8,1.000,Deer,16-23,0,0,0,0,NaN,NaN
8,1.000,Deer,23-5,0,0,0,0,NaN,NaN
8,1.000,Great Horned Owl,16-23,0,0,0,0,NaN,NaN
8,1.000,Great Horned Owl,23-5,0,0,0,0,NaN,NaN
8,1.000,Freshwater Lagoon,16-23,0,0,0,0,NaN,NaN
8,1.000,Freshwater Lagoon,23-5,0,0,0,0,NaN,NaN
8,1.000,Unknown Avian,16-23,0,0,0,0,NaN,NaN
8,1.000,Unknown Avian,23-5,0,0,0,0,NaN,NaN
8,1.000,Human UTI,16-23,0,0,0,0,NaN,NaN
8,1.000,Human UTI,23-5,0,0,0,0,NaN,NaN
8,1.000,unknown,16-23,0,0,0,0,NaN,NaN
8,1.000,unknown,23-5,0,0,0,0,NaN,NaN
8,1.000,SLO Creek Water,16-23,0,0,0,0,NaN,NaN
8,1.000,SLO Creek Water,23-5,0,0,0,0,NaN,NaN
8,1.000,Pig/Swine,16-23,0,0,0,0,NaN,NaN
8,1.000,Pig/Swine,23-5,0,0,0,0,NaN,NaN
8,1.000,Klebsiella,16-23,0,0,0,0,NaN,NaN
8,1.000,Klebsiella,23-5,0,0,0,0,NaN,NaN
8,1.000,Hu Cw and Dg,16-23,0,0,0,0,NaN,NaN
8,1.000,Hu Cw and Dg,23-5,0,0,0,0,NaN,NaN
8,1.000,Ground Squirrel,16-23,0,0,0,0,NaN,NaN
8,1.000,Ground Squirrel,23-5,0,0,0,0,NaN,NaN
8,1.000,Opossum,16-23,0,0,0,0,NaN,NaN
8,1.000,Opossum,23-5,0,0,0,0,NaN,NaN
8,1.000,Cow,16-23,0,0,0,0,NaN,NaN
8,1.000,Cow,23-5,0,0,0,0,NaN,NaN
8,1.000,Deer Mouse,16-23,0,0,0,0,NaN,NaN
8,1.000,Deer Mouse,23-5,0,0,0,0,NaN,NaN
8,1.000,OVERALL,16-23,68,0,0,68,100.000,100.000
8,1.000,OVERALL,23-5,90,0,0,90,100.000,100.000
9,0.000,Chicken,16-23,0,4,0,4,0.000,0.000
9,0.000,Chicken,23-5,8,7,0,15,53.333,53.333
9,0.000,Sea Lion,16-23,0,1,0,1,0.000,0.000
9,0.000,Sea Lion,23-5,3,10,0,13,23.077,23.077
9,0.000,Hu and Cw,16-23,5,7,0,12,41.667,41.667
9,0.000,Hu and Cw,23-5,4,9,0,13,30.769,30.769
9,0.000,Sheep,16-23,53,55,0,108,49.074,49.074
9,0.000,Sheep,23-5,58,39,0,97,59.794,59.794
9,0.000,Hu and Dg,16-23,9,16,0,25,36.000,36.000
9,0.000,Hu and Dg,23-5,20,19,0,39,51.282,51.282
9,0.000,Common Loon,16-23,0,0,0,0,NaN,NaN
9,0.000,Common Loon,23-5,0,3,0,3,0.000,0.000
9,0.000,Red-Winged Blackbird,16-23,0,3,0,3,0.000,0.000
9,0.000,Red-Winged Blackbird,23-5,0,0,0,0,NaN,NaN
9,0.000,Cw,16-23,8,14,0,22,36.364,36.364
9,0.000,Cw,23-5,13,32,0,45,28.889,28.889
9,0.000,Cliff Sparrow,16-23,1,14,0,15,6.667,6.667
9,0.000,Cliff Sparrow,23-5,0,7,0,7,0.000,0.000
9,0.000,Pig,16-23,10,9,0,19,52.632,52.632
9,0.000,Pig,23-5,4,5,0,9,44.444,44.444
9,0.000,Barn Owl,16-23,0,0,0,0,NaN,NaN
9,0.000,Barn Owl,23-5,0,0,0,0,NaN,NaN
9,0.000,Wild Pig,16-23,2,0,0,2,100.000,100.000
9,0.000,Wild Pig,23-5,1,1,0,2,50.000,50.000
9,0.000,Pennington Creek Water,16-23,0,0,0,0,NaN,NaN
9,0.000,Pennington Creek Water,23-5,0,0,0,0,NaN,NaN
9,0.000,Guinni,16-23,0,0,0,0,NaN,NaN
9,0.000,Guinni,23-5,0,0,0,0,NaN,NaN
9,0.000,Racoon,16-23,0,0,0,0,NaN,NaN
9,0.000,Racoon,23-5,0,0,0,0,NaN,NaN
9,0.000,Hu,16-23,16,15,0,31,51.613,51.613
9,0.000,Hu,23-5,21,13,0,34,61.765,61.765
9,0.000,Cw and Dg,16-23,5,15,0,20,25.000,25.000
9,0.000,Cw and Dg,23-5,16,17,0,33,48.485,48.485
9,0.000,Red Wind Blackbird,16-23,0,0,0,0,NaN,NaN
9,0.000,Red Wind Blackbird,23-5,0,0,0,0,NaN,NaN
9,0.000,Tree Swallow,16-23,0,0,0,0,NaN,NaN
9,0.000,Tree Swallow,23-5,0,0,0,0,NaN,NaN
9,0.000,Turkey Vulture,16-23,0,0,0,0,NaN,NaN
9,0.000,Turkey Vulture,23-5,0,0,0,0,NaN,NaN
9,0.000,Dg,16-23,6,10,0,16,37.500,37.500
9,0.000,Dg,23-5,31,30,0,61,50.820,50.820
9,0.000,Western Kingbird,16-23,0,0,0,0,NaN,NaN
9,0.000,Western Kingbird,23-5,0,0,0,0,NaN,NaN
9,0.000,White Crowned Sparrow,16-23,0,0,0,0,NaN,NaN
9,0.000,White Crowned Sparrow,23-5,1,6,0,7,14.286,14.286
9,0.000,Eared Grebe,16-23,0,0,0,0,NaN,NaN
9,0.000,Eared Grebe,23-5,0,15,0,15,0.000,0.000
9,0.000,cougar,16-23,0,0,0,0,NaN,NaN
9,0.000,cougar,23-5,0,0,0,0,NaN,NaN
9,0.000,Ocean Water,16-23,0,0,0,0,NaN,NaN
9,0.000,Ocean Water,23-5,0,0,0,0,NaN,NaN
9,0.000,Red Tailed Hawk,16-23,0,0,0,0,NaN,NaN
9,0.000,Red Tailed Hawk,23-5,0,5,0,5,0.000,0.000
9,0.000,Dog,16-23,56,67,0,123,45.528,45.528
9,0.000,Dog,23-5,104,130,0,234,44.444,44.444
9,0.000,Human,16-23,1752,735,0,2487,70.446,70.446
9,0.000,Human,23-5,2201,591,0,2792,78.832,78.832
9,0.000,Wild Turkey,16-23,2,10,0,12,16.667,16.667
9,0.000,Wild Turkey,23-5,0,24,0,24,0.000,0.000
9,0.000,Clark Grebe,16-23,0,0,0,0,NaN,NaN
9,0.000,Clark Grebe,23-5,0,0,0,0,NaN,NaN
9,0.000,Seagull,16-23,0,0,0,0,NaN,NaN
9,0.000,Seagull,23-5,44,8,0,52,84.615,84.615
9,0.000,Surf Scoter,16-23,0,0,0,0,NaN,NaN
9,0.000,Surf Scoter,23-5,0,0,0,0,NaN,NaN
9,0.000,Pigeon,16-23,90,149,0,239,37.657,37.657
9,0.000,Pigeon,23-5,137,182,0,319,42.947,42.947
9,0.000,Pacific Ocean Water,16-23,0,0,0,0,NaN,NaN
9,0.000,Pacific Ocean Water,23-5,0,0,0,0,NaN,NaN
9,0.000,Cat,16-23,19,29,0,48,39.583,39.583
9,0.000,Cat,23-5,27,26,0,53,50.943,50.943
9,0.000,Horse,16-23,7,21,0,28,25.000,25.000
9,0.000,Horse,23-5,31,156,0,187,16.578,16.578
9,0.000,orangutan,16-23,0,0,0,0,NaN,NaN
9,0.000,orangutan,23-5,0,0,0,0,NaN,NaN
9,0.000,Bat,16-23,36,25,0,61,59.016,59.016
9,0.000,Bat,23-5,37,29,0,66,56.061,56.061
9,0.000,Deer,16-23,15,25,0,40,37.500,37.500
9,0.000,Deer,23-5,18,109,0,127,14.173,14.173
9,0.000,Great Horned Owl,16-23,0,0,0,0,NaN,NaN
9,0.000,Great Horned Owl,23-5,0,1,0,1,0.000,0.000
9,0.000,Freshwater Lagoon,16-23,0,0,0,0,NaN,NaN
9,0.000,Freshwater Lagoon,23-5,0,0,0,0,NaN,NaN
9,0.000,Unknown Avian,16-23,0,0,0,0,NaN,NaN
9,0.000,Unknown Avian,23-5,0,0,0,0,NaN,NaN
9,0.000,Human UTI,16-23,77,71,0,148,52.027,52.027
9,0.000,Human UTI,23-5,102,95,0,197,51.777,51.777
9,0.000,unknown,16-23,0,0,0,0,NaN,NaN
9,0.000,unknown,23-5,2,3,0,5,40.000,40.000
9,0.000,SLO Creek Water,16-23,0,0,0,0,NaN,NaN
9,0.000,SLO Creek Water,23-5,0,0,0,0,NaN,NaN
9,0.000,Pig/Swine,16-23,9,9,0,18,50.000,50.000
9,0.000,Pig/Swine,23-5,11,9,0,20,55.000,55.000
9,0.000,Klebsiella,16-23,0,0,0,0,NaN,NaN
9,0.000,Klebsiella,23-5,0,0,0,0,NaN,NaN
9,0.000,Hu Cw and Dg,16-23,12,23,0,35,34.286,34.286
9,0.000,Hu Cw and Dg,23-5,12,22,0,34,35.294,35.294
9,0.000,Ground Squirrel,16-23,90,58,0,148,60.811,60.811
9,0.000,Ground Squirrel,23-5,86,79,0,165,52.121,52.121
9,0.000,Opossum,16-23,0,0,0,0,NaN,NaN
9,0.000,Opossum,23-5,0,0,0,0,NaN,NaN
9,0.000,Cow,16-23,1572,1111,0,2683,58.591,58.591
9,0.000,Cow,23-5,1524,1412,0,2936,51.907,51.907
9,0.000,Deer Mouse,16-23,0,0,0,0,NaN,NaN
9,0.000,Deer Mouse,23-5,0,0,0,0,NaN,NaN
9,0.000,OVERALL,16-23,3852,2496,0,6348,60.681,60.681
9,0.000,OVERALL,23-5,4516,3094,0,7610,59.343,59.343
9,0.500,Chicken,16-23,0,4,0,4,0.000,0.000
9,0.500,Chicken,23-5,8,7,0,15,53.333,53.333
9,0.500,Sea Lion,16-23,0,1,0,1,0.000,0.000
9,0.500,Sea Lion,23-5,3,10,0,13,23.077,23.077
9,0.500,Hu and Cw,16-23,5,7,0,12,41.667,41.667
9,0.500,Hu and Cw,23-5,4,9,0,13,30.769,30.769
9,0.500,Sheep,16-23,53,55,0,108,49.074,49.074
9,0.500,Sheep,23-5,58,39,0,97,59.794,59.794
9,0.500,Hu and Dg,16-23,9,16,0,25,36.000,36.000
9,0.500,Hu and Dg,23-5,20,19,0,39,51.282,51.282
9,0.500,Common Loon,16-23,0,0,0,0,NaN,NaN
9,0.500,Common Loon,23-5,0,3,0,3,0.000,0.000
9,0.500,Red-Winged Blackbird,16-23,0,3,0,3,0.000,0.000
9,0.500,Red-Winged Blackbird,23-5,0,0,0,0,NaN,NaN
9,0.500,Cw,16-23,8,14,0,22,36.364,36.364
9,0.500,Cw,23-5,13,32,0,45,28.889,28.889
9,0.500,Cliff Sparrow,16-23,1,14,0,15,6.667,6.667
9,0.500,Cliff Sparrow,23-5,0,7,0,7,0.000,0.000
9,0.500,Pig,16-23,10,9,0,19,52.632,52.632
9,0.500,Pig,23-5,4,5,0,9,44.444,44.444
9,0.500,Barn Owl,16-23,0,0,0,0,NaN,NaN
9,0.500,Barn Owl,23-5,0,0,0,0,NaN,NaN
9,0.500,Wild Pig,16-23,2,0,0,2,100.000,100.000
9,0.500,Wild Pig,23-5,1,1,0,2,50.000,50.000
9,0.500,Pennington Creek Water,16-23,0,0,0,0,NaN,NaN
9,0.500,Pennington Creek Water,23-5,0,0,0,0,NaN,NaN
9,0.500,Guinni,16-23,0,0,0,0,NaN,NaN
9,0.500,Guinni,23-5,0,0,0,0,NaN,NaN
9,0.500,Racoon,16-23,0,0,0,0,NaN,NaN
9,0.500,Racoon,23-5,0,0,0,0,NaN,NaN
9,0.500,Hu,16-23,16,15,0,31,51.613,51.613
9,0.500,Hu,23-5,21,13,0,34,61.765,61.765
9,0.500,Cw and Dg,16-23,5,15,0,20,25.000,25.000
9,0.500,Cw and Dg,23-5,16,17,0,33,48.485,48.485
9,0.500,Red Wind Blackbird,16-23,0,0,0,0,NaN,NaN
9,0.500,Red Wind Blackbird,23-5,0,0,0,0,NaN,NaN
9,0.500,Tree Swallow,16-23,0,0,0,0,NaN,NaN
9,0.500,Tree Swallow,23-5,0,0,0,0,NaN,NaN
9,0.500,Turkey Vulture,16-23,0,0,0,0,NaN,NaN
9,0.500,Turkey Vulture,23-5,0,0,0,0,NaN,NaN
9,0.500,Dg,16-23,6,10,0,16,37.500,37.500
9,0.500,Dg,23-5,31,30,0,61,50.820,50.820
9,0.500,Western Kingbird,16-23,0,0,0,0,NaN,NaN
9,0.500,Western Kingbird,23-5,0,0,0,0,NaN,NaN
9,0.500,White Crowned Sparrow,16-23,0,0,0,0,NaN,NaN
9,0.500,White Crowned Sparrow,23-5,1,6,0,7,14.286,14.286
9,0.500,Eared Grebe,16-23,0,0,0,0,NaN,NaN
9,0.500,Eared Grebe,23-5,0,15,0,15,0.000,0.000
9,0.500,cougar,16-23,0,0,0,0,NaN,NaN
9,0.500,cougar,23-5,0,0,0,0,NaN,NaN
9,0.500,Ocean Water,16-23,0,0,0,0,NaN,NaN
9,0.500,Ocean Water,23-5,0,0,0,0,NaN,NaN
9,0.500,Red Tailed Hawk,16-23,0,0,0,0,NaN,NaN
9,0.500,Red Tailed Hawk,23-5,0,5,0,5,0.000,0.000
9,0.500,Dog,16-23,56,67,0,123,45.528,45.528
9,0.500,Dog,23-5,104,130,0,234,44.444,44.444
9,0.500,Human,16-23,1752,735,0,2487,70.446,70.446
9,0.500,Human,23-5,2201,591,0,2792,78.832,78.832
9,0.500,Wild Turkey,16-23,2,10,0,12,16.667,16.667
9,0.500,Wild Turkey,23-5,0,24,0,24,0.000,0.000
9,0.500,Clark Grebe,16-23,0,0,0,0,NaN,NaN
9,0.500,Clark Grebe,23-5,0,0,0,0,NaN,NaN
9,0.500,Seagull,16-23,0,0,0,0,NaN,NaN
9,0.500,Seagull,23-5,44,8,0,52,84.615,84.615
9,0.500,Surf Scoter,16-23,0,0,0,0,NaN,NaN
9,0.500,Surf Scoter,23-5,0,0,0,0,NaN,NaN
9,0.500,Pigeon,16-23,90,149,0,239,37.657,37.657
9,0.500,Pigeon,23-5,137,182,0,319,42.947,42.947
9,0.500,Pacific Ocean Water,16-23,0,0,0,0,NaN,NaN
9,0.500,Pacific Ocean Water,23-5,0,0,0,0,NaN,NaN
9,0.500,Cat,16-23,19,29,0,48,39.583,39.583
9,0.500,Cat,23-5,27,26,0,53,50.943,50.943
9,0.500,Horse,16-23,7,21,0,28,25.000,25.000
9,0.500,Horse,23-5,31,156,0,187,16.578,16.578
9,0.500,orangutan,16-23,0,0,0,0,NaN,NaN
9,0.500,orangutan,23-5,0,0,0,0,NaN,NaN
9,0.500,Bat,16-23,36,25,0,61,59.016,59.016
9,0.500,Bat,23-5,37,29,0,66,56.061,56.061
9,0.500,Deer,16-23,15,25,0,40,37.500,37.500
9,0.500,Deer,23-5,18,109,0,127,14.173,14.173
9,0.500,Great Horned Owl,16-23,0,0,0,0,NaN,NaN
9,0.500,Great Horned Owl,23-5,0,1,0,1,0.000,0.000
9,0.500,Freshwater Lagoon,16-23,0,0,0,0,NaN,NaN
9,0.500,Freshwater Lagoon,23-5,0,0,0,0,NaN,NaN
9,0.500,Unknown Avian,16-23,0,0,0,0,NaN,NaN
9,0.500,Unknown Avian,23-5,0,0,0,0,NaN,NaN
9,0.500,Human UTI,16-23,77,71,0,148,52.027,52.027
9,0.500,Human UTI,23-5,102,95,0,197,51.777,51.777
9,0.500,unknown,16-23,0,0,0,0,NaN,NaN
9,0.500,unknown,23-5,2,3,0,5,40.000,40.000
9,0.500,SLO Creek Water,16-23,0,0,0,0,NaN,NaN
9,0.500,SLO Creek Water,23-5,0,0,0,0,NaN,NaN
9,0.500,Pig/Swine,16-23,9,9,0,18,50.000,50.000
9,0.500,Pig/Swine,23-5,11,9,0,20,55.000,55.000
9,0.500,Klebsiella,16-23,0,0,0,0,NaN,NaN
9,0.500,Klebsiella,23-5,0,0,0,0,NaN,NaN
9,0.500,Hu Cw and Dg,16-23,12,23,0,35,34.286,34.286
9,0.500,Hu Cw and Dg,23-5,12,22,0,34,35.294,35.294
9,0.500,Ground Squirrel,16-23,90,58,0,148,60.811,60.811
9,0.500,Ground Squirrel,23-5,86,79,0,165,52.121,52.121
9,0.500,Opossum,16-23,0,0,0,0,NaN,NaN
9,0.500,Opossum,23-5,0,0,0,0,NaN,NaN
9,0.500,Cow,16-23,1572,1111,0,2683,58.591,58.591
9,0.500,Cow,23-5,1524,1412,0,2936,51.907,51.907
9,0.500,Deer Mouse,16-23,0,0,0,0,NaN,NaN
9,0.500,Deer Mouse,23-5,0,0,0,0,NaN,NaN
9,0.500,OVERALL,16-23,3852,2496,0,6348,60.681,60.681
9,0.500,OVERALL,23-5,4516,3094,0,7610,59.343,59.343
9,0.900,Chicken,16-23,0,4,0,4,0.000,0.000
9,0.900,Chicken,23-5,8,7,0,15,53.333,53.333
9,0.900,Sea Lion,16-23,0,1,0,1,0.000,0.000
9,0.900,Sea Lion,23-5,3,10,0,13,23.077,23.077
9,0.900,Hu and Cw,16-23,5,7,0,12,41.667,41.667
9,0.900,Hu and Cw,23-5,4,9,0,13,30.769,30.769
9,0.900,Sheep,16-23,53,55,0,108,49.074,49.074
9,0.900,Sheep,23-5,58,39,0,97,59.794,59.794
9,0.900,Hu and Dg,16-23,9,16,0,25,36.000,36.000
9,0.900,Hu and Dg,23-5,20,19,0,39,51.282,51.282
9,0.900,Common Loon,16-23,0,0,0,0,NaN,NaN
9,0.900,Common Loon,23-5,0,3,0,3,0.000,0.000
9,0.900,Red-Winged Blackbird,16-23,0,3,0,3,0.000,0.000
9,0.900,Red-Winged Blackbird,23-5,0,0,0,0,NaN,NaN
9,0.900,Cw,16-23,8,14,0,22,36.364,36.364
9,0.900,Cw,23-5,13,32,0,45,28.889,28.889
9,0.900,Cliff Sparrow,16-23,1,14,0,15,6.667,6.667
9,0.900,Cliff Sparrow,23-5,0,7,0,7,0.000,0.000
9,0.900,Pig,16-23,10,9,0,19,52.632,52.632
9,0.900,Pig,23-5,4,5,0,9,44.444,44.444
9,0.900,Barn Owl,16-23,0,0,0,0,NaN,NaN
9,0.900,Barn Owl,23-5,0,0,0,0,NaN,NaN
9,0.900,Wild Pig,16-23,2,0,0,2,100.000,100.000
9,0.900,Wild Pig,23-5,1,1,0,2,50.000,50.000
9,0.900,Pennington Creek Water,16-23,0,0,0,0,NaN,NaN
9,0.900,Pennington Creek Water,23-5,0,0,0,0,NaN,NaN
9,0.900,Guinni,16-23,0,0,0,0,NaN,NaN
9,0.900,Guinni,23-5,0,0,0,0,NaN,NaN
9,0.900,Racoon,16-23,0,0,0,0,NaN,NaN
9,0.900,Racoon,23-5,0,0,0,0,NaN,NaN
9,0.900,Hu,16-23,16,15,0,31,51.613,51.613
9,0.900,Hu,23-5,21,13,0,34,61.765,61.765
9,0.900,Cw and Dg,16-23,5,15,0,20,25.000,25.000
9,0.900,Cw and Dg,23-5,16,17,0,33,48.485,48.485
9,0.900,Red Wind Blackbird,16-23,0,0,0,0,NaN,NaN
9,0.900,Red Wind Blackbird,23-5,0,0,0,0,NaN,NaN
9,0.900,Tree Swallow,16-23,0,0,0,0,NaN,NaN
9,0.900,Tree Swallow,23-5,0,0,0,0,NaN,NaN
9,0.900,Turkey Vulture,16-23,0,0,0,0,NaN,NaN
9,0.900,Turkey Vulture,23-5,0,0,0,0,NaN,NaN
9,0.900,Dg,16-23,6,10,0,16,37.500,37.500
9,0.900,Dg,23-5,31,30,0,61,50.820,50.820
9,0.900,Western Kingbird,16-23,0,0,0,0,NaN,NaN
9,0.900,Western Kingbird,23-5,0,0,0,0,NaN,NaN
9,0.900,White Crowned Sparrow,16-23,0,0,0,0,NaN,NaN
9,0.900,White Crowned Sparrow,23-5,1,6,0,7,14.286,14.286
9,0.900,Eared Grebe,16-23,0,0,0,0,NaN,NaN
9,0.900,Eared Grebe,23-5,0,15,0,15,0.000,0.000
9,0.900,cougar,16-23,0,0,0,0,NaN,NaN
9,0.900,cougar,23-5,0,0,0,0,NaN,NaN
9,0.900,Ocean Water,16-23,0,0,0,0,NaN,NaN
9,0.900,Ocean Water,23-5,0,0,0,0,NaN,NaN
9,0.900,Red Tailed Hawk,16-23,0,0,0,0,NaN,NaN
9,0.900,Red Tailed Hawk,23-5,0,5,0,5,0.000,0.000
9,0.900,Dog,16-23,56,67,0,123,45.528,45.528
9,0.900,Dog,23-5,104,126,0,230,45.217,45.217
9,0.900,Human,16-23,1752,734,0,2486,70.475,70.475
9,0.900,Human,23-5,2201,585,0,2786,79.002,79.002
9,0.900,Wild Turkey,16-23,2,10,0,12,16.667,16.667
9,0.900,Wild Turkey,23-5,0,24,0,24,0.000,0.000
9,0.900,Clark Grebe,16-23,0,0,0,0,NaN,NaN
9,0.900,Clark Grebe,23-5,0,0,0,0,NaN,NaN
9,0.900,Seagull,16-23,0,0,0,0,NaN,NaN
9,0.900,Seagull,23-5,44,9,0,53,83.019,83.019
9,0.900,Surf Scoter,16-23,0,0,0,0,NaN,NaN
9,0.900,Surf Scoter,23-5,0,0,0,0,NaN,NaN
9,0.900,Pigeon,16-23,90,149,0,239,37.657,37.657
9,0.900,Pigeon,23-5,137,182,0,319,42.947,42.947
9,0.900,Pacific Ocean Water,16-23,0,0,0,0,NaN,NaN
9,0.900,Pacific Ocean Water,23-5,0,0,0,0,NaN,NaN
9,0.900,Cat,16-23,19,29,0,48,39.583,39.583
9,0.900,Cat,23-5,27,26,0,53,50.943,50.943
9,0.900,Horse,16-23,7,21,0,28,25.000,25.000
9,0.900,Horse,23-5,31,156,0,187,16.578,16.578
9,0.900,orangutan,16-23,0,0,0,0,NaN,NaN
9,0.900,orangutan,23-5,0,0,0,0,NaN,NaN
9,0.900,Bat,16-23,36,25,0,61,59.016,59.016
9,0.900,Bat,23-5,37,29,0,66,56.061,56.061
9,0.900,Deer,16-23,15,25,0,40,37.500,37.500
9,0.900,Deer,23-5,18,109,0,127,14.173,14.173
9,0.900,Great Horned Owl,16-23,0,0,0,0,NaN,NaN
9,0.900,Great Horned Owl,23-5,0,1,0,1,0.000,0.000
9,0.900,Freshwater Lagoon,16-23,0,0,0,0,NaN,NaN
9,0.900,Freshwater Lagoon,23-5,0,0,0,0,NaN,NaN
9,0.900,Unknown Avian,16-23,0,0,0,0,NaN,NaN
9,0.900,Unknown Avian,23-5,0,0,0,0,NaN,NaN
9,0.900,Human UTI,16-23,77,71,0,148,52.027,52.027
9,0.900,Human UTI,23-5,105,95,0,200,52.500,52.500
9,0.900,unknown,16-23,0,0,0,0,NaN,NaN
9,0.900,unknown,23-5,2,3,0,5,40.000,40.000
9,0.900,SLO Creek Water,16-23,0,0,0,0,NaN,NaN
9,0.900,SLO Creek Water,23-5,0,0,0,0,NaN,NaN
9,0.900,Pig/Swine,16-23,9,9,0,18,50.000,50.000
9,0.900,Pig/Swine,23-5,11,9,0,20,55.000,55.000
9,0.900,Klebsiella,16-23,0,0,0,0,NaN,NaN
9,0.900,Klebsiella,23-5,0,0,0,0,NaN,NaN
9,0.900,Hu Cw and Dg,16-23,12,23,0,35,34.286,34.286
9,0.900,Hu Cw and Dg,23-5,12,22,0,34,35.294,35.294
9,0.900,Ground Squirrel,16-23,90,58,0,148,60.811,60.811
9,0.900,Ground Squirrel,23-5,86,79,0,165,52.121,52.121
9,0.900,Opossum,16-23,0,0,0,0,NaN,NaN
9,0.900,Opossum,23-5,0,0,0,0,NaN,NaN
9,0.900,Cow,16-23,1572,1108,0,2680,58.657,58.657
9,0.900,Cow,23-5,1524,1410,0,2934,51.943,51.943
9,0.900,Deer Mouse,16-23,0,0,0,0,NaN,NaN
9,0.900,Deer Mouse,23-5,0,0,0,0,NaN,NaN
9,0.900,OVERALL,16-23,3852,2492,0,6344,60.719,60.719
9,0.900,OVERALL,23-5,4519,3083,0,7602,59.445,59.445
9,0.950,Chicken,16-23,0,4,0,4,0.000,0.000
9,0.950,Chicken,23-5,8,7,0,15,53.333,53.333
9,0.950,Sea Lion,16-23,0,1,0,1,0.000,0.000
9,0.950,Sea Lion,23-5,3,10,0,13,23.077,23.077
9,0.950,Hu and Cw,16-23,5,7,0,12,41.667,41.667
9,0.950,Hu and Cw,23-5,4,9,0,13,30.769,30.769
9,0.950,Sheep,16-23,53,55,0,108,49.074,49.074
9,0.950,Sheep,23-5,58,39,0,97,59.794,59.794
9,0.950,Hu and Dg,16-23,9,16,0,25,36.000,36.000
9,0.950,Hu and Dg,23-5,20,19,0,39,51.282,51.282
9,0.950,Common Loon,16-23,0,0,0,0,NaN,NaN
9,0.950,Common Loon,23-5,0,3,0,3,0.000,0.000
9,0.950,Red-Winged Blackbird,16-23,0,3,0,3,0.000,0.000
9,0.950,Red-Winged Blackbird,23-5,0,0,0,0,NaN,NaN
9,0.950,Cw,16-23,8,14,0,22,36.364,36.364
9,0.950,Cw,23-5,13,32,0,45,28.889,28.889
9,0.950,Cliff Sparrow,16-23,1,14,0,15,6.667,6.667
9,0.950,Cliff Sparrow,23-5,0,7,0,7,0.000,0.000
9,0.950,Pig,16-23,10,9,0,19,52.632,52.632
9,0.950,Pig,23-5,4,5,0,9,44.444,44.444
9,0.950,Barn Owl,16-23,0,0,0,0,NaN,NaN
9,0.950,Barn Owl,23-5,0,0,0,0,NaN,NaN
9,0.950,Wild Pig,16-23,2,0,0,2,100.000,100.000
9,0.950,Wild Pig,23-5,1,1,0,2,50.000,50.000
9,0.950,Pennington Creek Water,16-23,0,0,0,0,NaN,NaN
9,0.950,Pennington Creek Water,23-5,0,0,0,0,NaN,NaN
9,0.950,Guinni,16-23,0,0,0,0,NaN,NaN
9,0.950,Guinni,23-5,0,0,0,0,NaN,NaN
9,0.950,Racoon,16-23,0,0,0,0,NaN,NaN
9,0.950,Racoon,23-5,0,0,0,0,NaN,NaN
9,0.950,Hu,16-23,16,15,0,31,51.613,51.613
9,0.950,Hu,23-5,21,13,0,34,61.765,61.765
9,0.950,Cw and Dg,16-23,5,15,0,20,25.000,25.000
9,0.950,Cw and Dg,23-5,16,17,0,33,48.485,48.485
9,0.950,Red Wind Blackbird,16-23,0,0,0,0,NaN,NaN
9,0.950,Red Wind Blackbird,23-5,0,0,0,0,NaN,NaN
9,0.950,Tree Swallow,16-23,0,0,0,0,NaN,NaN
9,0.950,Tree Swallow,23-5,0,0,0,0,NaN,NaN
9,0.950,Turkey Vulture,16-23,0,0,0,0,NaN,NaN
9,0.950,Turkey Vulture,23-5,0,0,0,0,NaN,NaN
9,0.950,Dg,16-23,6,10,0,16,37.500,37.500
9,0.950,Dg,23-5,31,30,0,61,50.820,50.820
9,0.950,Western Kingbird,16-23,0,0,0,0,NaN,NaN
9,0.950,Western Kingbird,23-5,0,0,0,0,NaN,NaN
9,0.950,White Crowned Sparrow,16-23,0,0,0,0,NaN,NaN
9,0.950,White Crowned Sparrow,23-5,1,6,0,7,14.286,14.286
9,0.950,Eared Grebe,16-23,0,0,0,0,NaN,NaN
9,0.950,Eared Grebe,23-5,0,15,0,15,0.000,0.000
9,0.950,cougar,16-23,0,0,0,0,NaN,NaN
9,0.950,cougar,23-5,0,0,0,0,NaN,NaN
9,0.950,Ocean Water,16-23,0,0,0,0,NaN,NaN
9,0.950,Ocean Water,23-5,0,0,0,0,NaN,NaN
9,0.950,Red Tailed Hawk,16-23,0,0,0,0,NaN,NaN
9,0.950,Red Tailed Hawk,23-5,0,5,0,5,0.000,0.000
9,0.950,Dog,16-23,56,67,0,123,45.528,45.528
9,0.950,Dog,23-5,104,124,0,228,45.614,45.614
9,0.950,Human,16-23,1752,733,0,2485,70.503,70.503
9,0.950,Human,23-5,2203,578,0,2781,79.216,79.216
9,0.950,Wild Turkey,16-23,2,10,0,12,16.667,16.667
9,0.950,Wild Turkey,23-5,0,24,0,24,0.000,0.000
9,0.950,Clark Grebe,16-23,0,0,0,0,NaN,NaN
9,0.950,Clark Grebe,23-5,0,0,0,0,NaN,NaN
9,0.950,Seagull,16-23,0,0,0,0,NaN,NaN
9,0.950,Seagull,23-5,44,8,0,52,84.615,84.615
9,0.950,Surf Scoter,16-23,0,0,0,0,NaN,NaN
9,0.950,Surf Scoter,23-5,0,0,0,0,NaN,NaN
9,0.950,Pigeon,16-23,91,148,0,239,38.075,38.075
9,0.950,Pigeon,23-5,137,183,0,320,42.813,42.813
9,0.950,Pacific Ocean Water,16-23,0,0,0,0,NaN,NaN
9,0.950,Pacific Ocean Water,23-5,0,0,0,0,NaN,NaN
9,0.950,Cat,16-23,19,29,0,48,39.583,39.583
9,0.950,Cat,23-5,27,26,0,53,50.943,50.943
9,0.950,Horse,16-23,7,21,0,28,25.000,25.000
9,0.950,Horse,23-5,31,156,0,187,16.578,16.578
9,0.950,orangutan,16-23,0,0,0,0,NaN,NaN
9,0.950,orangutan,23-5,0,0,0,0,NaN,NaN
9,0.950,Bat,16-23,36,25,0,61,59.016,59.016
9,0.950,Bat,23-5,37,28,0,65,56.923,56.923
9,0.950,Deer,16-23,15,25,0,40,37.500,37.500
9,0.950,Deer,23-5,18,109,0,127,14.173,14.173
9,0.950,Great Horned Owl,16-23,0,0,0,0,NaN,NaN
9,0.950,Great Horned Owl,23-5,0,1,0,1,0.000,0.000
9,0.950,Freshwater Lagoon,16-23,0,0,0,0,NaN,NaN
9,0.950,Freshwater Lagoon,23-5,0,0,0,0,NaN,NaN
9,0.950,Unknown Avian,16-23,0,0,0,0,NaN,NaN
9,0.950,Unknown Avian,23-5,0,0,0,0,NaN,NaN
9,0.950,Human UTI,16-23,80,72,0,152,52.632,52.632
9,0.950,Human UTI,23-5,104,97,0,201,51.741,51.741
9,0.950,unknown,16-23,0,0,0,0,NaN,NaN
9,0.950,unknown,23-5,2,3,0,5,40.000,40.000
9,0.950,SLO Creek Water,16-23,0,0,0,0,NaN,NaN
9,0.950,SLO Creek Water,23-5,0,0,0,0,NaN,NaN
9,0.950,Pig/Swine,16-23,9,9,0,18,50.000,50.000
9,0.950,Pig/Swine,23-5,11,9,0,20,55.000,55.000
9,0.950,Klebsiella,16-23,0,0,0,0,NaN,NaN
9,0.950,Klebsiella,23-5,0,0,0,0,NaN,NaN
9,0.950,Hu Cw and Dg,16-23,12,23,0,35,34.286,34.286
9,0.950,Hu Cw and Dg,23-5,12,22,0,34,35.294,35.294
9,0.950,Ground Squirrel,16-23,90,58,0,148,60.811,60.811
9,0.950,Ground Squirrel,23-5,86,78,0,164,52.439,52.439
9,0.950,Opossum,16-23,0,0,0,0,NaN,NaN
9,0.950,Opossum,23-5,0,0,0,0,NaN,NaN
9,0.950,Cow,16-23,1572,1088,0,2660,59.098,59.098
9,0.950,Cow,23-5,1523,1407,0,2930,51.980,51.980
9,0.950,Deer Mouse,16-23,0,0,0,0,NaN,NaN
9,0.950,Deer Mouse,23-5,0,0,0,0,NaN,NaN
9,0.950,OVERALL,16-23,3856,2471,0,6327,60.945,60.945
9,0.950,OVERALL,23-5,4519,3071,0,7590,59.539,59.539
9,0.960,Chicken,16-23,0,4,0,4,0.000,0.000
9,0.960,Chicken,23-5,8,7,0,15,53.333,53.333
9,0.960,Sea Lion,16-23,0,1,0,1,0.000,0.000
9,0.960,Sea Lion,23-5,3,10,0,13,23.077,23.077
9,0.960,Hu and Cw,16-23,5,7,0,12,41.667,41.667
9,0.960,Hu and Cw,23-5,4,9,0,13,30.769,30.769
9,0.960,Sheep,16-23,53,55,0,108,49.074,49.074
9,0.960,Sheep,23-5,58,40,0,98,59.184,59.184
9,0.960,Hu and Dg,16-23,9,16,0,25,36.000,36.000
9,0.960,Hu and Dg,23-5,20,19,0,39,51.282,51.282
9,0.960,Common Loon,16-23,0,0,0,0,NaN,NaN
9,0.960,Common Loon,23-5,0,3,0,3,0.000,0.000
9,0.960,Red-Winged Blackbird,16-23,0,3,0,3,0.000,0.000
9,0.960,Red-Winged Blackbird,23-5,0,0,0,0,NaN,NaN
9,0.960,Cw,16-23,8,14,0,22,36.364,36.364
9,0.960,Cw,23-5,13,32,0,45,28.889,28.889
9,0.960,Cliff Sparrow,16-23,1,14,0,15,6.667,6.667
9,0.960,Cliff Sparrow,23-5,0,7,0,7,0.000,0.000
9,0.960,Pig,16-23,10,9,0,19,52.632,52.632
9,0.960,Pig,23-5,4,5,0,9,44.444,44.444
9,0.960,Barn Owl,16-23,0,0,0,0,NaN,NaN
9,0.960,Barn Owl,23-5,0,0,0,0,NaN,NaN
9,0.960,Wild Pig,16-23,2,0,0,2,100.000,100.000
9,0.960,Wild Pig,23-5,1,1,0,2,50.000,50.000
9,0.960,Pennington Creek Water,16-23,0,0,0,0,NaN,NaN
9,0.960,Pennington Creek Water,23-5,0,0,0,0,NaN,NaN
9,0.960,Guinni,16-23,0,0,0,0,NaN,NaN
9,0.960,Guinni,23-5,0,0,0,0,NaN,NaN
9,0.960,Racoon,16-23,0,0,0,0,NaN,NaN
9,0.960,Racoon,23-5,0,0,0,0,NaN,NaN
9,0.960,Hu,16-23,16,15,0,31,51.613,51.613
9,0.960,Hu,23-5,21,13,0,34,61.765,61.765
9,0.960,Cw and Dg,16-23,5,15,0,20,25.000,25.000
9,0.960,Cw and Dg,23-5,16,17,0,33,48.485,48.485
9,0.960,Red Wind Blackbird,16-23,0,0,0,0,NaN,NaN
9,0.960,Red Wind Blackbird,23-5,0,0,0,0,NaN,NaN
9,0.960,Tree Swallow,16-23,0,0,0,0,NaN,NaN
9,0.960,Tree Swallow,23-5,0,0,0,0,NaN,NaN
9,0.960,Turkey Vulture,16-23,0,0,0,0,NaN,NaN
9,0.960,Turkey Vulture,23-5,0,0,0,0,NaN,NaN
9,0.960,Dg,16-23,6,10,0,16,37.500,37.500
9,0.960,Dg,23-5,31,30,0,61,50.820,50.820
9,0.960,Western Kingbird,16-23,0,0,0,0,NaN,NaN
9,0.960,Western Kingbird,23-5,0,0,0,0,NaN,NaN
9,0.960,White Crowned Sparrow,16-23,0,0,0,0,NaN,NaN
9,0.960,White Crowned Sparrow,23-5,1,6,0,7,14.286,14.286
9,0.960,Eared Grebe,16-23,0,0,0,0,NaN,NaN
9,0.960,Eared Grebe,23-5,0,15,0,15,0.000,0.000
9,0.960,cougar,16-23,0,0,0,0,NaN,NaN
9,0.960,cougar,23-5,0,0,0,0,NaN,NaN
9,0.960,Ocean Water,16-23,0,0,0,0,NaN,NaN
9,0.960,Ocean Water,23-5,0,0,0,0,NaN,NaN
9,0.960,Red Tailed Hawk,16-23,0,0,0,0,NaN,NaN
9,0.960,Red Tailed Hawk,23-5,0,5,0,5,0.000,0.000
9,0.960,Dog,16-23,56,67,0,123,45.528,45.528
9,0.960,Dog,23-5,104,119,0,223,46.637,46.637
9,0.960,Human,16-23,1754,731,0,2485,70.584,70.584
9,0.960,Human,23-5,2203,565,0,2768,79.588,79.588
9,0.960,Wild Turkey,16-23,2,10,0,12,16.667,16.667
9,0.960,Wild Turkey,23-5,0,28,0,28,0.000,0.000
9,0.960,Clark Grebe,16-23,0,0,0,0,NaN,NaN
9,0.960,Clark Grebe,23-5,0,0,0,0,NaN,NaN
9,0.960,Seagull,16-23,0,0,0,0,NaN,NaN
9,0.960,Seagull,23-5,44,9,0,53,83.019,83.019
9,0.960,Surf Scoter,16-23,0,0,0,0,NaN,NaN
9,0.960,Surf Scoter,23-5,0,2,0,2,0.000,0.000
9,0.960,Pigeon,16-23,90,148,0,238,37.815,37.815
9,0.960,Pigeon,23-5,138,197,0,335,41.194,41.194
9,0.960,Pacific Ocean Water,16-23,0,0,0,0,NaN,NaN
9,0.960,Pacific Ocean Water,23-5,0,0,0,0,NaN,NaN
9,0.960,Cat,16-23,19,29,0,48,39.583,39.583
9,0.960,Cat,23-5,27,26,0,53,50.943,50.943
9,0.960,Horse,16-23,7,21,0,28,25.000,25.000
9,0.960,Horse,23-5,31,156,0,187,16.578,16.578
9,0.960,orangutan,16-23,0,0,0,0,NaN,NaN
9,0.960,orangutan,23-5,0,0,0,0,NaN,NaN
9,0.960,Bat,16-23,36,25,0,61,59.016,59.016
9,0.960,Bat,23-5,37,28,0,65,56.923,56.923
9,0.960,Deer,16-23,15,25,0,40,37.500,37.500
9,0.960,Deer,23-5,18,109,0,127,14.173,14.173
9,0.960,Great Horned Owl,16-23,0,0,0,0,NaN,NaN
9,0.960,Great Horned Owl,23-5,0,1,0,1,0.000,0.000
9,0.960,Freshwater Lagoon,16-23,0,0,0,0,NaN,NaN
9,0.960,Freshwater Lagoon,23-5,0,0,0,0,NaN,NaN
9,0.960,Unknown Avian,16-23,0,0,0,0,NaN,NaN
9,0.960,Unknown Avian,23-5,0,0,0,0,NaN,NaN
9,0.960,Human UTI,16-23,80,73,0,153,52.288,52.288
9,0.960,Human UTI,23-5,104,96,0,200,52.000,52.000
9,0.960,unknown,16-23,0,0,0,0,NaN,NaN
9,0.960,unknown,23-5,2,3,0,5,40.000,40.000
9,0.960,SLO Creek Water,16-23,0,0,0,0,NaN,NaN
9,0.960,SLO Creek Water,23-5,0,0,0,0,NaN,NaN
9,0.960,Pig/Swine,16-23,9,9,0,18,50.000,50.000
9,0.960,Pig/Swine,23-5,11,9,0,20,55.000,55.000
9,0.960,Klebsiella,16-23,0,0,0,0,NaN,NaN
9,0.960,Klebsiella,23-5,0,0,0,0,NaN,NaN
9,0.960,Hu Cw and Dg,16-23,12,23,0,35,34.286,34.286
9,0.960,Hu Cw and Dg,23-5,12,22,0,34,35.294,35.294
9,0.960,Ground Squirrel,16-23,90,58,0,148,60.811,60.811
9,0.960,Ground Squirrel,23-5,86,80,0,166,51.807,51.807
9,0.960,Opossum,16-23,0,0,0,0,NaN,NaN
9,0.960,Opossum,23-5,0,0,0,0,NaN,NaN
9,0.960,Cow,16-23,1570,1079,0,2649,59.268,59.268
9,0.960,Cow,23-5,1523,1391,0,2914,52.265,52.265
9,0.960,Deer Mouse,16-23,0,0,0,0,NaN,NaN
9,0.960,Deer Mouse,23-5,0,0,0,0,NaN,NaN
9,0.960,OVERALL,16-23,3855,2461,0,6316,61.035,61.035
9,0.960,OVERALL,23-5,4520,3060,0,7580,59.631,59.631
9,0.970,Chicken,16-23,0,4,0,4,0.000,0.000
9,0.970,Chicken,23-5,8,7,0,15,53.333,53.333
9,0.970,Sea Lion,16-23,0,1,0,1,0.000,0.000
9,0.970,Sea Lion,23-5,3,10,0,13,23.077,23.077
9,0.970,Hu and Cw,16-23,5,7,0,12,41.667,41.667
9,0.970,Hu and Cw,23-5,4,9,0,13,30.769,30.769
9,0.970,Sheep,16-23,54,56,0,110,49.091,49.091
9,0.970,Sheep,23-5,58,39,0,97,59.794,59.794
9,0.970,Hu and Dg,16-23,9,16,0,25,36.000,36.000
9,0.970,Hu and Dg,23-5,20,19,0,39,51.282,51.282
9,0.970,Common Loon,16-23,0,0,0,0,NaN,NaN
9,0.970,Common Loon,23-5,0,3,0,3,0.000,0.000
9,0.970,Red-Winged Blackbird,16-23,0,3,0,3,0.000,0.000
9,0.970,Red-Winged Blackbird,23-5,0,0,0,0,NaN,NaN
9,0.970,Cw,16-23,8,15,0,23,34.783,34.783
9,0.970,Cw,23-5,13,32,0,45,28.889,28.889
9,0.970,Cliff Sparrow,16-23,1,14,0,15,6.667,6.667
9,0.970,Cliff Sparrow,23-5,0,7,0,7,0.000,0.000
9,0.970,Pig,16-23,10,9,0,19,52.632,52.632
9,0.970,Pig,23-5,4,5,0,9,44.444,44.444
9,0.970,Barn Owl,16-23,0,0,0,0,NaN,NaN
9,0.970,Barn Owl,23-5,0,0,0,0,NaN,NaN
9,0.970,Wild Pig,16-23,2,0,0,2,100.000,100.000
9,0.970,Wild Pig,23-5,0,1,0,1,0.000,0.000
9,0.970,Pennington Creek Water,16-23,0,0,0,0,NaN,NaN
9,0.970,Pennington Creek Water,23-5,0,0,0,0,NaN,NaN
9,0.970,Guinni,16-23,0,0,0,0,NaN,NaN
9,0.970,Guinni,23-5,0,0,0,0,NaN,NaN
9,0.970,Racoon,16-23,0,0,0,0,NaN,NaN
9,0.970,Racoon,23-5,0,0,0,0,NaN,NaN
9,0.970,Hu,16-23,16,15,0,31,51.613,51.613
9,0.970,Hu,23-5,21,13,0,34,61.765,61.765
9,0.970,Cw and Dg,16-23,5,15,0,20,25.000,25.000
9,0.970,Cw and Dg,23-5,16,17,0,33,48.485,48.485
9,0.970,Red Wind Blackbird,16-23,0,0,0,0,NaN,NaN
9,0.970,Red Wind Blackbird,23-5,0,0,0,0,NaN,NaN
9,0.970,Tree Swallow,16-23,0,0,0,0,NaN,NaN
9,0.970,Tree Swallow,23-5,0,0,0,0,NaN,NaN
9,0.970,Turkey Vulture,16-23,0,0,0,0,NaN,NaN
9,0.970,Turkey Vulture,23-5,0,0,0,0,NaN,NaN
9,0.970,Dg,16-23,6,10,0,16,37.500,37.500
9,0.970,Dg,23-5,31,29,0,60,51.667,51.667
9,0.970,Western Kingbird,16-23,0,0,0,0,NaN,NaN
9,0.970,Western Kingbird,23-5,0,0,0,0,NaN,NaN
9,0.970,White Crowned Sparrow,16-23,0,0,0,0,NaN,NaN
9,0.970,White Crowned Sparrow,23-5,1,6,0,7,14.286,14.286
9,0.970,Eared Grebe,16-23,0,0,0,0,NaN,NaN
9,0.970,Eared Grebe,23-5,0,15,0,15,0.000,0.000
9,0.970,cougar,16-23,0,0,0,0,NaN,NaN
9,0.970,cougar,23-5,0,0,0,0,NaN,NaN
9,0.970,Ocean Water,16-23,0,0,0,0,NaN,NaN
9,0.970,Ocean Water,23-5,0,0,0,0,NaN,NaN
9,0.970,Red Tailed Hawk,16-23,0,0,0,0,NaN,NaN
9,0.970,Red Tailed Hawk,23-5,0,5,0,5,0.000,0.000
9,0.970,Dog,16-23,56,67,0,123,45.528,45.528
9,0.970,Dog,23-5,104,118,0,222,46.847,46.847
9,0.970,Human,16-23,1753,730,0,2483,70.600,70.600
9,0.970,Human,23-5,2201,565,0,2766,79.573,79.573
9,0.970,Wild Turkey,16-23,2,12,0,14,14.286,14.286
9,0.970,Wild Turkey,23-5,2,27,0,29,6.897,6.897
9,0.970,Clark Grebe,16-23,0,0,0,0,NaN,NaN
9,0.970,Clark Grebe,23-5,0,0,0,0,NaN,NaN
9,0.970,Seagull,16-23,0,0,0,0,NaN,NaN
9,0.970,Seagull,23-5,44,10,0,54,81.481,81.481
9,0.970,Surf Scoter,16-23,0,0,0,0,NaN,NaN
9,0.970,Surf Scoter,23-5,0,2,0,2,0.000,0.000
9,0.970,Pigeon,16-23,88,146,0,234,37.607,37.607
9,0.970,Pigeon,23-5,138,215,0,353,39.093,39.093
9,0.970,Pacific Ocean Water,16-23,0,0,0,0,NaN,NaN
9,0.970,Pacific Ocean Water,23-5,0,0,0,0,NaN,NaN
9,0.970,Cat,16-23,19,29,0,48,39.583,39.583
9,0.970,Cat,23-5,27,26,0,53,50.943,50.943
9,0.970,Horse,16-23,7,21,0,28,25.000,25.000
9,0.970,Horse,23-5,31,156,0,187,16.578,16.578
9,0.970,orangutan,16-23,0,0,0,0,NaN,NaN
9,0.970,orangutan,23-5,0,0,0,0,NaN,NaN
9,0.970,Bat,16-23,36,25,0,61,59.016,59.016
9,0.970,Bat,23-5,37,28,0,65,56.923,56.923
9,0.970,Deer,16-23,15,25,0,40,37.500,37.500
9,0.970,Deer,23-5,18,109,0,127,14.173,14.173
9,0.970,Great Horned Owl,16-23,0,0,0,0,NaN,NaN
9,0.970,Great Horned Owl,23-5,0,1,0,1,0.000,0.000
9,0.970,Freshwater Lagoon,16-23,0,0,0,0,NaN,NaN
9,0.970,Freshwater Lagoon,23-5,0,0,0,0,NaN,NaN
9,0.970,Unknown Avian,16-23,0,0,0,0,NaN,NaN
9,0.970,Unknown Avian,23-5,0,0,0,0,NaN,NaN
9,0.970,Human UTI,16-23,80,74,0,154,51.948,51.948
9,0.970,Human UTI,23-5,103,95,0,198,52.020,52.020
9,0.970,unknown,16-23,0,0,0,0,NaN,NaN
9,0.970,unknown,23-5,2,3,0,5,40.000,40.000
9,0.970,SLO Creek Water,16-23,0,0,0,0,NaN,NaN
9,0.970,SLO Creek Water,23-5,0,0,0,0,NaN,NaN
9,0.970,Pig/Swine,16-23,9,9,0,18,50.000,50.000
9,0.970,Pig/Swine,23-5,11,9,0,20,55.000,55.000
9,0.970,Klebsiella,16-23,0,0,0,0,NaN,NaN
9,0.970,Klebsiella,23-5,0,0,0,0,NaN,NaN
9,0.970,Hu Cw and Dg,16-23,12,23,0,35,34.286,34.286
9,0.970,Hu Cw and Dg,23-5,12,22,0,34,35.294,35.294
9,0.970,Ground Squirrel,16-23,90,56,0,146,61.644,61.644
9,0.970,Ground Squirrel,23-5,86,78,0,164,52.439,52.439
9,0.970,Opossum,16-23,0,0,0,0,NaN,NaN
9,0.970,Opossum,23-5,0,0,0,0,NaN,NaN
9,0.970,Cow,16-23,1564,1077,0,2641,59.220,59.220
9,0.970,Cow,23-5,1520,1365,0,2885,52.686,52.686
9,0.970,Deer Mouse,16-23,0,0,0,0,NaN,NaN
9,0.970,Deer Mouse,23-5,0,0,0,0,NaN,NaN
9,0.970,OVERALL,16-23,3847,2459,0,6306,61.005,61.005
9,0.970,OVERALL,23-5,4515,3046,0,7561,59.714,59.714
9,0.980,Chicken,16-23,0,4,0,4,0.000,0.000
9,0.980,Chicken,23-5,9,7,0,16,56.250,56.250
9,0.980,Sea Lion,16-23,0,1,0,1,0.000,0.000
9,0.980,Sea Lion,23-5,3,9,0,12,25.000,25.000
9,0.980,Hu and Cw,16-23,5,7,0,12,41.667,41.667
9,0.980,Hu and Cw,23-5,4,19,0,23,17.391,17.391
9,0.980,Sheep,16-23,54,54,0,108,50.000,50.000
9,0.980,Sheep,23-5,57,38,0,95,60.000,60.000
9,0.980,Hu and Dg,16-23,9,15,0,24,37.500,37.500
9,0.980,Hu and Dg,23-5,20,17,0,37,54.054,54.054
9,0.980,Common Loon,16-23,0,0,0,0,NaN,NaN
9,0.980,Common Loon,23-5,0,3,0,3,0.000,0.000
9,0.980,Red-Winged Blackbird,16-23,0,3,0,3,0.000,0.000
9,0.980,Red-Winged Blackbird,23-5,0,0,0,0,NaN,NaN
9,0.980,Cw,16-23,8,14,0,22,36.364,36.364
9,0.980,Cw,23-5,13,32,0,45,28.889,28.889
9,0.980,Cliff Sparrow,16-23,1,13,0,14,7.143,7.143
9,0.980,Cliff Sparrow,23-5,0,7,0,7,0.000,0.000
9,0.980,Pig,16-23,10,9,0,19,52.632,52.632
9,0.980,Pig,23-5,4,5,0,9,44.444,44.444
9,0.980,Barn Owl,16-23,0,0,0,0,NaN,NaN
9,0.980,Barn Owl,23-5,0,0,0,0,NaN,NaN
9,0.980,Wild Pig,16-23,2,0,0,2,100.000,100.000
9,0.980,Wild Pig,23-5,0,1,0,1,0.000,0.000
9,0.980,Pennington Creek Water,16-23,0,0,0,0,NaN,NaN
9,0.980,Pennington Creek Water,23-5,0,0,0,0,NaN,NaN
9,0.980,Guinni,16-23,0,0,0,0,NaN,NaN
9,0.980,Guinni,23-5,0,0,0,0,NaN,NaN
9,0.980,Racoon,16-23,0,0,0,0,NaN,NaN
9,0.980,Racoon,23-5,0,0,0,0,NaN,NaN
9,0.980,Hu,16-23,16,15,0,31,51.613,51.613
9,0.980,Hu,23-5,21,14,0,35,60.000,60.000
9,0.980,Cw and Dg,16-23,5,15,0,20,25.000,25.000
9,0.980,Cw and Dg,23-5,16,18,0,34,47.059,47.059
9,0.980,Red Wind Blackbird,16-23,0,0,0,0,NaN,NaN
9,0.980,Red Wind Blackbird,23-5,0,0,0,0,NaN,NaN
9,0.980,Tree Swallow,16-23,0,0,0,0,NaN,NaN
9,0.980,Tree Swallow,23-5,0,0,0,0,NaN,NaN
9,0.980,Turkey Vulture,16-23,0,0,0,0,NaN,NaN
9,0.980,Turkey Vulture,23-5,0,0,0,0,NaN,NaN
9,0.980,Dg,16-23,6,10,0,16,37.500,37.500
9,0.980,Dg,23-5,31,22,0,53,58.491,58.491
9,0.980,Western Kingbird,16-23,0,0,0,0,NaN,NaN
9,0.980,Western Kingbird,23-5,0,0,0,0,NaN,NaN
9,0.980,White Crowned Sparrow,16-23,0,0,0,0,NaN,NaN
9,0.980,White Crowned Sparrow,23-5,1,7,0,8,12.500,12.500
9,0.980,Eared Grebe,16-23,0,0,0,0,NaN,NaN
9,0.980,Eared Grebe,23-5,0,15,0,15,0.000,0.000
9,0.980,cougar,16-23,0,0,0,0,NaN,NaN
9,0.980,cougar,23-5,0,0,0,0,NaN,NaN
9,0.980,Ocean Water,16-23,0,0,0,0,NaN,NaN
9,0.980,Ocean Water,23-5,0,0,0,0,NaN,NaN
9,0.980,Red Tailed Hawk,16-23,0,0,0,0,NaN,NaN
9,0.980,Red Tailed Hawk,23-5,0,4,0,4,0.000,0.000
9,0.980,Dog,16-23,55,72,0,127,43.307,43.307
9,0.980,Dog,23-5,104,116,0,220,47.273,47.273
9,0.980,Human,16-23,1756,722,0,2478,70.864,70.864
9,0.980,Human,23-5,2203,553,0,2756,79.935,79.935
9,0.980,Wild Turkey,16-23,2,12,0,14,14.286,14.286
9,0.980,Wild Turkey,23-5,4,34,0,38,10.526,10.526
9,0.980,Clark Grebe,16-23,0,0,0,0,NaN,NaN
9,0.980,Clark Grebe,23-5,0,0,0,0,NaN,NaN
9,0.980,Seagull,16-23,0,0,0,0,NaN,NaN
9,0.980,Seagull,23-5,46,8,0,54,85.185,85.185
9,0.980,Surf Scoter,16-23,0,0,0,0,NaN,NaN
9,0.980,Surf Scoter,23-5,2,0,0,2,100.000,100.000
9,0.980,Pigeon,16-23,88,144,0,232,37.931,37.931
9,0.980,Pigeon,23-5,137,224,0,361,37.950,37.950
9,0.980,Pacific Ocean Water,16-23,0,0,0,0,NaN,NaN
9,0.980,Pacific Ocean Water,23-5,0,0,0,0,NaN,NaN
9,0.980,Cat,16-23,19,28,0,47,40.426,40.426
9,0.980,Cat,23-5,29,24,0,53,54.717,54.717
9,0.980,Horse,16-23,7,20,0,27,25.926,25.926
9,0.980,Horse,23-5,31,153,0,184,16.848,16.848
9,0.980,orangutan,16-23,0,0,0,0,NaN,NaN
9,0.980,orangutan,23-5,0,0,0,0,NaN,NaN
9,0.980,Bat,16-23,36,25,0,61,59.016,59.016
9,0.980,Bat,23-5,37,27,0,64,57.813,57.813
9,0.980,Deer,16-23,15,25,0,40,37.500,37.500
9,0.980,Deer,23-5,18,109,0,127,14.173,14.173
9,0.980,Great Horned Owl,16-23,0,0,0,0,NaN,NaN
9,0.980,Great Horned Owl,23-5,0,1,0,1,0.000,0.000
9,0.980,Freshwater Lagoon,16-23,0,0,0,0,NaN,NaN
9,0.980,Freshwater Lagoon,23-5,0,0,0,0,NaN,NaN
9,0.980,Unknown Avian,16-23,0,0,0,0,NaN,NaN
9,0.980,Unknown Avian,23-5,0,0,0,0,NaN,NaN
9,0.980,Human UTI,16-23,80,76,0,156,51.282,51.282
9,0.980,Human UTI,23-5,103,91,0,194,53.093,53.093
9,0.980,unknown,16-23,0,0,0,0,NaN,NaN
9,0.980,unknown,23-5,2,4,0,6,33.333,33.333
9,0.980,SLO Creek Water,16-23,0,0,0,0,NaN,NaN
9,0.980,SLO Creek Water,23-5,0,0,0,0,NaN,NaN
9,0.980,Pig/Swine,16-23,9,9,0,18,50.000,50.000
9,0.980,Pig/Swine,23-5,11,9,0,20,55.000,55.000
9,0.980,Klebsiella,16-23,0,0,0,0,NaN,NaN
9,0.980,Klebsiella,23-5,0,0,0,0,NaN,NaN
9,0.980,Hu Cw and Dg,16-23,12,23,0,35,34.286,34.286
9,0.980,Hu Cw and Dg,23-5,12,20,0,32,37.500,37.500
9,0.980,Ground Squirrel,16-23,92,57,0,149,61.745,61.745
9,0.980,Ground Squirrel,23-5,86,75,0,161,53.416,53.416
9,0.980,Opossum,16-23,0,0,0,0,NaN,NaN
9,0.980,Opossum,23-5,0,0,0,0,NaN,NaN
9,0.980,Cow,16-23,1556,1062,0,2618,59.435,59.435
9,0.980,Cow,23-5,1515,1337,0,2852,53.121,53.121
9,0.980,Deer Mouse,16-23,0,0,0,0,NaN,NaN
9,0.980,Deer Mouse,23-5,0,0,0,0,NaN,NaN
9,0.980,OVERALL,16-23,3843,2435,0,6278,61.214,61.214
9,0.980,OVERALL,23-5,4519,3003,0,7522,60.077,60.077
9,0.990,Chicken,16-23,2,9,0,11,18.182,18.182
9,0.990,Chicken,23-5,10,7,0,17,58.824,58.824
9,0.990,Sea Lion,16-23,0,1,0,1,0.000,0.000
9,0.990,Sea Lion,23-5,4,6,0,10,40.000,40.000
9,0.990,Hu and Cw,16-23,6,7,0,13,46.154,46.154
9,0.990,Hu and Cw,23-5,6,24,0,30,20.000,20.000
9,0.990,Sheep,16-23,53,54,0,107,49.533,49.533
9,0.990,Sheep,23-5,59,37,0,96,61.458,61.458
9,0.990,Hu and Dg,16-23,9,16,0,25,36.000,36.000
9,0.990,Hu and Dg,23-5,20,14,0,34,58.824,58.824
9,0.990,Common Loon,16-23,0,0,0,0,NaN,NaN
9,0.990,Common Loon,23-5,0,3,0,3,0.000,0.000
9,0.990,Red-Winged Blackbird,16-23,0,4,0,4,0.000,0.000
9,0.990,Red-Winged Blackbird,23-5,0,0,0,0,NaN,NaN
9,0.990,Cw,16-23,8,14,0,22,36.364,36.364
9,0.990,Cw,23-5,17,34,0,51,33.333,33.333
9,0.990,Cliff Sparrow,16-23,1,13,0,14,7.143,7.143
9,0.990,Cliff Sparrow,23-5,0,11,0,11,0.000,0.000
9,0.990,Pig,16-23,10,10,0,20,50.000,50.000
9,0.990,Pig,23-5,8,7,0,15,53.333,53.333
9,0.990,Barn Owl,16-23,0,0,0,0,NaN,NaN
9,0.990,Barn Owl,23-5,0,0,0,0,NaN,NaN
9,0.990,Wild Pig,16-23,2,1,0,3,66.667,66.667
9,0.990,Wild Pig,23-5,0,2,0,2,0.000,0.000
9,0.990,Pennington Creek Water,16-23,0,0,0,0,NaN,NaN
9,0.990,Pennington Creek Water,23-5,0,0,0,0,NaN,NaN
9,0.990,Guinni,16-23,0,0,0,0,NaN,NaN
9,0.990,Guinni,23-5,0,0,0,0,NaN,NaN
9,0.990,Racoon,16-23,0,0,0,0,NaN,NaN
9,0.990,Racoon,23-5,0,1,0,1,0.000,0.000
9,0.990,Hu,16-23,16,13,0,29,55.172,55.172
9,0.990,Hu,23-5,21,11,0,32,65.625,65.625
9,0.990,Cw and Dg,16-23,5,15,0,20,25.000,25.000
9,0.990,Cw and Dg,23-5,16,12,0,28,57.143,57.143
9,0.990,Red Wind Blackbird,16-23,0,0,0,0,NaN,NaN
9,0.990,Red Wind Blackbird,23-5,0,0,0,0,NaN,NaN
9,0.990,Tree Swallow,16-23,0,0,0,0,NaN,NaN
9,0.990,Tree Swallow,23-5,0,0,0,0,NaN,NaN
9,0.990,Turkey Vulture,16-23,0,0,0,0,NaN,NaN
9,0.990,Turkey Vulture,23-5,0,0,0,0,NaN,NaN
9,0.990,Dg,16-23,6,10,0,16,37.500,37.500
9,0.990,Dg,23-5,31,17,0,48,64.583,64.583
9,0.990,Western Kingbird,16-23,0,0,0,0,NaN,NaN
9,0.990,Western Kingbird,23-5,0,0,0,0,NaN,NaN
9,0.990,White Crowned Sparrow,16-23,0,0,0,0,NaN,NaN
9,0.990,White Crowned Sparrow,23-5,1,7,0,8,12.500,12.500
9,0.990,Eared Grebe,16-23,0,0,0,0,NaN,NaN
9,0.990,Eared Grebe,23-5,0,14,0,14,0.000,0.000
9,0.990,cougar,16-23,0,1,0,1,0.000,0.000
9,0.990,cougar,23-5,0,0,0,0,NaN,NaN
9,0.990,Ocean Water,16-23,0,0,0,0,NaN,NaN
9,0.990,Ocean Water,23-5,0,0,0,0,NaN,NaN
9,0.990,Red Tailed Hawk,16-23,0,0,0,0,NaN,NaN
9,0.990,Red Tailed Hawk,23-5,0,5,0,5,0.000,0.000
9,0.990,Dog,16-23,58,74,0,132,43.939,43.939
9,0.990,Dog,23-5,107,109,0,216,49.537,49.537
9,0.990,Human,16-23,1746,687,0,2433,71.763,71.763
9,0.990,Human,23-5,2191,511,0,2702,81.088,81.088
9,0.990,Wild Turkey,16-23,4,17,0,21,19.048,19.048
9,0.990,Wild Turkey,23-5,4,33,0,37,10.811,10.811
9,0.990,Clark Grebe,16-23,0,0,0,0,NaN,NaN
9,0.990,Clark Grebe,23-5,2,3,0,5,40.000,40.000
9,0.990,Seagull,16-23,0,0,0,0,NaN,NaN
9,0.990,Seagull,23-5,48,7,0,55,87.273,87.273
9,0.990,Surf Scoter,16-23,0,0,0,0,NaN,NaN
9,0.990,Surf Scoter,23-5,2,0,0,2,100.000,100.000
9,0.990,Pigeon,16-23,93,136,0,229,40.611,40.611
9,0.990,Pigeon,23-5,142,230,0,372,38.172,38.172
9,0.990,Pacific Ocean Water,16-23,0,0,0,0,NaN,NaN
9,0.990,Pacific Ocean Water,23-5,0,0,0,0,NaN,NaN
9,0.990,Cat,16-23,21,27,0,48,43.750,43.750
9,0.990,Cat,23-5,30,27,0,57,52.632,52.632
9,0.990,Horse,16-23,10,21,0,31,32.258,32.258
9,0.990,Horse,23-5,31,156,0,187,16.578,16.578
9,0.990,orangutan,16-23,0,0,0,0,NaN,NaN
9,0.990,orangutan,23-5,0,0,0,0,NaN,NaN
9,0.990,Bat,16-23,36,23,0,59,61.017,61.017
9,0.990,Bat,23-5,37,26,0,63,58.730,58.730
9,0.990,Deer,16-23,15,26,0,41,36.585,36.585
9,0.990,Deer,23-5,18,103,0,121,14.876,14.876
9,0.990,Great Horned Owl,16-23,0,0,0,0,NaN,NaN
9,0.990,Great Horned Owl,23-5,0,1,0,1,0.000,0.000
9,0.990,Freshwater Lagoon,16-23,0,0,0,0,NaN,NaN
9,0.990,Freshwater Lagoon,23-5,0,0,0,0,NaN,NaN
9,0.990,Unknown Avian,16-23,0,0,0,0,NaN,NaN
9,0.990,Unknown Avian,23-5,0,0,0,0,NaN,NaN
9,0.990,Human UTI,16-23,84,68,0,152,55.263,55.263
9,0.990,Human UTI,23-5,104,76,0,180,57.778,57.778
9,0.990,unknown,16-23,0,0,0,0,NaN,NaN
9,0.990,unknown,23-5,2,6,0,8,25.000,25.000
9,0.990,SLO Creek Water,16-23,0,0,0,0,NaN,NaN
9,0.990,SLO Creek Water,23-5,0,0,0,0,NaN,NaN
9,0.990,Pig/Swine,16-23,9,10,0,19,47.368,47.368
9,0.990,Pig/Swine,23-5,11,9,0,20,55.000,55.000
9,0.990,Klebsiella,16-23,0,0,0,0,NaN,NaN
9,0.990,Klebsiella,23-5,0,0,0,0,NaN,NaN
9,0.990,Hu Cw and Dg,16-23,12,23,0,35,34.286,34.286
9,0.990,Hu Cw and Dg,23-5,12,19,0,31,38.710,38.710
9,0.990,Ground Squirrel,16-23,94,56,0,150,62.667,62.667
9,0.990,Ground Squirrel,23-5,88,78,0,166,53.012,53.012
9,0.990,Opossum,16-23,1,0,0,1,100.000,100.000
9,0.990,Opossum,23-5,2,0,0,2,100.000,100.000
9,0.990,Cow,16-23,1521,967,0,2488,61.133,61.133
9,0.990,Cow,23-5,1480,1216,0,2696,54.896,54.896
9,0.990,Deer Mouse,16-23,0,0,0,0,NaN,NaN
9,0.990,Deer Mouse,23-5,0,0,0,0,NaN,NaN
9,0.990,OVERALL,16-23,3822,2303,0,6125,62.400,62.400
9,0.990,OVERALL,23-5,4504,2822,0,7326,61.480,61.480
9,1.000,Chicken,16-23,0,0,0,0,NaN,NaN
9,1.000,Chicken,23-5,0,0,0,0,NaN,NaN
9,1.000,Sea Lion,16-23,0,0,0,0,NaN,NaN
9,1.000,Sea Lion,23-5,0,0,0,0,NaN,NaN
9,1.000,Hu and Cw,16-23,0,0,0,0,NaN,NaN
9,1.000,Hu and Cw,23-5,0,0,0,0,NaN,NaN
9,1.000,Sheep,16-23,0,0,0,0,NaN,NaN
9,1.000,Sheep,23-5,0,0,0,0,NaN,NaN
9,1.000,Hu and Dg,16-23,0,0,0,0,NaN,NaN
9,1.000,Hu and Dg,23-5,0,0,0,0,NaN,NaN
9,1.000,Common Loon,16-23,0,0,0,0,NaN,NaN
9,1.000,Common Loon,23-5,0,0,0,0,NaN,NaN
9,1.000,Red-Winged Blackbird,16-23,0,0,0,0,NaN,NaN
9,1.000,Red-Winged Blackbird,23-5,0,0,0,0,NaN,NaN
9,1.000,Cw,16-23,0,0,0,0,NaN,NaN
9,1.000,Cw,23-5,0,0,0,0,NaN,NaN
9,1.000,Cliff Sparrow,16-23,0,0,0,0,NaN,NaN
9,1.000,Cliff Sparrow,23-5,0,0,0,0,NaN,NaN
9,1.000,Pig,16-23,0,0,0,0,NaN,NaN
9,1.000,Pig,23-5,0,0,0,0,NaN,NaN
9,1.000,Barn Owl,16-23,0,0,0,0,NaN,NaN
9,1.000,Barn Owl,23-5,0,0,0,0,NaN,NaN
9,1.000,Wild Pig,16-23,0,0,0,0,NaN,NaN
9,1.000,Wild Pig,23-5,0,0,0,0,NaN,NaN
9,1.000,Pennington Creek Water,16-23,0,0,0,0,NaN,NaN
9,1.000,Pennington Creek Water,23-5,0,0,0,0,NaN,NaN
9,1.000,Guinni,16-23,0,0,0,0,NaN,NaN
9,1.000,Guinni,23-5,0,0,0,0,NaN,NaN
9,1.000,Racoon,16-23,0,0,0,0,NaN,NaN
9,1.000,Racoon,23-5,0,0,0,0,NaN,NaN
9,1.000,Hu,16-23,0,0,0,0,NaN,NaN
9,1.000,Hu,23-5,0,0,0,0,NaN,NaN
9,1.000,Cw and Dg,16-23,0,0,0,0,NaN,NaN
9,1.000,Cw and Dg,23-5,0,0,0,0,NaN,NaN
9,1.000,Red Wind Blackbird,16-23,0,0,0,0,NaN,NaN
9,1.000,Red Wind Blackbird,23-5,0,0,0,0,NaN,NaN
9,1.000,Tree Swallow,16-23,0,0,0,0,NaN,NaN
9,1.000,Tree Swallow,23-5,0,0,0,0,NaN,NaN
9,1.000,Turkey Vulture,16-23,0,0,0,0,NaN,NaN
9,1.000,Turkey Vulture,23-5,0,0,0,0,NaN,NaN
9,1.000,Dg,16-23,0,0,0,0,NaN,NaN
9,1.000,Dg,23-5,0,0,0,0,NaN,NaN
9,1.000,Western Kingbird,16-23,0,0,0,0,NaN,NaN
9,1.000,Western Kingbird,23-5,0,0,0,0,NaN,NaN
9,1.000,White Crowned Sparrow,16-23,0,0,0,0,NaN,NaN
9,1.000,White Crowned Sparrow,23-5,0,0,0,0,NaN,NaN
9,1.000,Eared Grebe,16-23,0,0,0,0,NaN,NaN
9,1.000,Eared Grebe,23-5,0,0,0,0,NaN,NaN
9,1.000,cougar,16-23,0,0,0,0,NaN,NaN
9,1.000,cougar,23-5,0,0,0,0,NaN,NaN
9,1.000,Ocean Water,16-23,0,0,0,0,NaN,NaN
9,1.000,Ocean Water,23-5,0,0,0,0,NaN,NaN
9,1.000,Red Tailed Hawk,16-23,0,0,0,0,NaN,NaN
9,1.000,Red Tailed Hawk,23-5,0,0,0,0,NaN,NaN
9,1.000,Dog,16-23,0,0,0,0,NaN,NaN
9,1.000,Dog,23-5,0,0,0,0,NaN,NaN
9,1.000,Human,16-23,68,0,0,68,100.000,100.000
9,1.000,Human,23-5,90,0,0,90,100.000,100.000
9,1.000,Wild Turkey,16-23,0,0,0,0,NaN,NaN
9,1.000,Wild Turkey,23-5,0,0,0,0,NaN,NaN
9,1.000,Clark Grebe,16-23,0,0,0,0,NaN,NaN
9,1.000,Clark Grebe,23-5,0,0,0,0,NaN,NaN
9,1.000,Seagull,16-23,0,0,0,0,NaN,NaN
9,1.000,Seagull,23-5,0,0,0,0,NaN,NaN
9,1.000,Surf Scoter,16-23,0,0,0,0,NaN,NaN
9,1.000,Surf Scoter,23-5,0,0,0,0,NaN,NaN
9,1.000,Pigeon,16-23,0,0,0,0,NaN,NaN
9,1.000,Pigeon,23-5,0,0,0,0,NaN,NaN
9,1.000,Pacific Ocean Water,16-23,0,0,0,0,NaN,NaN
9,1.000,Pacific Ocean Water,23-5,0,0,0,0,NaN,NaN
9,1.000,Cat,16-23,0,0,0,0,NaN,NaN
9,1.000,Cat,23-5,0,0,0,0,NaN,NaN
9,1.000,Horse,16-23,0,0,0,0,NaN,NaN
9,1.000,Horse,23-5,0,0,0,0,NaN,NaN
9,1.000,orangutan,16-23,0,0,0,0,NaN,NaN
9,1.000,orangutan,23-5,0,0,0,0,NaN,NaN
9,1.000,Bat,16-23,0,0,0,0,NaN,NaN
9,1.000,Bat,23-5,0,0,0,0,NaN,NaN
9,1.000,Deer,16-23,0,0,0,0,NaN,NaN
9,1.000,Deer,23-5,0,0,0,0,NaN,NaN
9,1.000,Great Horned Owl,16-23,0,0,0,0,NaN,NaN
9,1.000,Great Horned Owl,23-5,0,0,0,0,NaN,NaN
9,1.000,Freshwater Lagoon,16-23,0,0,0,0,NaN,NaN
9,1.000,Freshwater Lagoon,23-5,0,0,0,0,NaN,NaN
9,1.000,Unknown Avian,16-23,0,0,0,0,NaN,NaN
9,1.000,Unknown Avian,23-5,0,0,0,0,NaN,NaN
9,1.000,Human UTI,16-23,0,0,0,0,NaN,NaN
9,1.000,Human UTI,23-5,0,0,0,0,NaN,NaN
9,1.000,unknown,16-23,0,0,0,0,NaN,NaN
9,1.000,unknown,23-5,0,0,0,0,NaN,NaN
9,1.000,SLO Creek Water,16-23,0,0,0,0,NaN,NaN
9,1.000,SLO Creek Water,23-5,0,0,0,0,NaN,NaN
9,1.000,Pig/Swine,16-23,0,0,0,0,NaN,NaN
9,1.000,Pig/Swine,23-5,0,0,0,0,NaN,NaN
9,1.000,Klebsiella,16-23,0,0,0,0,NaN,NaN
9,1.000,Klebsiella,23-5,0,0,0,0,NaN,NaN
9,1.000,Hu Cw and Dg,16-23,0,0,0,0,NaN,NaN
9,1.000,Hu Cw and Dg,23-5,0,0,0,0,NaN,NaN
9,1.000,Ground Squirrel,16-23,0,0,0,0,NaN,NaN
9,1.000,Ground Squirrel,23-5,0,0,0,0,NaN,NaN
9,1.000,Opossum,16-23,0,0,0,0,NaN,NaN
9,1.000,Opossum,23-5,0,0,0,0,NaN,NaN
9,1.000,Cow,16-23,0,0,0,0,NaN,NaN
9,1.000,Cow,23-5,0,0,0,0,NaN,NaN
9,1.000,Deer Mouse,16-23,0,0,0,0,NaN,NaN
9,1.000,Deer Mouse,23-5,0,0,0,0,NaN,NaN
9,1.000,OVERALL,16-23,68,0,0,68,100.000,100.000
9,1.000,OVERALL,23-5,90,0,0,90,100.000,100.000
10,0.000,Chicken,16-23,0,1,0,1,0.000,0.000
10,0.000,Chicken,23-5,7,9,0,16,43.750,43.750
10,0.000,Sea Lion,16-23,0,1,0,1,0.000,0.000
10,0.000,Sea Lion,23-5,1,10,0,11,9.091,9.091
10,0.000,Hu and Cw,16-23,2,7,0,9,22.222,22.222
10,0.000,Hu and Cw,23-5,2,10,0,12,16.667,16.667
10,0.000,Sheep,16-23,50,50,0,100,50.000,50.000
10,0.000,Sheep,23-5,58,41,0,99,58.586,58.586
10,0.000,Hu and Dg,16-23,7,10,0,17,41.176,41.176
10,0.000,Hu and Dg,23-5,19,21,0,40,47.500,47.500
10,0.000,Common Loon,16-23,0,0,0,0,NaN,NaN
10,0.000,Common Loon,23-5,0,1,0,1,0.000,0.000
10,0.000,Red-Winged Blackbird,16-23,0,1,0,1,0.000,0.000
10,0.000,Red-Winged Blackbird,23-5,0,0,0,0,NaN,NaN
10,0.000,Cw,16-23,7,13,0,20,35.000,35.000
10,0.000,Cw,23-5,11,26,0,37,29.730,29.730
10,0.000,Cliff Sparrow,16-23,1,12,0,13,7.692,7.692
10,0.000,Cliff Sparrow,23-5,0,5,0,5,0.000,0.000
10,0.000,Pig,16-23,10,8,0,18,55.556,55.556
10,0.000,Pig,23-5,4,6,0,10,40.000,40.000
10,0.000,Barn Owl,16-23,0,0,0,0,NaN,NaN
10,0.000,Barn Owl,23-5,0,0,0,0,NaN,NaN
10,0.000,Wild Pig,16-23,1,0,0,1,100.000,100.000
10,0.000,Wild Pig,23-5,1,2,0,3,33.333,33.333
10,0.000,Pennington Creek Water,16-23,0,0,0,0,NaN,NaN
10,0.000,Pennington Creek Water,23-5,0,0,0,0,NaN,NaN
10,0.000,Guinni,16-23,0,0,0,0,NaN,NaN
10,0.000,Guinni,23-5,0,0,0,0,NaN,NaN
10,0.000,Racoon,16-23,0,0,0,0,NaN,NaN
10,0.000,Racoon,23-5,0,0,0,0,NaN,NaN
10,0.000,Hu,16-23,15,14,0,29,51.724,51.724
10,0.000,Hu,23-5,23,14,0,37,62.162,62.162
10,0.000,Cw and Dg,16-23,5,15,0,20,25.000,25.000
10,0.000,Cw and Dg,23-5,15,16,0,31,48.387,48.387
10,0.000,Red Wind Blackbird,16-23,0,0,0,0,NaN,NaN
10,0.000,Red Wind Blackbird,23-5,0,0,0,0,NaN,NaN
10,0.000,Tree Swallow,16-23,0,0,0,0,NaN,NaN
10,0.000,Tree Swallow,23-5,0,0,0,0,NaN,NaN
10,0.000,Turkey Vulture,16-23,0,0,0,0,NaN,NaN
10,0.000,Turkey Vulture,23-5,0,0,0,0,NaN,NaN
10,0.000,Dg,16-23,5,9,0,14,35.714,35.714
10,0.000,Dg,23-5,31,31,0,62,50.000,50.000
10,0.000,Western Kingbird,16-23,0,0,0,0,NaN,NaN
10,0.000,Western Kingbird,23-5,0,0,0,0,NaN,NaN
10,0.000,White Crowned Sparrow,16-23,0,0,0,0,NaN,NaN
10,0.000,White Crowned Sparrow,23-5,0,5,0,5,0.000,0.000
10,0.000,Eared Grebe,16-23,0,0,0,0,NaN,NaN
10,0.000,Eared Grebe,23-5,0,10,0,10,0.000,0.000
10,0.000,cougar,16-23,0,0,0,0,NaN,NaN
10,0.000,cougar,23-5,0,0,0,0,NaN,NaN
10,0.000,Ocean Water,16-23,0,0,0,0,NaN,NaN
10,0.000,Ocean Water,23-5,0,0,0,0,NaN,NaN
10,0.000,Red Tailed Hawk,16-23,0,0,0,0,NaN,NaN
10,0.000,Red Tailed Hawk,23-5,0,5,0,5,0.000,0.000
10,0.000,Dog,16-23,55,67,0,122,45.082,45.082
10,0.000,Dog,23-5,101,133,0,234,43.162,43.162
10,0.000,Human,16-23,1763,771,0,2534,69.574,69.574
10,0.000,Human,23-5,2194,617,0,2811,78.051,78.051
10,0.000,Wild Turkey,16-23,1,5,0,6,16.667,16.667
10,0.000,Wild Turkey,23-5,0,15,0,15,0.000,0.000
10,0.000,Clark Grebe,16-23,0,0,0,0,NaN,NaN
10,0.000,Clark Grebe,23-5,0,0,0,0,NaN,NaN
10,0.000,Seagull,16-23,0,0,0,0,NaN,NaN
10,0.000,Seagull,23-5,44,8,0,52,84.615,84.615
10,0.000,Surf Scoter,16-23,0,0,0,0,NaN,NaN
10,0.000,Surf Scoter,23-5,0,0,0,0,NaN,NaN
10,0.000,Pigeon,16-23,88,142,0,230,38.261,38.261
10,0.000,Pigeon,23-5,131,169,0,300,43.667,43.667
10,0.000,Pacific Ocean Water,16-23,0,0,0,0,NaN,NaN
10,0.000,Pacific Ocean Water,23-5,0,0,0,0,NaN,NaN
10,0.000,Cat,16-23,19,24,0,43,44.186,44.186
10,0.000,Cat,23-5,27,23,0,50,54.000,54.000
10,0.000,Horse,16-23,6,19,0,25,24.000,24.000
10,0.000,Horse,23-5,26,140,0,166,15.663,15.663
10,0.000,orangutan,16-23,0,0,0,0,NaN,NaN
10,0.000,orangutan,23-5,0,0,0,0,NaN,NaN
10,0.000,Bat,16-23,36,29,0,65,55.385,55.385
10,0.000,Bat,23-5,37,34,0,71,52.113,52.113
10,0.000,Deer,16-23,15,27,0,42,35.714,35.714
10,0.000,Deer,23-5,18,117,0,135,13.333,13.333
10,0.000,Great Horned Owl,16-23,0,0,0,0,NaN,NaN
10,0.000,Great Horned Owl,23-5,0,1,0,1,0.000,0.000
10,0.000,Freshwater Lagoon,16-23,0,0,0,0,NaN,NaN
10,0.000,Freshwater Lagoon,23-5,0,0,0,0,NaN,NaN
10,0.000,Unknown Avian,16-23,0,0,0,0,NaN,NaN
10,0.000,Unknown Avian,23-5,0,0,0,0,NaN,NaN
10,0.000,Human UTI,16-23,75,74,0,149,50.336,50.336
10,0.000,Human UTI,23-5,100,99,0,199,50.251,50.251
10,0.000,unknown,16-23,0,0,0,0,NaN,NaN
10,0.000,unknown,23-5,0,3,0,3,0.000,0.000
10,0.000,SLO Creek Water,16-23,0,0,0,0,NaN,NaN
10,0.000,SLO Creek Water,23-5,0,0,0,0,NaN,NaN
10,0.000,Pig/Swine,16-23,7,7,0,14,50.000,50.000
10,0.000,Pig/Swine,23-5,11,11,0,22,50.000,50.000
10,0.000,Klebsiella,16-23,0,0,0,0,NaN,NaN
10,0.000,Klebsiella,23-5,0,0,0,0,NaN,NaN
10,0.000,Hu Cw and Dg,16-23,11,18,0,29,37.931,37.931
10,0.000,Hu Cw and Dg,23-5,11,23,0,34,32.353,32.353
10,0.000,Ground Squirrel,16-23,86,47,0,133,64.662,64.662
10,0.000,Ground Squirrel,23-5,84,77,0,161,52.174,52.174
10,0.000,Opossum,16-23,0,0,0,0,NaN,NaN
10,0.000,Opossum,23-5,0,0,0,0,NaN,NaN
10,0.000,Cow,16-23,1572,1140,0,2712,57.965,57.965
10,0.000,Cow,23-5,1528,1444,0,2972,51.413,51.413
10,0.000,Deer Mouse,16-23,0,0,0,0,NaN,NaN
10,0.000,Deer Mouse,23-5,0,0,0,0,NaN,NaN
10,0.000,OVERALL,16-23,3837,2511,0,6348,60.444,60.444
10,0.000,OVERALL,23-5,4484,3126,0,7610,58.922,58.922
10,0.500,Chicken,16-23,0,1,0,1,0.000,0.000
10,0.500,Chicken,23-5,7,9,0,16,43.750,43.750
10,0.500,Sea Lion,16-23,0,1,0,1,0.000,0.000
10,0.500,Sea Lion,23-5,1,10,0,11,9.091,9.091
10,0.500,Hu and Cw,16-23,2,7,0,9,22.222,22.222
10,0.500,Hu and Cw,23-5,2,10,0,12,16.667,16.667
10,0.500,Sheep,16-23,50,50,0,100,50.000,50.000
10,0.500,Sheep,23-5,58,41,0,99,58.586,58.586
10,0.500,Hu and Dg,16-23,7,10,0,17,41.176,41.176
10,0.500,Hu and Dg,23-5,19,21,0,40,47.500,47.500
10,0.500,Common Loon,16-23,0,0,0,0,NaN,NaN
10,0.500,Common Loon,23-5,0,1,0,1,0.000,0.000
10,0.500,Red-Winged Blackbird,16-23,0,1,0,1,0.000,0.000
10,0.500,Red-Winged Blackbird,23-5,0,0,0,0,NaN,NaN
10,0.500,Cw,16-23,7,13,0,20,35.000,35.000
10,0.500,Cw,23-5,11,26,0,37,29.730,29.730
10,0.500,Cliff Sparrow,16-23,1,12,0,13,7.692,7.692
10,0.500,Cliff Sparrow,23-5,0,5,0,5,0.000,0.000
10,0.500,Pig,16-23,10,8,0,18,55.556,55.556
10,0.500,Pig,23-5,4,6,0,10,40.000,40.000
10,0.500,Barn Owl,16-23,0,0,0,0,NaN,NaN
10,0.500,Barn Owl,23-5,0,0,0,0,NaN,NaN
10,0.500,Wild Pig,16-23,1,0,0,1,100.000,100.000
10,0.500,Wild Pig,23-5,1,2,0,3,33.333,33.333
10,0.500,Pennington Creek Water,16-23,0,0,0,0,NaN,NaN
10,0.500,Pennington Creek Water,23-5,0,0,0,0,NaN,NaN
10,0.500,Guinni,16-23,0,0,0,0,NaN,NaN
10,0.500,Guinni,23-5,0,0,0,0,NaN,NaN
10,0.500,Racoon,16-23,0,0,0,0,NaN,NaN
10,0.500,Racoon,23-5,0,0,0,0,NaN,NaN
10,0.500,Hu,16-23,15,14,0,29,51.724,51.724
10,0.500,Hu,23-5,23,14,0,37,62.162,62.162
10,0.500,Cw and Dg,16-23,5,15,0,20,25.000,25.000
10,0.500,Cw and Dg,23-5,15,16,0,31,48.387,48.387
10,0.500,Red Wind Blackbird,16-23,0,0,0,0,NaN,NaN
10,0.500,Red Wind Blackbird,23-5,0,0,0,0,NaN,NaN
10,0.500,Tree Swallow,16-23,0,0,0,0,NaN,NaN
10,0.500,Tree Swallow,23-5,0,0,0,0,NaN,NaN
10,0.500,Turkey Vulture,16-23,0,0,0,0,NaN,NaN
10,0.500,Turkey Vulture,23-5,0,0,0,0,NaN,NaN
10,0.500,Dg,16-23,5,9,0,14,35.714,35.714
10,0.500,Dg,23-5,31,31,0,62,50.000,50.000
10,0.500,Western Kingbird,16-23,0,0,0,0,NaN,NaN
10,0.500,Western Kingbird,23-5,0,0,0,0,NaN,NaN
10,0.500,White Crowned Sparrow,16-23,0,0,0,0,NaN,NaN
10,0.500,White Crowned Sparrow,23-5,0,5,0,5,0.000,0.000
10,0.500,Eared Grebe,16-23,0,0,0,0,NaN,NaN
10,0.500,Eared Grebe,23-5,0,10,0,10,0.000,0.000
10,0.500,cougar,16-23,0,0,0,0,NaN,NaN
10,0.500,cougar,23-5,0,0,0,0,NaN,NaN
10,0.500,Ocean Water,16-23,0,0,0,0,NaN,NaN
10,0.500,Ocean Water,23-5,0,0,0,0,NaN,NaN
10,0.500,Red Tailed Hawk,16-23,0,0,0,0,NaN,NaN
10,0.500,Red Tailed Hawk,23-5,0,5,0,5,0.000,0.000
10,0.500,Dog,16-23,55,67,0,122,45.082,45.082
10,0.500,Dog,23-5,101,133,0,234,43.162,43.162
10,0.500,Human,16-23,1763,771,0,2534,69.574,69.574
10,0.500,Human,23-5,2194,617,0,2811,78.051,78.051
10,0.500,Wild Turkey,16-23,1,5,0,6,16.667,16.667
10,0.500,Wild Turkey,23-5,0,15,0,15,0.000,0.000
10,0.500,Clark Grebe,16-23,0,0,0,0,NaN,NaN
10,0.500,Clark Grebe,23-5,0,0,0,0,NaN,NaN
10,0.500,Seagull,16-23,0,0,0,0,NaN,NaN
10,0.500,Seagull,23-5,44,8,0,52,84.615,84.615
10,0.500,Surf Scoter,16-23,0,0,0,0,NaN,NaN
10,0.500,Surf Scoter,23-5,0,0,0,0,NaN,NaN
10,0.500,Pigeon,16-23,88,142,0,230,38.261,38.261
10,0.500,Pigeon,23-5,131,169,0,300,43.667,43.667
10,0.500,Pacific Ocean Water,16-23,0,0,0,0,NaN,NaN
10,0.500,Pacific Ocean Water,23-5,0,0,0,0,NaN,NaN
10,0.500,Cat,16-23,19,24,0,43,44.186,44.186
10,0.500,Cat,23-5,27,23,0,50,54.000,54.000
10,0.500,Horse,16-23,6,19,0,25,24.000,24.000
10,0.500,Horse,23-5,26,140,0,166,15.663,15.663
10,0.500,orangutan,16-23,0,0,0,0,NaN,NaN
10,0.500,orangutan,23-5,0,0,0,0,NaN,NaN
10,0.500,Bat,16-23,36,29,0,65,55.385,55.385
10,0.500,Bat,23-5,37,34,0,71,52.113,52.113
10,0.500,Deer,16-23,15,27,0,42,35.714,35.714
10,0.500,Deer,23-5,18,117,0,135,13.333,13.333
10,0.500,Great Horned Owl,16-23,0,0,0,0,NaN,NaN
10,0.500,Great Horned Owl,23-5,0,1,0,1,0.000,0.000
10,0.500,Freshwater Lagoon,16-23,0,0,0,0,NaN,NaN
10,0.500,Freshwater Lagoon,23-5,0,0,0,0,NaN,NaN
10,0.500,Unknown Avian,16-23,0,0,0,0,NaN,NaN
10,0.500,Unknown Avian,23-5,0,0,0,0,NaN,NaN
10,0.500,Human UTI,16-23,75,74,0,149,50.336,50.336
10,0.500,Human UTI,23-5,100,99,0,199,50.251,50.251
10,0.500,unknown,16-23,0,0,0,0,NaN,NaN
10,0.500,unknown,23-5,0,3,0,3,0.000,0.000
10,0.500,SLO Creek Water,16-23,0,0,0,0,NaN,NaN
10,0.500,SLO Creek Water,23-5,0,0,0,0,NaN,NaN
10,0.500,Pig/Swine,16-23,7,7,0,14,50.000,50.000
10,0.500,Pig/Swine,23-5,11,11,0,22,50.000,50.000
10,0.500,Klebsiella,16-23,0,0,0,0,NaN,NaN
10,0.500,Klebsiella,23-5,0,0,0,0,NaN,NaN
10,0.500,Hu Cw and Dg,16-23,11,18,0,29,37.931,37.931
10,0.500,Hu Cw and Dg,23-5,11,23,0,34,32.353,32.353
10,0.500,Ground Squirrel,16-23,86,47,0,133,64.662,64.662
10,0.500,Ground Squirrel,23-5,84,77,0,161,52.174,52.174
10,0.500,Opossum,16-23,0,0,0,0,NaN,NaN
10,0.500,Opossum,23-5,0,0,0,0,NaN,NaN
10,0.500,Cow,16-23,1572,1140,0,2712,57.965,57.965
10,0.500,Cow,23-5,1528,1444,0,2972,51.413,51.413
10,0.500,Deer Mouse,16-23,0,0,0,0,NaN,NaN
10,0.500,Deer Mouse,23-5,0,0,0,0,NaN,NaN
10,0.500,OVERALL,16-23,3837,2511,0,6348,60.444,60.444
10,0.500,OVERALL,23-5,4484,3126,0,7610,58.922,58.922
10,0.900,Chicken,16-23,0,1,0,1,0.000,0.000
10,0.900,Chicken,23-5,7,9,0,16,43.750,43.750
10,0.900,Sea Lion,16-23,0,1,0,1,0.000,0.000
10,0.900,Sea Lion,23-5,1,10,0,11,9.091,9.091
10,0.900,Hu and Cw,16-23,2,7,0,9,22.222,22.222
10,0.900,Hu and Cw,23-5,2,10,0,12,16.667,16.667
10,0.900,Sheep,16-23,50,50,0,100,50.000,50.000
10,0.900,Sheep,23-5,58,41,0,99,58.586,58.586
10,0.900,Hu and Dg,16-23,7,10,0,17,41.176,41.176
10,0.900,Hu and Dg,23-5,19,21,0,40,47.500,47.500
10,0.900,Common Loon,16-23,0,0,0,0,NaN,NaN
10,0.900,Common Loon,23-5,0,1,0,1,0.000,0.000
10,0.900,Red-Winged Blackbird,16-23,0,1,0,1,0.000,0.000
10,0.900,Red-Winged Blackbird,23-5,0,0,0,0,NaN,NaN
10,0.900,Cw,16-23,7,13,0,20,35.000,35.000
10,0.900,Cw,23-5,11,26,0,37,29.730,29.730
10,0.900,Cliff Sparrow,16-23,1,12,0,13,7.692,7.692
10,0.900,Cliff Sparrow,23-5,0,5,0,5,0.000,0.000
10,0.900,Pig,16-23,10,8,0,18,55.556,55.556
10,0.900,Pig,23-5,4,6,0,10,40.000,40.000
10,0.900,Barn Owl,16-23,0,0,0,0,NaN,NaN
10,0.900,Barn Owl,23-5,0,0,0,0,NaN,NaN
10,0.900,Wild Pig,16-23,1,0,0,1,100.000,100.000
10,0.900,Wild Pig,23-5,1,2,0,3,33.333,33.333
10,0.900,Pennington Creek Water,16-23,0,0,0,0,NaN,NaN
10,0.900,Pennington Creek Water,23-5,0,0,0,0,NaN,NaN
10,0.900,Guinni,16-23,0,0,0,0,NaN,NaN
10,0.900,Guinni,23-5,0,0,0,0,NaN,NaN
10,0.900,Racoon,16-23,0,0,0,0,NaN,NaN
10,0.900,Racoon,23-5,0,0,0,0,NaN,NaN
10,0.900,Hu,16-23,15,14,0,29,51.724,51.724
10,0.900,Hu,23-5,23,14,0,37,62.162,62.162
10,0.900,Cw and Dg,16-23,5,15,0,20,25.000,25.000
10,0.900,Cw and Dg,23-5,15,16,0,31,48.387,48.387
10,0.900,Red Wind Blackbird,16-23,0,0,0,0,NaN,NaN
10,0.900,Red Wind Blackbird,23-5,0,0,0,0,NaN,NaN
10,0.900,Tree Swallow,16-23,0,0,0,0,NaN,NaN
10,0.900,Tree Swallow,23-5,0,0,0,0,NaN,NaN
10,0.900,Turkey Vulture,16-23,0,0,0,0,NaN,NaN
10,0.900,Turkey Vulture,23-5,0,0,0,0,NaN,NaN
10,0.900,Dg,16-23,5,9,0,14,35.714,35.714
10,0.900,Dg,23-5,31,31,0,62,50.000,50.000
10,0.900,Western Kingbird,16-23,0,0,0,0,NaN,NaN
10,0.900,Western Kingbird,23-5,0,0,0,0,NaN,NaN
10,0.900,White Crowned Sparrow,16-23,0,0,0,0,NaN,NaN
10,0.900,White Crowned Sparrow,23-5,0,5,0,5,0.000,0.000
10,0.900,Eared Grebe,16-23,0,0,0,0,NaN,NaN
10,0.900,Eared Grebe,23-5,0,10,0,10,0.000,0.000
10,0.900,cougar,16-23,0,0,0,0,NaN,NaN
10,0.900,cougar,23-5,0,0,0,0,NaN,NaN
10,0.900,Ocean Water,16-23,0,0,0,0,NaN,NaN
10,0.900,Ocean Water,23-5,0,0,0,0,NaN,NaN
10,0.900,Red Tailed Hawk,16-23,0,0,0,0,NaN,NaN
10,0.900,Red Tailed Hawk,23-5,0,5,0,5,0.000,0.000
10,0.900,Dog,16-23,55,67,0,122,45.082,45.082
10,0.900,Dog,23-5,101,128,0,229,44.105,44.105
10,0.900,Human,16-23,1763,770,0,2533,69.601,69.601
10,0.900,Human,23-5,2194,613,0,2807,78.162,78.162
10,0.900,Wild Turkey,16-23,1,5,0,6,16.667,16.667
10,0.900,Wild Turkey,23-5,0,15,0,15,0.000,0.000
10,0.900,Clark Grebe,16-23,0,0,0,0,NaN,NaN
10,0.900,Clark Grebe,23-5,0,0,0,0,NaN,NaN
10,0.900,Seagull,16-23,0,0,0,0,NaN,NaN
10,0.900,Seagull,23-5,44,9,0,53,83.019,83.019
10,0.900,Surf Scoter,16-23,0,0,0,0,NaN,NaN
10,0.900,Surf Scoter,23-5,0,0,0,0,NaN,NaN
10,0.900,Pigeon,16-23,88,143,0,231,38.095,38.095
10,0.900,Pigeon,23-5,131,169,0,300,43.667,43.667
10,0.900,Pacific Ocean Water,16-23,0,0,0,0,NaN,NaN
10,0.900,Pacific Ocean Water,23-5,0,0,0,0,NaN,NaN
10,0.900,Cat,16-23,19,24,0,43,44.186,44.186
10,0.900,Cat,23-5,27,23,0,50,54.000,54.000
10,0.900,Horse,16-23,6,19,0,25,24.000,24.000
10,0.900,Horse,23-5,26,140,0,166,15.663,15.663
10,0.900,orangutan,16-23,0,0,0,0,NaN,NaN
10,0.900,orangutan,23-5,0,0,0,0,NaN,NaN
10,0.900,Bat,16-23,36,29,0,65,55.385,55.385
10,0.900,Bat,23-5,37,34,0,71,52.113,52.113
10,0.900,Deer,16-23,15,27,0,42,35.714,35.714
10,0.900,Deer,23-5,18,117,0,135,13.333,13.333
10,0.900,Great Horned Owl,16-23,0,0,0,0,NaN,NaN
10,0.900,Great Horned Owl,23-5,0,1,0,1,0.000,0.000
10,0.900,Freshwater Lagoon,16-23,0,0,0,0,NaN,NaN
10,0.900,Freshwater Lagoon,23-5,0,0,0,0,NaN,NaN
10,0.900,Unknown Avian,16-23,0,0,0,0,NaN,NaN
10,0.900,Unknown Avian,23-5,0,0,0,0,NaN,NaN
10,0.900,Human UTI,16-23,75,74,0,149,50.336,50.336
10,0.900,Human UTI,23-5,103,99,0,202,50.990,50.990
10,0.900,unknown,16-23,0,0,0,0,NaN,NaN
10,0.900,unknown,23-5,0,3,0,3,0.000,0.000
10,0.900,SLO Creek Water,16-23,0,0,0,0,NaN,NaN
10,0.900,SLO Creek Water,23-5,0,0,0,0,NaN,NaN
10,0.900,Pig/Swine,16-23,7,7,0,14,50.000,50.000
10,0.900,Pig/Swine,23-5,11,11,0,22,50.000,50.000
10,0.900,Klebsiella,16-23,0,0,0,0,NaN,NaN
10,0.900,Klebsiella,23-5,0,0,0,0,NaN,NaN
10,0.900,Hu Cw and Dg,16-23,11,18,0,29,37.931,37.931
10,0.900,Hu Cw and Dg,23-5,11,23,0,34,32.353,32.353
10,0.900,Ground Squirrel,16-23,86,47,0,133,64.662,64.662
10,0.900,Ground Squirrel,23-5,84,77,0,161,52.174,52.174
10,0.900,Opossum,16-23,0,0,0,0,NaN,NaN
10,0.900,Opossum,23-5,0,0,0,0,NaN,NaN
10,0.900,Cow,16-23,1572,1136,0,2708,58.050,58.050
10,0.900,Cow,23-5,1528,1441,0,2969,51.465,51.465
10,0.900,Deer Mouse,16-23,0,0,0,0,NaN,NaN
10,0.900,Deer Mouse,23-5,0,0,0,0,NaN,NaN
10,0.900,OVERALL,16-23,3837,2507,0,6344,60.482,60.482
10,0.900,OVERALL,23-5,4487,3115,0,7602,59.024,59.024
10,0.950,Chicken,16-23,0,1,0,1,0.000,0.000
10,0.950,Chicken,23-5,7,9,0,16,43.750,43.750
10,0.950,Sea Lion,16-23,0,1,0,1,0.000,0.000
10,0.950,Sea Lion,23-5,1,10,0,11,9.091,9.091
10,0.950,Hu and Cw,16-23,2,7,0,9,22.222,22.222
10,0.950,Hu and Cw,23-5,2,10,0,12,16.667,16.667
10,0.950,Sheep,16-23,50,50,0,100,50.000,50.000
10,0.950,Sheep,23-5,58,41,0,99,58.586,58.586
10,0.950,Hu and Dg,16-23,7,10,0,17,41.176,41.176
10,0.950,Hu and Dg,23-5,19,21,0,40,47.500,47.500
10,0.950,Common Loon,16-23,0,0,0,0,NaN,NaN
10,0.950,Common Loon,23-5,0,1,0,1,0.000,0.000
10,0.950,Red-Winged Blackbird,16-23,0,1,0,1,0.000,0.000
10,0.950,Red-Winged Blackbird,23-5,0,0,0,0,NaN,NaN
10,0.950,Cw,16-23,7,13,0,20,35.000,35.000
10,0.950,Cw,23-5,11,26,0,37,29.730,29.730
10,0.950,Cliff Sparrow,16-23,1,12,0,13,7.692,7.692
10,0.950,Cliff Sparrow,23-5,0,5,0,5,0.000,0.000
10,0.950,Pig,16-23,10,8,0,18,55.556,55.556
10,0.950,Pig,23-5,4,6,0,10,40.000,40.000
10,0.950,Barn Owl,16-23,0,0,0,0,NaN,NaN
10,0.950,Barn Owl,23-5,0,0,0,0,NaN,NaN
10,0.950,Wild Pig,16-23,1,0,0,1,100.000,100.000
10,0.950,Wild Pig,23-5,1,2,0,3,33.333,33.333
10,0.950,Pennington Creek Water,16-23,0,0,0,0,NaN,NaN
10,0.950,Pennington Creek Water,23-5,0,0,0,0,NaN,NaN
10,0.950,Guinni,16-23,0,0,0,0,NaN,NaN
10,0.950,Guinni,23-5,0,0,0,0,NaN,NaN
10,0.950,Racoon,16-23,0,0,0,0,NaN,NaN
10,0.950,Racoon,23-5,0,0,0,0,NaN,NaN
10,0.950,Hu,16-23,15,14,0,29,51.724,51.724
10,0.950,Hu,23-5,23,14,0,37,62.162,62.162
10,0.950,Cw and Dg,16-23,5,15,0,20,25.000,25.000
10,0.950,Cw and Dg,23-5,15,16,0,31,48.387,48.387
10,0.950,Red Wind Blackbird,16-23,0,0,0,0,NaN,NaN
10,0.950,Red Wind Blackbird,23-5,0,0,0,0,NaN,NaN
10,0.950,Tree Swallow,16-23,0,0,0,0,NaN,NaN
10,0.950,Tree Swallow,23-5,0,0,0,0,NaN,NaN
10,0.950,Turkey Vulture,16-23,0,0,0,0,NaN,NaN
10,0.950,Turkey Vulture,23-5,0,0,0,0,NaN,NaN
10,0.950,Dg,16-23,5,9,0,14,35.714,35.714
10,0.950,Dg,23-5,31,31,0,62,50.000,50.000
10,0.950,Western Kingbird,16-23,0,0,0,0,NaN,NaN
10,0.950,Western Kingbird,23-5,0,0,0,0,NaN,NaN
10,0.950,White Crowned Sparrow,16-23,0,0,0,0,NaN,NaN
10,0.950,White Crowned Sparrow,23-5,0,5,0,5,0.000,0.000
10,0.950,Eared Grebe,16-23,0,0,0,0,NaN,NaN
10,0.950,Eared Grebe,23-5,0,10,0,10,0.000,0.000
10,0.950,cougar,16-23,0,0,0,0,NaN,NaN
10,0.950,cougar,23-5,0,0,0,0,NaN,NaN
10,0.950,Ocean Water,16-23,0,0,0,0,NaN,NaN
10,0.950,Ocean Water,23-5,0,0,0,0,NaN,NaN
10,0.950,Red Tailed Hawk,16-23,0,0,0,0,NaN,NaN
10,0.950,Red Tailed Hawk,23-5,0,5,0,5,0.000,0.000
10,0.950,Dog,16-23,55,67,0,122,45.082,45.082
10,0.950,Dog,23-5,101,126,0,227,44.493,44.493
10,0.950,Human,16-23,1763,768,0,2531,69.656,69.656
10,0.950,Human,23-5,2196,606,0,2802,78.373,78.373
10,0.950,Wild Turkey,16-23,1,5,0,6,16.667,16.667
10,0.950,Wild Turkey,23-5,0,15,0,15,0.000,0.000
10,0.950,Clark Grebe,16-23,0,0,0,0,NaN,NaN
10,0.950,Clark Grebe,23-5,0,0,0,0,NaN,NaN
10,0.950,Seagull,16-23,0,0,0,0,NaN,NaN
10,0.950,Seagull,23-5,44,8,0,52,84.615,84.615
10,0.950,Surf Scoter,16-23,0,0,0,0,NaN,NaN
10,0.950,Surf Scoter,23-5,0,0,0,0,NaN,NaN
10,0.950,Pigeon,16-23,89,140,0,229,38.865,38.865
10,0.950,Pigeon,23-5,131,170,0,301,43.522,43.522
10,0.950,Pacific Ocean Water,16-23,0,0,0,0,NaN,NaN
10,0.950,Pacific Ocean Water,23-5,0,0,0,0,NaN,NaN
10,0.950,Cat,16-23,19,24,0,43,44.186,44.186
10,0.950,Cat,23-5,27,23,0,50,54.000,54.000
10,0.950,Horse,16-23,6,19,0,25,24.000,24.000
10,0.950,Horse,23-5,26,140,0,166,15.663,15.663
10,0.950,orangutan,16-23,0,0,0,0,NaN,NaN
10,0.950,orangutan,23-5,0,0,0,0,NaN,NaN
10,0.950,Bat,16-23,36,29,0,65,55.385,55.385
10,0.950,Bat,23-5,37,33,0,70,52.857,52.857
10,0.950,Deer,16-23,15,27,0,42,35.714,35.714
10,0.950,Deer,23-5,18,117,0,135,13.333,13.333
10,0.950,Great Horned Owl,16-23,0,0,0,0,NaN,NaN
10,0.950,Great Horned Owl,23-5,0,1,0,1,0.000,0.000
10,0.950,Freshwater Lagoon,16-23,0,0,0,0,NaN,NaN
10,0.950,Freshwater Lagoon,23-5,0,0,0,0,NaN,NaN
10,0.950,Unknown Avian,16-23,0,0,0,0,NaN,NaN
10,0.950,Unknown Avian,23-5,0,0,0,0,NaN,NaN
10,0.950,Human UTI,16-23,78,75,0,153,50.980,50.980
10,0.950,Human UTI,23-5,102,101,0,203,50.246,50.246
10,0.950,unknown,16-23,0,0,0,0,NaN,NaN
10,0.950,unknown,23-5,0,3,0,3,0.000,0.000
10,0.950,SLO Creek Water,16-23,0,0,0,0,NaN,NaN
10,0.950,SLO Creek Water,23-5,0,0,0,0,NaN,NaN
10,0.950,Pig/Swine,16-23,7,7,0,14,50.000,50.000
10,0.950,Pig/Swine,23-5,11,11,0,22,50.000,50.000
10,0.950,Klebsiella,16-23,0,0,0,0,NaN,NaN
10,0.950,Klebsiella,23-5,0,0,0,0,NaN,NaN
10,0.950,Hu Cw and Dg,16-23,11,18,0,29,37.931,37.931
10,0.950,Hu Cw and Dg,23-5,11,23,0,34,32.353,32.353
10,0.950,Ground Squirrel,16-23,86,47,0,133,64.662,64.662
10,0.950,Ground Squirrel,23-5,84,76,0,160,52.500,52.500
10,0.950,Opossum,16-23,0,0,0,0,NaN,NaN
10,0.950,Opossum,23-5,0,0,0,0,NaN,NaN
10,0.950,Cow,16-23,1575,1116,0,2691,58.528,58.528
10,0.950,Cow,23-5,1527,1438,0,2965,51.501,51.501
10,0.950,Deer Mouse,16-23,0,0,0,0,NaN,NaN
10,0.950,Deer Mouse,23-5,0,0,0,0,NaN,NaN
10,0.950,OVERALL,16-23,3844,2483,0,6327,60.755,60.755
10,0.950,OVERALL,23-5,4487,3103,0,7590,59.117,59.117
10,0.960,Chicken,16-23,0,1,0,1,0.000,0.000
10,0.960,Chicken,23-5,7,9,0,16,43.750,43.750
10,0.960,Sea Lion,16-23,0,1,0,1,0.000,0.000
10,0.960,Sea Lion,23-5,1,10,0,11,9.091,9.091
10,0.960,Hu and Cw,16-23,2,7,0,9,22.222,22.222
10,0.960,Hu and Cw,23-5,2,10,0,12,16.667,16.667
10,0.960,Sheep,16-23,50,50,0,100,50.000,50.000
10,0.960,Sheep,23-5,58,42,0,100,58.000,58.000
10,0.960,Hu and Dg,16-23,7,10,0,17,41.176,41.176
10,0.960,Hu and Dg,23-5,19,21,0,40,47.500,47.500
10,0.960,Common Loon,16-23,0,0,0,0,NaN,NaN
10,0.960,Common Loon,23-5,0,1,0,1,0.000,0.000
10,0.960,Red-Winged Blackbird,16-23,0,1,0,1,0.000,0.000
10,0.960,Red-Winged Blackbird,23-5,0,0,0,0,NaN,NaN
10,0.960,Cw,16-23,7,13,0,20,35.000,35.000
10,0.960,Cw,23-5,11,26,0,37,29.730,29.730
10,0.960,Cliff Sparrow,16-23,1,12,0,13,7.692,7.692
10,0.960,Cliff Sparrow,23-5,0,5,0,5,0.000,0.000
10,0.960,Pig,16-23,10,8,0,18,55.556,55.556
10,0.960,Pig,23-5,4,6,0,10,40.000,40.000
10,0.960,Barn Owl,16-23,0,0,0,0,NaN,NaN
10,0.960,Barn Owl,23-5,0,0,0,0,NaN,NaN
10,0.960,Wild Pig,16-23,1,0,0,1,100.000,100.000
10,0.960,Wild Pig,23-5,1,2,0,3,33.333,33.333
10,0.960,Pennington Creek Water,16-23,0,0,0,0,NaN,NaN
10,0.960,Pennington Creek Water,23-5,0,0,0,0,NaN,NaN
10,0.960,Guinni,16-23,0,0,0,0,NaN,NaN
10,0.960,Guinni,23-5,0,0,0,0,NaN,NaN
10,0.960,Racoon,16-23,0,0,0,0,NaN,NaN
10,0.960,Racoon,23-5,0,0,0,0,NaN,NaN
10,0.960,Hu,16-23,15,14,0,29,51.724,51.724
10,0.960,Hu,23-5,23,14,0,37,62.162,62.162
10,0.960,Cw and Dg,16-23,5,15,0,20,25.000,25.000
10,0.960,Cw and Dg,23-5,15,16,0,31,48.387,48.387
10,0.960,Red Wind Blackbird,16-23,0,0,0,0,NaN,NaN
10,0.960,Red Wind Blackbird,23-5,0,0,0,0,NaN,NaN
10,0.960,Tree Swallow,16-23,0,0,0,0,NaN,NaN
10,0.960,Tree Swallow,23-5,0,0,0,0,NaN,NaN
10,0.960,Turkey Vulture,16-23,0,0,0,0,NaN,NaN
10,0.960,Turkey Vulture,23-5,0,0,0,0,NaN,NaN
10,0.960,Dg,16-23,5,9,0,14,35.714,35.714
10,0.960,Dg,23-5,31,31,0,62,50.000,50.000
10,0.960,Western Kingbird,16-23,0,0,0,0,NaN,NaN
10,0.960,Western Kingbird,23-5,0,0,0,0,NaN,NaN
10,0.960,White Crowned Sparrow,16-23,0,0,0,0,NaN,NaN
10,0.960,White Crowned Sparrow,23-5,0,5,0,5,0.000,0.000
10,0.960,Eared Grebe,16-23,0,0,0,0,NaN,NaN
10,0.960,Eared Grebe,23-5,0,10,0,10,0.000,0.000
10,0.960,cougar,16-23,0,0,0,0,NaN,NaN
10,0.960,cougar,23-5,0,0,0,0,NaN,NaN
10,0.960,Ocean Water,16-23,0,0,0,0,NaN,NaN
10,0.960,Ocean Water,23-5,0,0,0,0,NaN,NaN
10,0.960,Red Tailed Hawk,16-23,0,0,0,0,NaN,NaN
10,0.960,Red Tailed Hawk,23-5,0,5,0,5,0.000,0.000
10,0.960,Dog,16-23,55,67,0,122,45.082,45.082
10,0.960,Dog,23-5,101,122,0,223,45.291,45.291
10,0.960,Human,16-23,1765,766,0,2531,69.735,69.735
10,0.960,Human,23-5,2196,592,0,2788,78.766,78.766
10,0.960,Wild Turkey,16-23,1,5,0,6,16.667,16.667
10,0.960,Wild Turkey,23-5,0,19,0,19,0.000,0.000
10,0.960,Clark Grebe,16-23,0,0,0,0,NaN,NaN
10,0.960,Clark Grebe,23-5,0,0,0,0,NaN,NaN
10,0.960,Seagull,16-23,0,0,0,0,NaN,NaN
10,0.960,Seagull,23-5,44,9,0,53,83.019,83.019
10,0.960,Surf Scoter,16-23,0,0,0,0,NaN,NaN
10,0.960,Surf Scoter,23-5,0,2,0,2,0.000,0.000
10,0.960,Pigeon,16-23,88,140,0,228,38.596,38.596
10,0.960,Pigeon,23-5,132,184,0,316,41.772,41.772
10,0.960,Pacific Ocean Water,16-23,0,0,0,0,NaN,NaN
10,0.960,Pacific Ocean Water,23-5,0,0,0,0,NaN,NaN
10,0.960,Cat,16-23,19,24,0,43,44.186,44.186
10,0.960,Cat,23-5,27,24,0,51,52.941,52.941
10,0.960,Horse,16-23,6,19,0,25,24.000,24.000
10,0.960,Horse,23-5,26,140,0,166,15.663,15.663
10,0.960,orangutan,16-23,0,0,0,0,NaN,NaN
10,0.960,orangutan,23-5,0,0,0,0,NaN,NaN
10,0.960,Bat,16-23,36,29,0,65,55.385,55.385
10,0.960,Bat,23-5,37,33,0,70,52.857,52.857
10,0.960,Deer,16-23,15,27,0,42,35.714,35.714
10,0.960,Deer,23-5,18,117,0,135,13.333,13.333
10,0.960,Great Horned Owl,16-23,0,0,0,0,NaN,NaN
10,0.960,Great Horned Owl,23-5,0,1,0,1,0.000,0.000
10,0.960,Freshwater Lagoon,16-23,0,0,0,0,NaN,NaN
10,0.960,Freshwater Lagoon,23-5,0,0,0,0,NaN,NaN
10,0.960,Unknown Avian,16-23,0,0,0,0,NaN,NaN
10,0.960,Unknown Avian,23-5,0,0,0,0,NaN,NaN
10,0.960,Human UTI,16-23,78,76,0,154,50.649,50.649
10,0.960,Human UTI,23-5,102,100,0,202,50.495,50.495
10,0.960,unknown,16-23,0,0,0,0,NaN,NaN
10,0.960,unknown,23-5,0,3,0,3,0.000,0.000
10,0.960,SLO Creek Water,16-23,0,0,0,0,NaN,NaN
10,0.960,SLO Creek Water,23-5,0,0,0,0,NaN,NaN
10,0.960,Pig/Swine,16-23,7,7,0,14,50.000,50.000
10,0.960,Pig/Swine,23-5,11,11,0,22,50.000,50.000
10,0.960,Klebsiella,16-23,0,0,0,0,NaN,NaN
10,0.960,Klebsiella,23-5,0,0,0,0,NaN,NaN
10,0.960,Hu Cw and Dg,16-23,11,18,0,29,37.931,37.931
10,0.960,Hu Cw and Dg,23-5,11,23,0,34,32.353,32.353
10,0.960,Ground Squirrel,16-23,86,47,0,133,64.662,64.662
10,0.960,Ground Squirrel,23-5,84,78,0,162,51.852,51.852
10,0.960,Opossum,16-23,0,0,0,0,NaN,NaN
10,0.960,Opossum,23-5,0,0,0,0,NaN,NaN
10,0.960,Cow,16-23,1573,1107,0,2680,58.694,58.694
10,0.960,Cow,23-5,1527,1421,0,2948,51.798,51.798
10,0.960,Deer Mouse,16-23,0,0,0,0,NaN,NaN
10,0.960,Deer Mouse,23-5,0,0,0,0,NaN,NaN
10,0.960,OVERALL,16-23,3843,2473,0,6316,60.845,60.845
10,0.960,OVERALL,23-5,4488,3092,0,7580,59.208,59.208
10,0.970,Chicken,16-23,0,1,0,1,0.000,0.000
10,0.970,Chicken,23-5,7,9,0,16,43.750,43.750
10,0.970,Sea Lion,16-23,0,1,0,1,0.000,0.000
10,0.970,Sea Lion,23-5,1,10,0,11,9.091,9.091
10,0.970,Hu and Cw,16-23,2,7,0,9,22.222,22.222
10,0.970,Hu and Cw,23-5,2,10,0,12,16.667,16.667
10,0.970,Sheep,16-23,51,51,0,102,50.000,50.000
10,0.970,Sheep,23-5,58,41,0,99,58.586,58.586
10,0.970,Hu and Dg,16-23,7,10,0,17,41.176,41.176
10,0.970,Hu and Dg,23-5,19,21,0,40,47.500,47.500
10,0.970,Common Loon,16-23,0,0,0,0,NaN,NaN
10,0.970,Common Loon,23-5,0,1,0,1,0.000,0.000
10,0.970,Red-Winged Blackbird,16-23,0,1,0,1,0.000,0.000
10,0.970,Red-Winged Blackbird,23-5,0,0,0,0,NaN,NaN
10,0.970,Cw,16-23,7,14,0,21,33.333,33.333
10,0.970,Cw,23-5,11,26,0,37,29.730,29.730
10,0.970,Cliff Sparrow,16-23,1,12,0,13,7.692,7.692
10,0.970,Cliff Sparrow,23-5,0,5,0,5,0.000,0.000
10,0.970,Pig,16-23,10,8,0,18,55.556,55.556
10,0.970,Pig,23-5,4,6,0,10,40.000,40.000
10,0.970,Barn Owl,16-23,0,0,0,0,NaN,NaN
10,0.970,Barn Owl,23-5,0,0,0,0,NaN,NaN
10,0.970,Wild Pig,16-23,1,0,0,1,100.000,100.000
10,0.970,Wild Pig,23-5,0,2,0,2,0.000,0.000
10,0.970,Pennington Creek Water,16-23,0,0,0,0,NaN,NaN
10,0.970,Pennington Creek Water,23-5,0,0,0,0,NaN,NaN
10,0.970,Guinni,16-23,0,0,0,0,NaN,NaN
10,0.970,Guinni,23-5,0,0,0,0,NaN,NaN
10,0.970,Racoon,16-23,0,0,0,0,NaN,NaN
10,0.970,Racoon,23-5,0,0,0,0,NaN,NaN
10,0.970,Hu,16-23,15,14,0,29,51.724,51.724
10,0.970,Hu,23-5,23,14,0,37,62.162,62.162
10,0.970,Cw and Dg,16-23,5,15,0,20,25.000,25.000
10,0.970,Cw and Dg,23-5,15,16,0,31,48.387,48.387
10,0.970,Red Wind Blackbird,16-23,0,0,0,0,NaN,NaN
10,0.970,Red Wind Blackbird,23-5,0,0,0,0,NaN,NaN
10,0.970,Tree Swallow,16-23,0,0,0,0,NaN,NaN
10,0.970,Tree Swallow,23-5,0,0,0,0,NaN,NaN
10,0.970,Turkey Vulture,16-23,0,0,0,0,NaN,NaN
10,0.970,Turkey Vulture,23-5,0,0,0,0,NaN,NaN
10,0.970,Dg,16-23,5,9,0,14,35.714,35.714
10,0.970,Dg,23-5,31,30,0,61,50.820,50.820
10,0.970,Western Kingbird,16-23,0,0,0,0,NaN,NaN
10,0.970,Western Kingbird,23-5,0,0,0,0,NaN,NaN
10,0.970,White Crowned Sparrow,16-23,0,0,0,0,NaN,NaN
10,0.970,White Crowned Sparrow,23-5,0,5,0,5,0.000,0.000
10,0.970,Eared Grebe,16-23,0,0,0,0,NaN,NaN
10,0.970,Eared Grebe,23-5,0,10,0,10,0.000,0.000
10,0.970,cougar,16-23,0,0,0,0,NaN,NaN
10,0.970,cougar,23-5,0,0,0,0,NaN,NaN
10,0.970,Ocean Water,16-23,0,0,0,0,NaN,NaN
10,0.970,Ocean Water,23-5,0,0,0,0,NaN,NaN
10,0.970,Red Tailed Hawk,16-23,0,0,0,0,NaN,NaN
10,0.970,Red Tailed Hawk,23-5,0,5,0,5,0.000,0.000
10,0.970,Dog,16-23,55,67,0,122,45.082,45.082
10,0.970,Dog,23-5,101,121,0,222,45.495,45.495
10,0.970,Human,16-23,1764,765,0,2529,69.751,69.751
10,0.970,Human,23-5,2194,591,0,2785,78.779,78.779
10,0.970,Wild Turkey,16-23,1,7,0,8,12.500,12.500
10,0.970,Wild Turkey,23-5,2,19,0,21,9.524,9.524
10,0.970,Clark Grebe,16-23,0,0,0,0,NaN,NaN
10,0.970,Clark Grebe,23-5,0,0,0,0,NaN,NaN
10,0.970,Seagull,16-23,0,0,0,0,NaN,NaN
10,0.970,Seagull,23-5,44,10,0,54,81.481,81.481
10,0.970,Surf Scoter,16-23,0,0,0,0,NaN,NaN
10,0.970,Surf Scoter,23-5,0,2,0,2,0.000,0.000
10,0.970,Pigeon,16-23,86,138,0,224,38.393,38.393
10,0.970,Pigeon,23-5,132,201,0,333,39.640,39.640
10,0.970,Pacific Ocean Water,16-23,0,0,0,0,NaN,NaN
10,0.970,Pacific Ocean Water,23-5,0,0,0,0,NaN,NaN
10,0.970,Cat,16-23,19,24,0,43,44.186,44.186
10,0.970,Cat,23-5,27,24,0,51,52.941,52.941
10,0.970,Horse,16-23,6,19,0,25,24.000,24.000
10,0.970,Horse,23-5,26,141,0,167,15.569,15.569
10,0.970,orangutan,16-23,0,0,0,0,NaN,NaN
10,0.970,orangutan,23-5,0,0,0,0,NaN,NaN
10,0.970,Bat,16-23,36,29,0,65,55.385,55.385
10,0.970,Bat,23-5,37,33,0,70,52.857,52.857
10,0.970,Deer,16-23,15,27,0,42,35.714,35.714
10,0.970,Deer,23-5,18,117,0,135,13.333,13.333
10,0.970,Great Horned Owl,16-23,0,0,0,0,NaN,NaN
10,0.970,Great Horned Owl,23-5,0,1,0,1,0.000,0.000
10,0.970,Freshwater Lagoon,16-23,0,0,0,0,NaN,NaN
10,0.970,Freshwater Lagoon,23-5,0,0,0,0,NaN,NaN
10,0.970,Unknown Avian,16-23,0,0,0,0,NaN,NaN
10,0.970,Unknown Avian,23-5,0,0,0,0,NaN,NaN
10,0.970,Human UTI,16-23,78,77,0,155,50.323,50.323
10,0.970,Human UTI,23-5,101,100,0,201,50.249,50.249
10,0.970,unknown,16-23,0,0,0,0,NaN,NaN
10,0.970,unknown,23-5,0,3,0,3,0.000,0.000
10,0.970,SLO Creek Water,16-23,0,0,0,0,NaN,NaN
10,0.970,SLO Creek Water,23-5,0,0,0,0,NaN,NaN
10,0.970,Pig/Swine,16-23,7,7,0,14,50.000,50.000
10,0.970,Pig/Swine,23-5,11,11,0,22,50.000,50.000
10,0.970,Klebsiella,16-23,0,0,0,0,NaN,NaN
10,0.970,Klebsiella,23-5,0,0,0,0,NaN,NaN
10,0.970,Hu Cw and Dg,16-23,11,18,0,29,37.931,37.931
10,0.970,Hu Cw and Dg,23-5,11,23,0,34,32.353,32.353
10,0.970,Ground Squirrel,16-23,86,45,0,131,65.649,65.649
10,0.970,Ground Squirrel,23-5,84,76,0,160,52.500,52.500
10,0.970,Opossum,16-23,0,0,0,0,NaN,NaN
10,0.970,Opossum,23-5,0,0,0,0,NaN,NaN
10,0.970,Cow,16-23,1567,1105,0,2672,58.645,58.645
10,0.970,Cow,23-5,1524,1394,0,2918,52.228,52.228
10,0.970,Deer Mouse,16-23,0,0,0,0,NaN,NaN
10,0.970,Deer Mouse,23-5,0,0,0,0,NaN,NaN
10,0.970,OVERALL,16-23,3835,2471,0,6306,60.815,60.815
10,0.970,OVERALL,23-5,4483,3078,0,7561,59.291,59.291
10,0.980,Chicken,16-23,0,1,0,1,0.000,0.000
10,0.980,Chicken,23-5,8,9,0,17,47.059,47.059
10,0.980,Sea Lion,16-23,0,1,0,1,0.000,0.000
10,0.980,Sea Lion,23-5,1,9,0,10,10.000,10.000
10,0.980,Hu and Cw,16-23,2,7,0,9,22.222,22.222
10,0.980,Hu and Cw,23-5,2,20,0,22,9.091,9.091
10,0.980,Sheep,16-23,53,49,0,102,51.961,51.961
10,0.980,Sheep,23-5,57,40,0,97,58.763,58.763
10,0.980,Hu and Dg,16-23,7,10,0,17,41.176,41.176
10,0.980,Hu and Dg,23-5,19,18,0,37,51.351,51.351
10,0.980,Common Loon,16-23,0,0,0,0,NaN,NaN
10,0.980,Common Loon,23-5,0,1,0,1,0.000,0.000
10,0.980,Red-Winged Blackbird,16-23,0,1,0,1,0.000,0.000
10,0.980,Red-Winged Blackbird,23-5,0,0,0,0,NaN,NaN
10,0.980,Cw,16-23,7,13,0,20,35.000,35.000
10,0.980,Cw,23-5,11,26,0,37,29.730,29.730
10,0.980,Cliff Sparrow,16-23,1,11,0,12,8.333,8.333
10,0.980,Cliff Sparrow,23-5,0,5,0,5,0.000,0.000
10,0.980,Pig,16-23,10,8,0,18,55.556,55.556
10,0.980,Pig,23-5,4,6,0,10,40.000,40.000
10,0.980,Barn Owl,16-23,0,0,0,0,NaN,NaN
10,0.980,Barn Owl,23-5,0,0,0,0,NaN,NaN
10,0.980,Wild Pig,16-23,1,0,0,1,100.000,100.000
10,0.980,Wild Pig,23-5,0,2,0,2,0.000,0.000
10,0.980,Pennington Creek Water,16-23,0,0,0,0,NaN,NaN
10,0.980,Pennington Creek Water,23-5,0,0,0,0,NaN,NaN
10,0.980,Guinni,16-23,0,0,0,0,NaN,NaN
10,0.980,Guinni,23-5,0,0,0,0,NaN,NaN
10,0.980,Racoon,16-23,0,0,0,0,NaN,NaN
10,0.980,Racoon,23-5,0,0,0,0,NaN,NaN
10,0.980,Hu,16-23,15,14,0,29,51.724,51.724
10,0.980,Hu,23-5,23,15,0,38,60.526,60.526
10,0.980,Cw and Dg,16-23,5,15,0,20,25.000,25.000
10,0.980,Cw and Dg,23-5,15,17,0,32,46.875,46.875
10,0.980,Red Wind Blackbird,16-23,0,0,0,0,NaN,NaN
10,0.980,Red Wind Blackbird,23-5,0,0,0,0,NaN,NaN
10,0.980,Tree Swallow,16-23,0,0,0,0,NaN,NaN
10,0.980,Tree Swallow,23-5,0,0,0,0,NaN,NaN
10,0.980,Turkey Vulture,16-23,0,0,0,0,NaN,NaN
10,0.980,Turkey Vulture,23-5,0,0,0,0,NaN,NaN
10,0.980,Dg,16-23,5,9,0,14,35.714,35.714
10,0.980,Dg,23-5,31,23,0,54,57.407,57.407
10,0.980,Western Kingbird,16-23,0,0,0,0,NaN,NaN
10,0.980,Western Kingbird,23-5,0,0,0,0,NaN,NaN
10,0.980,White Crowned Sparrow,16-23,0,0,0,0,NaN,NaN
10,0.980,White Crowned Sparrow,23-5,0,6,0,6,0.000,0.000
10,0.980,Eared Grebe,16-23,0,0,0,0,NaN,NaN
10,0.980,Eared Grebe,23-5,0,10,0,10,0.000,0.000
10,0.980,cougar,16-23,0,0,0,0,NaN,NaN
10,0.980,cougar,23-5,0,0,0,0,NaN,NaN
10,0.980,Ocean Water,16-23,0,0,0,0,NaN,NaN
10,0.980,Ocean Water,23-5,0,0,0,0,NaN,NaN
10,0.980,Red Tailed Hawk,16-23,0,0,0,0,NaN,NaN
10,0.980,Red Tailed Hawk,23-5,0,4,0,4,0.000,0.000
10,0.980,Dog,16-23,54,71,0,125,43.200,43.200
10,0.980,Dog,23-5,101,119,0,220,45.909,45.909
10,0.980,Human,16-23,1767,754,0,2521,70.091,70.091
10,0.980,Human,23-5,2196,577,0,2773,79.192,79.192
10,0.980,Wild Turkey,16-23,1,7,0,8,12.500,12.500
10,0.980,Wild Turkey,23-5,4,26,0,30,13.333,13.333
10,0.980,Clark Grebe,16-23,0,0,0,0,NaN,NaN
10,0.980,Clark Grebe,23-5,0,0,0,0,NaN,NaN
10,0.980,Seagull,16-23,0,0,0,0,NaN,NaN
10,0.980,Seagull,23-5,46,8,0,54,85.185,85.185
10,0.980,Surf Scoter,16-23,0,0,0,0,NaN,NaN
10,0.980,Surf Scoter,23-5,2,0,0,2,100.000,100.000
10,0.980,Pigeon,16-23,86,135,0,221,38.914,38.914
10,0.980,Pigeon,23-5,131,209,0,340,38.529,38.529
10,0.980,Pacific Ocean Water,16-23,0,0,0,0,NaN,NaN
10,0.980,Pacific Ocean Water,23-5,0,0,0,0,NaN,NaN
10,0.980,Cat,16-23,19,24,0,43,44.186,44.186
10,0.980,Cat,23-5,29,23,0,52,55.769,55.769
10,0.980,Horse,16-23,6,19,0,25,24.000,24.000
10,0.980,Horse,23-5,26,138,0,164,15.854,15.854
10,0.980,orangutan,16-23,0,0,0,0,NaN,NaN
10,0.980,orangutan,23-5,0,0,0,0,NaN,NaN
10,0.980,Bat,16-23,36,29,0,65,55.385,55.385
10,0.980,Bat,23-5,37,32,0,69,53.623,53.623
10,0.980,Deer,16-23,15,27,0,42,35.714,35.714
10,0.980,Deer,23-5,18,117,0,135,13.333,13.333
10,0.980,Great Horned Owl,16-23,0,0,0,0,NaN,NaN
10,0.980,Great Horned Owl,23-5,0,1,0,1,0.000,0.000
10,0.980,Freshwater Lagoon,16-23,0,0,0,0,NaN,NaN
10,0.980,Freshwater Lagoon,23-5,0,0,0,0,NaN,NaN
10,0.980,Unknown Avian,16-23,0,0,0,0,NaN,NaN
10,0.980,Unknown Avian,23-5,0,0,0,0,NaN,NaN
10,0.980,Human UTI,16-23,78,79,0,157,49.682,49.682
10,0.980,Human UTI,23-5,101,98,0,199,50.754,50.754
10,0.980,unknown,16-23,0,0,0,0,NaN,NaN
10,0.980,unknown,23-5,0,4,0,4,0.000,0.000
10,0.980,SLO Creek Water,16-23,0,0,0,0,NaN,NaN
10,0.980,SLO Creek Water,23-5,0,0,0,0,NaN,NaN
10,0.980,Pig/Swine,16-23,7,7,0,14,50.000,50.000
10,0.980,Pig/Swine,23-5,11,11,0,22,50.000,50.000
10,0.980,Klebsiella,16-23,0,0,0,0,NaN,NaN
10,0.980,Klebsiella,23-5,0,0,0,0,NaN,NaN
10,0.980,Hu Cw and Dg,16-23,11,18,0,29,37.931,37.931
10,0.980,Hu Cw and Dg,23-5,11,22,0,33,33.333,33.333
10,0.980,Ground Squirrel,16-23,87,46,0,133,65.414,65.414
10,0.980,Ground Squirrel,23-5,84,74,0,158,53.165,53.165
10,0.980,Opossum,16-23,0,0,0,0,NaN,NaN
10,0.980,Opossum,23-5,0,0,0,0,NaN,NaN
10,0.980,Cow,16-23,1561,1089,0,2650,58.906,58.906
10,0.980,Cow,23-5,1519,1365,0,2884,52.670,52.670
10,0.980,Deer Mouse,16-23,0,0,0,0,NaN,NaN
10,0.980,Deer Mouse,23-5,0,0,0,0,NaN,NaN
10,0.980,OVERALL,16-23,3834,2444,0,6278,61.070,61.070
10,0.980,OVERALL,23-5,4487,3035,0,7522,59.652,59.652
10,0.990,Chicken,16-23,2,6,0,8,25.000,25.000
10,0.990,Chicken,23-5,9,9,0,18,50.000,50.000
10,0.990,Sea Lion,16-23,0,1,0,1,0.000,0.000
10,0.990,Sea Lion,23-5,4,6,0,10,40.000,40.000
10,0.990,Hu and Cw,16-23,3,7,0,10,30.000,30.000
10,0.990,Hu and Cw,23-5,4,25,0,29,13.793,13.793
10,0.990,Sheep,16-23,52,49,0,101,51.485,51.485
10,0.990,Sheep,23-5,58,39,0,97,59.794,59.794
10,0.990,Hu and Dg,16-23,7,12,0,19,36.842,36.842
10,0.990,Hu and Dg,23-5,19,14,0,33,57.576,57.576
10,0.990,Common Loon,16-23,0,0,0,0,NaN,NaN
10,0.990,Common Loon,23-5,0,2,0,2,0.000,0.000
10,0.990,Red-Winged Blackbird,16-23,0,3,0,3,0.000,0.000
10,0.990,Red-Winged Blackbird,23-5,0,0,0,0,NaN,NaN
10,0.990,Cw,16-23,8,13,0,21,38.095,38.095
10,0.990,Cw,23-5,17,28,0,45,37.778,37.778
10,0.990,Cliff Sparrow,16-23,1,12,0,13,7.692,7.692
10,0.990,Cliff Sparrow,23-5,0,8,0,8,0.000,0.000
10,0.990,Pig,16-23,10,9,0,19,52.632,52.632
10,0.990,Pig,23-5,8,8,0,16,50.000,50.000
10,0.990,Barn Owl,16-23,0,0,0,0,NaN,NaN
10,0.990,Barn Owl,23-5,0,0,0,0,NaN,NaN
10,0.990,Wild Pig,16-23,1,1,0,2,50.000,50.000
10,0.990,Wild Pig,23-5,0,3,0,3,0.000,0.000
10,0.990,Pennington Creek Water,16-23,0,0,0,0,NaN,NaN
10,0.990,Pennington Creek Water,23-5,0,0,0,0,NaN,NaN
10,0.990,Guinni,16-23,0,0,0,0,NaN,NaN
10,0.990,Guinni,23-5,0,0,0,0,NaN,NaN
10,0.990,Racoon,16-23,0,0,0,0,NaN,NaN
10,0.990,Racoon,23-5,0,1,0,1,0.000,0.000
10,0.990,Hu,16-23,15,12,0,27,55.556,55.556
10,0.990,Hu,23-5,23,12,0,35,65.714,65.714
10,0.990,Cw and Dg,16-23,5,15,0,20,25.000,25.000
10,0.990,Cw and Dg,23-5,15,11,0,26,57.692,57.692
10,0.990,Red Wind Blackbird,16-23,0,0,0,0,NaN,NaN
10,0.990,Red Wind Blackbird,23-5,0,0,0,0,NaN,NaN
10,0.990,Tree Swallow,16-23,0,0,0,0,NaN,NaN
10,0.990,Tree Swallow,23-5,0,0,0,0,NaN,NaN
10,0.990,Turkey Vulture,16-23,0,0,0,0,NaN,NaN
10,0.990,Turkey Vulture,23-5,0,0,0,0,NaN,NaN
10,0.990,Dg,16-23,5,10,0,15,33.333,33.333
10,0.990,Dg,23-5,31,19,0,50,62.000,62.000
10,0.990,Western Kingbird,16-23,0,0,0,0,NaN,NaN
10,0.990,Western Kingbird,23-5,0,0,0,0,NaN,NaN
10,0.990,White Crowned Sparrow,16-23,0,0,0,0,NaN,NaN
10,0.990,White Crowned Sparrow,23-5,0,6,0,6,0.000,0.000
10,0.990,Eared Grebe,16-23,0,0,0,0,NaN,NaN
10,0.990,Eared Grebe,23-5,0,11,0,11,0.000,0.000
10,0.990,cougar,16-23,0,1,0,1,0.000,0.000
10,0.990,cougar,23-5,0,0,0,0,NaN,NaN
10,0.990,Ocean Water,16-23,0,0,0,0,NaN,NaN
10,0.990,Ocean Water,23-5,0,0,0,0,NaN,NaN
10,0.990,Red Tailed Hawk,16-23,0,0,0,0,NaN,NaN
10,0.990,Red Tailed Hawk,23-5,0,4,0,4,0.000,0.000
10,0.990,Dog,16-23,57,74,0,131,43.511,43.511
10,0.990,Dog,23-5,104,111,0,215,48.372,48.372
10,0.990,Human,16-23,1755,714,0,2469,71.081,71.081
10,0.990,Human,23-5,2184,530,0,2714,80.472,80.472
10,0.990,Wild Turkey,16-23,3,12,0,15,20.000,20.000
10,0.990,Wild Turkey,23-5,4,26,0,30,13.333,13.333
10,0.990,Clark Grebe,16-23,0,0,0,0,NaN,NaN
10,0.990,Clark Grebe,23-5,2,3,0,5,40.000,40.000
10,0.990,Seagull,16-23,0,0,0,0,NaN,NaN
10,0.990,Seagull,23-5,48,7,0,55,87.273,87.273
10,0.990,Surf Scoter,16-23,0,0,0,0,NaN,NaN
10,0.990,Surf Scoter,23-5,2,0,0,2,100.000,100.000
10,0.990,Pigeon,16-23,93,129,0,222,41.892,41.892
10,0.990,Pigeon,23-5,137,222,0,359,38.162,38.162
10,0.990,Pacific Ocean Water,16-23,0,0,0,0,NaN,NaN
10,0.990,Pacific Ocean Water,23-5,0,0,0,0,NaN,NaN
10,0.990,Cat,16-23,21,25,0,46,45.652,45.652
10,0.990,Cat,23-5,30,26,0,56,53.571,53.571
10,0.990,Horse,16-23,9,19,0,28,32.143,32.143
10,0.990,Horse,23-5,26,144,0,170,15.294,15.294
10,0.990,orangutan,16-23,0,0,0,0,NaN,NaN
10,0.990,orangutan,23-5,0,0,0,0,NaN,NaN
10,0.990,Bat,16-23,36,27,0,63,57.143,57.143
10,0.990,Bat,23-5,37,31,0,68,54.412,54.412
10,0.990,Deer,16-23,15,28,0,43,34.884,34.884
10,0.990,Deer,23-5,18,111,0,129,13.953,13.953
10,0.990,Great Horned Owl,16-23,0,0,0,0,NaN,NaN
10,0.990,Great Horned Owl,23-5,0,1,0,1,0.000,0.000
10,0.990,Freshwater Lagoon,16-23,0,0,0,0,NaN,NaN
10,0.990,Freshwater Lagoon,23-5,0,0,0,0,NaN,NaN
10,0.990,Unknown Avian,16-23,0,0,0,0,NaN,NaN
10,0.990,Unknown Avian,23-5,0,0,0,0,NaN,NaN
10,0.990,Human UTI,16-23,82,71,0,153,53.595,53.595
10,0.990,Human UTI,23-5,102,80,0,182,56.044,56.044
10,0.990,unknown,16-23,0,0,0,0,NaN,NaN
10,0.990,unknown,23-5,0,6,0,6,0.000,0.000
10,0.990,SLO Creek Water,16-23,0,0,0,0,NaN,NaN
10,0.990,SLO Creek Water,23-5,0,0,0,0,NaN,NaN
10,0.990,Pig/Swine,16-23,7,8,0,15,46.667,46.667
10,0.990,Pig/Swine,23-5,11,10,0,21,52.381,52.381
10,0.990,Klebsiella,16-23,0,0,0,0,NaN,NaN
10,0.990,Klebsiella,23-5,0,0,0,0,NaN,NaN
10,0.990,Hu Cw and Dg,16-23,11,18,0,29,37.931,37.931
10,0.990,Hu Cw and Dg,23-5,11,21,0,32,34.375,34.375
10,0.990,Ground Squirrel,16-23,89,47,0,136,65.441,65.441
10,0.990,Ground Squirrel,23-5,86,77,0,163,52.761,52.761
10,0.990,Opossum,16-23,1,0,0,1,100.000,100.000
10,0.990,Opossum,23-5,2,0,0,2,100.000,100.000
10,0.990,Cow,16-23,1524,990,0,2514,60.621,60.621
10,0.990,Cow,23-5,1480,1242,0,2722,54.372,54.372
10,0.990,Deer Mouse,16-23,0,0,0,0,NaN,NaN
10,0.990,Deer Mouse,23-5,0,0,0,0,NaN,NaN
10,0.990,OVERALL,16-23,3812,2313,0,6125,62.237,62.237
10,0.990,OVERALL,23-5,4472,2854,0,7326,61.043,61.043
10,1.000,Chicken,16-23,0,0,0,0,NaN,NaN
10,1.000,Chicken,23-5,0,0,0,0,NaN,NaN
10,1.000,Sea Lion,16-23,0,0,0,0,NaN,NaN
10,1.000,Sea Lion,23-5,0,0,0,0,NaN,NaN
10,1.000,Hu and Cw,16-23,0,0,0,0,NaN,NaN
10,1.000,Hu and Cw,23-5,0,0,0,0,NaN,NaN
10,1.000,Sheep,16-23,0,0,0,0,NaN,NaN
10,1.000,Sheep,23-5,0,0,0,0,NaN,NaN
10,1.000,Hu and Dg,16-23,0,0,0,0,NaN,NaN
10,1.000,Hu and Dg,23-5,0,0,0,0,NaN,NaN
10,1.000,Common Loon,16-23,0,0,0,0,NaN,NaN
10,1.000,Common Loon,23-5,0,0,0,0,NaN,NaN
10,1.000,Red-Winged Blackbird,16-23,0,0,0,0,NaN,NaN
10,1.000,Red-Winged Blackbird,23-5,0,0,0,0,NaN,NaN
10,1.000,Cw,16-23,0,0,0,0,NaN,NaN
10,1.000,Cw,23-5,0,0,0,0,NaN,NaN
10,1.000,Cliff Sparrow,16-23,0,0,0,0,NaN,NaN
10,1.000,Cliff Sparrow,23-5,0,0,0,0,NaN,NaN
10,1.000,Pig,16-23,0,0,0,0,NaN,NaN
10,1.000,Pig,23-5,0,0,0,0,NaN,NaN
10,1.000,Barn Owl,16-23,0,0,0,0,NaN,NaN
10,1.000,Barn Owl,23-5,0,0,0,0,NaN,NaN
10,1.000,Wild Pig,16-23,0,0,0,0,NaN,NaN
10,1.000,Wild Pig,23-5,0,0,0,0,NaN,NaN
10,1.000,Pennington Creek Water,16-23,0,0,0,0,NaN,NaN
10,1.000,Pennington Creek Water,23-5,0,0,0,0,NaN,NaN
10,1.000,Guinni,16-23,0,0,0,0,NaN,NaN
10,1.000,Guinni,23-5,0,0,0,0,NaN,NaN
10,1.000,Racoon,16-23,0,0,0,0,NaN,NaN
10,1.000,Racoon,23-5,0,0,0,0,NaN,NaN
10,1.000,Hu,16-23,0,0,0,0,NaN,NaN
10,1.000,Hu,23-5,0,0,0,0,NaN,NaN
10,1.000,Cw and Dg,16-23,0,0,0,0,NaN,NaN
10,1.000,Cw and Dg,23-5,0,0,0,0,NaN,NaN
10,1.000,Red Wind Blackbird,16-23,0,0,0,0,NaN,NaN
10,1.000,Red Wind Blackbird,23-5,0,0,0,0,NaN,NaN
10,1.000,Tree Swallow,16-23,0,0,0,0,NaN,NaN
10,1.000,Tree Swallow,23-5,0,0,0,0,NaN,NaN
10,1.000,Turkey Vulture,16-23,0,0,0,0,NaN,NaN
10,1.000,Turkey Vulture,23-5,0,0,0,0,NaN,NaN
10,1.000,Dg,16-23,0,0,0,0,NaN,NaN
10,1.000,Dg,23-5,0,0,0,0,NaN,NaN
10,1.000,Western Kingbird,16-23,0,0,0,0,NaN,NaN
10,1.000,Western Kingbird,23-5,0,0,0,0,NaN,NaN
10,1.000,White Crowned Sparrow,16-23,0,0,0,0,NaN,NaN
10,1.000,White Crowned Sparrow,23-5,0,0,0,0,NaN,NaN
10,1.000,Eared Grebe,16-23,0,0,0,0,NaN,NaN
10,1.000,Eared Grebe,23-5,0,0,0,0,NaN,NaN
10,1.000,cougar,16-23,0,0,0,0,NaN,NaN
10,1.000,cougar,23-5,0,0,0,0,NaN,NaN
10,1.000,Ocean Water,16-23,0,0,0,0,NaN,NaN
10,1.000,Ocean Water,23-5,0,0,0,0,NaN,NaN
10,1.000,Red Tailed Hawk,16-23,0,0,0,0,NaN,NaN
10,1.000,Red Tailed Hawk,23-5,0,0,0,0,NaN,NaN
10,1.000,Dog,16-23,0,0,0,0,NaN,NaN
10,1.000,Dog,23-5,0,0,0,0,NaN,NaN
10,1.000,Human,16-23,68,0,0,68,100.000,100.000
10,1.000,Human,23-5,90,0,0,90,100.000,100.000
10,1.000,Wild Turkey,16-23,0,0,0,0,NaN,NaN
10,1.000,Wild Turkey,23-5,0,0,0,0,NaN,NaN
10,1.000,Clark Grebe,16-23,0,0,0,0,NaN,NaN
10,1.000,Clark Grebe,23-5,0,0,0,0,NaN,NaN
10,1.000,Seagull,16-23,0,0,0,0,NaN,NaN
10,1.000,Seagull,23-5,0,0,0,0,NaN,NaN
10,1.000,Surf Scoter,16-23,0,0,0,0,NaN,NaN
10,1.000,Surf Scoter,23-5,0,0,0,0,NaN,NaN
10,1.000,Pigeon,16-23,0,0,0,0,NaN,NaN
10,1.000,Pigeon,23-5,0,0,0,0,NaN,NaN
10,1.000,Pacific Ocean Water,16-23,0,0,0,0,NaN,NaN
10,1.000,Pacific Ocean Water,23-5,0,0,0,0,NaN,NaN
10,1.000,Cat,16-23,0,0,0,0,NaN,NaN
10,1.000,Cat,23-5,0,0,0,0,NaN,NaN
10,1.000,Horse,16-23,0,0,0,0,NaN,NaN
10,1.000,Horse,23-5,0,0,0,0,NaN,NaN
10,1.000,orangutan,16-23,0,0,0,0,NaN,NaN
10,1.000,orangutan,23-5,0,0,0,0,NaN,NaN
10,1.000,Bat,16-23,0,0,0,0,NaN,NaN
10,1.000,Bat,23-5,0,0,0,0,NaN,NaN
10,1.000,Deer,16-23,0,0,0,0,NaN,NaN
10,1.000,Deer,23-5,0,0,0,0,NaN,NaN
10,1.000,Great Horned Owl,16-23,0,0,0,0,NaN,NaN
10,1.000,Great Horned Owl,23-5,0,0,0,0,NaN,NaN
10,1.000,Freshwater Lagoon,16-23,0,0,0,0,NaN,NaN
10,1.000,Freshwater Lagoon,23-5,0,0,0,0,NaN,NaN
10,1.000,Unknown Avian,16-23,0,0,0,0,NaN,NaN
10,1.000,Unknown Avian,23-5,0,0,0,0,NaN,NaN
10,1.000,Human UTI,16-23,0,0,0,0,NaN,NaN
10,1.000,Human UTI,23-5,0,0,0,0,NaN,NaN
10,1.000,unknown,16-23,0,0,0,0,NaN,NaN
10,1.000,unknown,23-5,0,0,0,0,NaN,NaN
10,1.000,SLO Creek Water,16-23,0,0,0,0,NaN,NaN
10,1.000,SLO Creek Water,23-5,0,0,0,0,NaN,NaN
10,1.000,Pig/Swine,16-23,0,0,0,0,NaN,NaN
10,1.000,Pig/Swine,23-5,0,0,0,0,NaN,NaN
10,1.000,Klebsiella,16-23,0,0,0,0,NaN,NaN
10,1.000,Klebsiella,23-5,0,0,0,0,NaN,NaN
10,1.000,Hu Cw and Dg,16-23,0,0,0,0,NaN,NaN
10,1.000,Hu Cw and Dg,23-5,0,0,0,0,NaN,NaN
10,1.000,Ground Squirrel,16-23,0,0,0,0,NaN,NaN
10,1.000,Ground Squirrel,23-5,0,0,0,0,NaN,NaN
10,1.000,Opossum,16-23,0,0,0,0,NaN,NaN
10,1.000,Opossum,23-5,0,0,0,0,NaN,NaN
10,1.000,Cow,16-23,0,0,0,0,NaN,NaN
10,1.000,Cow,23-5,0,0,0,0,NaN,NaN
10,1.000,Deer Mouse,16-23,0,0,0,0,NaN,NaN
10,1.000,Deer Mouse,23-5,0,0,0,0,NaN,NaN
10,1.000,OVERALL,16-23,68,0,0,68,100.000,100.000
10,1.000,OVERALL,23-5,90,0,0,90,100.000,100.000
11,0.000,Chicken,16-23,0,1,0,1,0.000,0.000
11,0.000,Chicken,23-5,8,8,0,16,50.000,50.000
11,0.000,Sea Lion,16-23,0,0,0,0,NaN,NaN
11,0.000,Sea Lion,23-5,1,10,0,11,9.091,9.091
11,0.000,Hu and Cw,16-23,1,4,0,5,20.000,20.000
11,0.000,Hu and Cw,23-5,7,8,0,15,46.667,46.667
11,0.000,Sheep,16-23,47,51,0,98,47.959,47.959
11,0.000,Sheep,23-5,53,37,0,90,58.889,58.889
11,0.000,Hu and Dg,16-23,8,13,0,21,38.095,38.095
11,0.000,Hu and Dg,23-5,18,21,0,39,46.154,46.154
11,0.000,Common Loon,16-23,0,0,0,0,NaN,NaN
11,0.000,Common Loon,23-5,0,0,0,0,NaN,NaN
11,0.000,Red-Winged Blackbird,16-23,0,1,0,1,0.000,0.000
11,0.000,Red-Winged Blackbird,23-5,0,0,0,0,NaN,NaN
11,0.000,Cw,16-23,8,13,0,21,38.095,38.095
11,0.000,Cw,23-5,10,25,0,35,28.571,28.571
11,0.000,Cliff Sparrow,16-23,2,9,0,11,18.182,18.182
11,0.000,Cliff Sparrow,23-5,0,0,0,0,NaN,NaN
11,0.000,Pig,16-23,10,6,0,16,62.500,62.500
11,0.000,Pig,23-5,3,3,0,6,50.000,50.000
11,0.000,Barn Owl,16-23,0,0,0,0,NaN,NaN
11,0.000,Barn Owl,23-5,0,0,0,0,NaN,NaN
11,0.000,Wild Pig,16-23,0,0,0,0,NaN,NaN
11,0.000,Wild Pig,23-5,1,3,0,4,25.000,25.000
11,0.000,Pennington Creek Water,16-23,0,0,0,0,NaN,NaN
11,0.000,Pennington Creek Water,23-5,0,0,0,0,NaN,NaN
11,0.000,Guinni,16-23,0,0,0,0,NaN,NaN
11,0.000,Guinni,23-5,0,0,0,0,NaN,NaN
11,0.000,Racoon,16-23,0,0,0,0,NaN,NaN
11,0.000,Racoon,23-5,0,0,0,0,NaN,NaN
11,0.000,Hu,16-23,15,15,0,30,50.000,50.000
11,0.000,Hu,23-5,24,14,0,38,63.158,63.158
11,0.000,Cw and Dg,16-23,6,16,0,22,27.273,27.273
11,0.000,Cw and Dg,23-5,14,18,0,32,43.750,43.750
11,0.000,Red Wind Blackbird,16-23,0,0,0,0,NaN,NaN
11,0.000,Red Wind Blackbird,23-5,0,0,0,0,NaN,NaN
11,0.000,Tree Swallow,16-23,0,0,0,0,NaN,NaN
11,0.000,Tree Swallow,23-5,0,0,0,0,NaN,NaN
11,0.000,Turkey Vulture,16-23,0,0,0,0,NaN,NaN
11,0.000,Turkey Vulture,23-5,0,0,0,0,NaN,NaN
11,0.000,Dg,16-23,6,9,0,15,40.000,40.000
11,0.000,Dg,23-5,32,32,0,64,50.000,50.000
11,0.000,Western Kingbird,16-23,0,0,0,0,NaN,NaN
11,0.000,Western Kingbird,23-5,0,0,0,0,NaN,NaN
11,0.000,White Crowned Sparrow,16-23,0,0,0,0,NaN,NaN
11,0.000,White Crowned Sparrow,23-5,0,3,0,3,0.000,0.000
11,0.000,Eared Grebe,16-23,0,0,0,0,NaN,NaN
11,0.000,Eared Grebe,23-5,0,10,0,10,0.000,0.000
11,0.000,cougar,16-23,0,0,0,0,NaN,NaN
11,0.000,cougar,23-5,0,0,0,0,NaN,NaN
11,0.000,Ocean Water,16-23,0,0,0,0,NaN,NaN
11,0.000,Ocean Water,23-5,0,0,0,0,NaN,NaN
11,0.000,Red Tailed Hawk,16-23,0,0,0,0,NaN,NaN
11,0.000,Red Tailed Hawk,23-5,0,7,0,7,0.000,0.000
11,0.000,Dog,16-23,55,69,0,124,44.355,44.355
11,0.000,Dog,23-5,94,140,0,234,40.171,40.171
11,0.000,Human,16-23,1756,791,0,2547,68.944,68.944
11,0.000,Human,23-5,2185,637,0,2822,77.427,77.427
11,0.000,Wild Turkey,16-23,1,4,0,5,20.000,20.000
11,0.000,Wild Turkey,23-5,0,12,0,12,0.000,0.000
11,0.000,Clark Grebe,16-23,0,0,0,0,NaN,NaN
11,0.000,Clark Grebe,23-5,0,0,0,0,NaN,NaN
11,0.000,Seagull,16-23,0,0,0,0,NaN,NaN
11,0.000,Seagull,23-5,44,8,0,52,84.615,84.615
11,0.000,Surf Scoter,16-23,0,0,0,0,NaN,NaN
11,0.000,Surf Scoter,23-5,0,0,0,0,NaN,NaN
11,0.000,Pigeon,16-23,82,141,0,223,36.771,36.771
11,0.000,Pigeon,23-5,123,147,0,270,45.556,45.556
11,0.000,Pacific Ocean Water,16-23,0,0,0,0,NaN,NaN
11,0.000,Pacific Ocean Water,23-5,0,0,0,0,NaN,NaN
11,0.000,Cat,16-23,19,22,0,41,46.341,46.341
11,0.000,Cat,23-5,26,20,0,46,56.522,56.522
11,0.000,Horse,16-23,5,19,0,24,20.833,20.833
11,0.000,Horse,23-5,25,115,0,140,17.857,17.857
11,0.000,orangutan,16-23,0,0,0,0,NaN,NaN
11,0.000,orangutan,23-5,0,0,0,0,NaN,NaN
11,0.000,Bat,16-23,36,31,0,67,53.731,53.731
11,0.000,Bat,23-5,37,36,0,73,50.685,50.685
11,0.000,Deer,16-23,14,24,0,38,36.842,36.842
11,0.000,Deer,23-5,19,121,0,140,13.571,13.571
11,0.000,Great Horned Owl,16-23,0,0,0,0,NaN,NaN
11,0.000,Great Horned Owl,23-5,0,0,0,0,NaN,NaN
11,0.000,Freshwater Lagoon,16-23,0,0,0,0,NaN,NaN
11,0.000,Freshwater Lagoon,23-5,0,0,0,0,NaN,NaN
11,0.000,Unknown Avian,16-23,0,0,0,0,NaN,NaN
11,0.000,Unknown Avian,23-5,0,0,0,0,NaN,NaN
11,0.000,Human UTI,16-23,75,70,0,145,51.724,51.724
11,0.000,Human UTI,23-5,100,104,0,204,49.020,49.020
11,0.000,unknown,16-23,0,0,0,0,NaN,NaN
11,0.000,unknown,23-5,0,2,0,2,0.000,0.000
11,0.000,SLO Creek Water,16-23,0,0,0,0,NaN,NaN
11,0.000,SLO Creek Water,23-5,0,0,0,0,NaN,NaN
11,0.000,Pig/Swine,16-23,5,7,0,12,41.667,41.667
11,0.000,Pig/Swine,23-5,9,12,0,21,42.857,42.857
11,0.000,Klebsiella,16-23,0,0,0,0,NaN,NaN
11,0.000,Klebsiella,23-5,0,0,0,0,NaN,NaN
11,0.000,Hu Cw and Dg,16-23,7,11,0,18,38.889,38.889
11,0.000,Hu Cw and Dg,23-5,8,14,0,22,36.364,36.364
11,0.000,Ground Squirrel,16-23,87,53,0,140,62.143,62.143
11,0.000,Ground Squirrel,23-5,84,72,0,156,53.846,53.846
11,0.000,Opossum,16-23,0,0,0,0,NaN,NaN
11,0.000,Opossum,23-5,0,0,0,0,NaN,NaN
11,0.000,Cow,16-23,1575,1148,0,2723,57.841,57.841
11,0.000,Cow,23-5,1541,1505,0,3046,50.591,50.591
11,0.000,Deer Mouse,16-23,0,0,0,0,NaN,NaN
11,0.000,Deer Mouse,23-5,0,0,0,0,NaN,NaN
11,0.000,OVERALL,16-23,3820,2528,0,6348,60.176,60.176
11,0.000,OVERALL,23-5,4466,3144,0,7610,58.686,58.686
11,0.500,Chicken,16-23,0,1,0,1,0.000,0.000
11,0.500,Chicken,23-5,8,8,0,16,50.000,50.000
11,0.500,Sea Lion,16-23,0,0,0,0,NaN,NaN
11,0.500,Sea Lion,23-5,1,10,0,11,9.091,9.091
11,0.500,Hu and Cw,16-23,1,4,0,5,20.000,20.000
11,0.500,Hu and Cw,23-5,7,8,0,15,46.667,46.667
11,0.500,Sheep,16-23,47,51,0,98,47.959,47.959
11,0.500,Sheep,23-5,53,37,0,90,58.889,58.889
11,0.500,Hu and Dg,16-23,8,13,0,21,38.095,38.095
11,0.500,Hu and Dg,23-5,18,21,0,39,46.154,46.154
11,0.500,Common Loon,16-23,0,0,0,0,NaN,NaN
11,0.500,Common Loon,23-5,0,0,0,0,NaN,NaN
11,0.500,Red-Winged Blackbird,16-23,0,1,0,1,0.000,0.000
11,0.500,Red-Winged Blackbird,23-5,0,0,0,0,NaN,NaN
11,0.500,Cw,16-23,8,13,0,21,38.095,38.095
11,0.500,Cw,23-5,10,25,0,35,28.571,28.571
11,0.500,Cliff Sparrow,16-23,2,9,0,11,18.182,18.182
11,0.500,Cliff Sparrow,23-5,0,0,0,0,NaN,NaN
11,0.500,Pig,16-23,10,6,0,16,62.500,62.500
11,0.500,Pig,23-5,3,3,0,6,50.000,50.000
11,0.500,Barn Owl,16-23,0,0,0,0,NaN,NaN
11,0.500,Barn Owl,23-5,0,0,0,0,NaN,NaN
11,0.500,Wild Pig,16-23,0,0,0,0,NaN,NaN
11,0.500,Wild Pig,23-5,1,3,0,4,25.000,25.000
11,0.500,Pennington Creek Water,16-23,0,0,0,0,NaN,NaN
11,0.500,Pennington Creek Water,23-5,0,0,0,0,NaN,NaN
11,0.500,Guinni,16-23,0,0,0,0,NaN,NaN
11,0.500,Guinni,23-5,0,0,0,0,NaN,NaN
11,0.500,Racoon,16-23,0,0,0,0,NaN,NaN
11,0.500,Racoon,23-5,0,0,0,0,NaN,NaN
11,0.500,Hu,16-23,15,15,0,30,50.000,50.000
11,0.500,Hu,23-5,24,14,0,38,63.158,63.158
11,0.500,Cw and Dg,16-23,6,16,0,22,27.273,27.273
11,0.500,Cw and Dg,23-5,14,18,0,32,43.750,43.750
11,0.500,Red Wind Blackbird,16-23,0,0,0,0,NaN,NaN
11,0.500,Red Wind Blackbird,23-5,0,0,0,0,NaN,NaN
11,0.500,Tree Swallow,16-23,0,0,0,0,NaN,NaN
11,0.500,Tree Swallow,23-5,0,0,0,0,NaN,NaN
11,0.500,Turkey Vulture,16-23,0,0,0,0,NaN,NaN
11,0.500,Turkey Vulture,23-5,0,0,0,0,NaN,NaN
11,0.500,Dg,16-23,6,9,0,15,40.000,40.000
11,0.500,Dg,23-5,32,32,0,64,50.000,50.000
11,0.500,Western Kingbird,16-23,0,0,0,0,NaN,NaN
11,0.500,Western Kingbird,23-5,0,0,0,0,NaN,NaN
11,0.500,White Crowned Sparrow,16-23,0,0,0,0,NaN,NaN
11,0.500,White Crowned Sparrow,23-5,0,3,0,3,0.000,0.000
11,0.500,Eared Grebe,16-23,0,0,0,0,NaN,NaN
11,0.500,Eared Grebe,23-5,0,10,0,10,0.000,0.000
11,0.500,cougar,16-23,0,0,0,0,NaN,NaN
11,0.500,cougar,23-5,0,0,0,0,NaN,NaN
11,0.500,Ocean Water,16-23,0,0,0,0,NaN,NaN
11,0.500,Ocean Water,23-5,0,0,0,0,NaN,NaN
11,0.500,Red Tailed Hawk,16-23,0,0,0,0,NaN,NaN
11,0.500,Red Tailed Hawk,23-5,0,7,0,7,0.000,0.000
11,0.500,Dog,16-23,55,69,0,124,44.355,44.355
11,0.500,Dog,23-5,94,140,0,234,40.171,40.171
11,0.500,Human,16-23,1756,791,0,2547,68.944,68.944
11,0.500,Human,23-5,2185,637,0,2822,77.427,77.427
11,0.500,Wild Turkey,16-23,1,4,0,5,20.000,20.000
11,0.500,Wild Turkey,23-5,0,12,0,12,0.000,0.000
11,0.500,Clark Grebe,16-23,0,0,0,0,NaN,NaN
11,0.500,Clark Grebe,23-5,0,0,0,0,NaN,NaN
11,0.500,Seagull,16-23,0,0,0,0,NaN,NaN
11,0.500,Seagull,23-5,44,8,0,52,84.615,84.615
11,0.500,Surf Scoter,16-23,0,0,0,0,NaN,NaN
11,0.500,Surf Scoter,23-5,0,0,0,0,NaN,NaN
11,0.500,Pigeon,16-23,82,141,0,223,36.771,36.771
11,0.500,Pigeon,23-5,123,147,0,270,45.556,45.556
11,0.500,Pacific Ocean Water,16-23,0,0,0,0,NaN,NaN
11,0.500,Pacific Ocean Water,23-5,0,0,0,0,NaN,NaN
11,0.500,Cat,16-23,19,22,0,41,46.341,46.341
11,0.500,Cat,23-5,26,20,0,46,56.522,56.522
11,0.500,Horse,16-23,5,19,0,24,20.833,20.833
11,0.500,Horse,23-5,25,115,0,140,17.857,17.857
11,0.500,orangutan,16-23,0,0,0,0,NaN,NaN
11,0.500,orangutan,23-5,0,0,0,0,NaN,NaN
11,0.500,Bat,16-23,36,31,0,67,53.731,53.731
11,0.500,Bat,23-5,37,36,0,73,50.685,50.685
11,0.500,Deer,16-23,14,24,0,38,36.842,36.842
11,0.500,Deer,23-5,19,121,0,140,13.571,13.571
11,0.500,Great Horned Owl,16-23,0,0,0,0,NaN,NaN
11,0.500,Great Horned Owl,23-5,0,0,0,0,NaN,NaN
11,0.500,Freshwater Lagoon,16-23,0,0,0,0,NaN,NaN
11,0.500,Freshwater Lagoon,23-5,0,0,0,0,NaN,NaN
11,0.500,Unknown Avian,16-23,0,0,0,0,NaN,NaN
11,0.500,Unknown Avian,23-5,0,0,0,0,NaN,NaN
11,0.500,Human UTI,16-23,75,70,0,145,51.724,51.724
11,0.500,Human UTI,23-5,100,104,0,204,49.020,49.020
11,0.500,unknown,16-23,0,0,0,0,NaN,NaN
11,0.500,unknown,23-5,0,2,0,2,0.000,0.000
11,0.500,SLO Creek Water,16-23,0,0,0,0,NaN,NaN
11,0.500,SLO Creek Water,23-5,0,0,0,0,NaN,NaN
11,0.500,Pig/Swine,16-23,5,7,0,12,41.667,41.667
11,0.500,Pig/Swine,23-5,9,12,0,21,42.857,42.857
11,0.500,Klebsiella,16-23,0,0,0,0,NaN,NaN
11,0.500,Klebsiella,23-5,0,0,0,0,NaN,NaN
11,0.500,Hu Cw and Dg,16-23,7,11,0,18,38.889,38.889
11,0.500,Hu Cw and Dg,23-5,8,14,0,22,36.364,36.364
11,0.500,Ground Squirrel,16-23,87,53,0,140,62.143,62.143
11,0.500,Ground Squirrel,23-5,84,72,0,156,53.846,53.846
11,0.500,Opossum,16-23,0,0,0,0,NaN,NaN
11,0.500,Opossum,23-5,0,0,0,0,NaN,NaN
11,0.500,Cow,16-23,1575,1148,0,2723,57.841,57.841
11,0.500,Cow,23-5,1541,1505,0,3046,50.591,50.591
11,0.500,Deer Mouse,16-23,0,0,0,0,NaN,NaN
11,0.500,Deer Mouse,23-5,0,0,0,0,NaN,NaN
11,0.500,OVERALL,16-23,3820,2528,0,6348,60.176,60.176
11,0.500,OVERALL,23-5,4466,3144,0,7610,58.686,58.686
11,0.900,Chicken,16-23,0,1,0,1,0.000,0.000
11,0.900,Chicken,23-5,8,8,0,16,50.000,50.000
11,0.900,Sea Lion,16-23,0,0,0,0,NaN,NaN
11,0.900,Sea Lion,23-5,1,10,0,11,9.091,9.091
11,0.900,Hu and Cw,16-23,1,4,0,5,20.000,20.000
11,0.900,Hu and Cw,23-5,7,8,0,15,46.667,46.667
11,0.900,Sheep,16-23,47,51,0,98,47.959,47.959
11,0.900,Sheep,23-5,53,37,0,90,58.889,58.889
11,0.900,Hu and Dg,16-23,8,13,0,21,38.095,38.095
11,0.900,Hu and Dg,23-5,18,21,0,39,46.154,46.154
11,0.900,Common Loon,16-23,0,0,0,0,NaN,NaN
11,0.900,Common Loon,23-5,0,0,0,0,NaN,NaN
11,0.900,Red-Winged Blackbird,16-23,0,1,0,1,0.000,0.000
11,0.900,Red-Winged Blackbird,23-5,0,0,0,0,NaN,NaN
11,0.900,Cw,16-23,8,13,0,21,38.095,38.095
11,0.900,Cw,23-5,10,25,0,35,28.571,28.571
11,0.900,Cliff Sparrow,16-23,2,9,0,11,18.182,18.182
11,0.900,Cliff Sparrow,23-5,0,0,0,0,NaN,NaN
11,0.900,Pig,16-23,10,6,0,16,62.500,62.500
11,0.900,Pig,23-5,3,3,0,6,50.000,50.000
11,0.900,Barn Owl,16-23,0,0,0,0,NaN,NaN
11,0.900,Barn Owl,23-5,0,0,0,0,NaN,NaN
11,0.900,Wild Pig,16-23,0,0,0,0,NaN,NaN
11,0.900,Wild Pig,23-5,1,3,0,4,25.000,25.000
11,0.900,Pennington Creek Water,16-23,0,0,0,0,NaN,NaN
11,0.900,Pennington Creek Water,23-5,0,0,0,0,NaN,NaN
11,0.900,Guinni,16-23,0,0,0,0,NaN,NaN
11,0.900,Guinni,23-5,0,0,0,0,NaN,NaN
11,0.900,Racoon,16-23,0,0,0,0,NaN,NaN
11,0.900,Racoon,23-5,0,0,0,0,NaN,NaN
11,0.900,Hu,16-23,15,15,0,30,50.000,50.000
11,0.900,Hu,23-5,24,14,0,38,63.158,63.158
11,0.900,Cw and Dg,16-23,6,16,0,22,27.273,27.273
11,0.900,Cw and Dg,23-5,14,18,0,32,43.750,43.750
11,0.900,Red Wind Blackbird,16-23,0,0,0,0,NaN,NaN
11,0.900,Red Wind Blackbird,23-5,0,0,0,0,NaN,NaN
11,0.900,Tree Swallow,16-23,0,0,0,0,NaN,NaN
11,0.900,Tree Swallow,23-5,0,0,0,0,NaN,NaN
11,0.900,Turkey Vulture,16-23,0,0,0,0,NaN,NaN
11,0.900,Turkey Vulture,23-5,0,0,0,0,NaN,NaN
11,0.900,Dg,16-23,6,9,0,15,40.000,40.000
11,0.900,Dg,23-5,32,32,0,64,50.000,50.000
11,0.900,Western Kingbird,16-23,0,0,0,0,NaN,NaN
11,0.900,Western Kingbird,23-5,0,0,0,0,NaN,NaN
11,0.900,White Crowned Sparrow,16-23,0,0,0,0,NaN,NaN
11,0.900,White Crowned Sparrow,23-5,0,3,0,3,0.000,0.000
11,0.900,Eared Grebe,16-23,0,0,0,0,NaN,NaN
11,0.900,Eared Grebe,23-5,0,10,0,10,0.000,0.000
11,0.900,cougar,16-23,0,0,0,0,NaN,NaN
11,0.900,cougar,23-5,0,0,0,0,NaN,NaN
11,0.900,Ocean Water,16-23,0,0,0,0,NaN,NaN
11,0.900,Ocean Water,23-5,0,0,0,0,NaN,NaN
11,0.900,Red Tailed Hawk,16-23,0,0,0,0,NaN,NaN
11,0.900,Red Tailed Hawk,23-5,0,7,0,7,0.000,0.000
11,0.900,Dog,16-23,55,69,0,124,44.355,44.355
11,0.900,Dog,23-5,94,135,0,229,41.048,41.048
11,0.900,Human,16-23,1756,790,0,2546,68.971,68.971
11,0.900,Human,23-5,2185,633,0,2818,77.537,77.537
11,0.900,Wild Turkey,16-23,1,4,0,5,20.000,20.000
11,0.900,Wild Turkey,23-5,0,12,0,12,0.000,0.000
11,0.900,Clark Grebe,16-23,0,0,0,0,NaN,NaN
11,0.900,Clark Grebe,23-5,0,0,0,0,NaN,NaN
11,0.900,Seagull,16-23,0,0,0,0,NaN,NaN
11,0.900,Seagull,23-5,44,9,0,53,83.019,83.019
11,0.900,Surf Scoter,16-23,0,0,0,0,NaN,NaN
11,0.900,Surf Scoter,23-5,0,0,0,0,NaN,NaN
11,0.900,Pigeon,16-23,82,142,0,224,36.607,36.607
11,0.900,Pigeon,23-5,123,147,0,270,45.556,45.556
11,0.900,Pacific Ocean Water,16-23,0,0,0,0,NaN,NaN
11,0.900,Pacific Ocean Water,23-5,0,0,0,0,NaN,NaN
11,0.900,Cat,16-23,19,22,0,41,46.341,46.341
11,0.900,Cat,23-5,26,20,0,46,56.522,56.522
11,0.900,Horse,16-23,5,19,0,24,20.833,20.833
11,0.900,Horse,23-5,25,115,0,140,17.857,17.857
11,0.900,orangutan,16-23,0,0,0,0,NaN,NaN
11,0.900,orangutan,23-5,0,0,0,0,NaN,NaN
11,0.900,Bat,16-23,36,31,0,67,53.731,53.731
11,0.900,Bat,23-5,37,36,0,73,50.685,50.685
11,0.900,Deer,16-23,14,24,0,38,36.842,36.842
11,0.900,Deer,23-5,19,121,0,140,13.571,13.571
11,0.900,Great Horned Owl,16-23,0,0,0,0,NaN,NaN
11,0.900,Great Horned Owl,23-5,0,0,0,0,NaN,NaN
11,0.900,Freshwater Lagoon,16-23,0,0,0,0,NaN,NaN
11,0.900,Freshwater Lagoon,23-5,0,0,0,0,NaN,NaN
11,0.900,Unknown Avian,16-23,0,0,0,0,NaN,NaN
11,0.900,Unknown Avian,23-5,0,0,0,0,NaN,NaN
11,0.900,Human UTI,16-23,75,70,0,145,51.724,51.724
11,0.900,Human UTI,23-5,103,104,0,207,49.758,49.758
11,0.900,unknown,16-23,0,0,0,0,NaN,NaN
11,0.900,unknown,23-5,0,2,0,2,0.000,0.000
11,0.900,SLO Creek Water,16-23,0,0,0,0,NaN,NaN
11,0.900,SLO Creek Water,23-5,0,0,0,0,NaN,NaN
11,0.900,Pig/Swine,16-23,5,7,0,12,41.667,41.667
11,0.900,Pig/Swine,23-5,9,12,0,21,42.857,42.857
11,0.900,Klebsiella,16-23,0,0,0,0,NaN,NaN
11,0.900,Klebsiella,23-5,0,0,0,0,NaN,NaN
11,0.900,Hu Cw and Dg,16-23,7,11,0,18,38.889,38.889
11,0.900,Hu Cw and Dg,23-5,8,14,0,22,36.364,36.364
11,0.900,Ground Squirrel,16-23,87,53,0,140,62.143,62.143
11,0.900,Ground Squirrel,23-5,84,72,0,156,53.846,53.846
11,0.900,Opossum,16-23,0,0,0,0,NaN,NaN
11,0.900,Opossum,23-5,0,0,0,0,NaN,NaN
11,0.900,Cow,16-23,1575,1144,0,2719,57.926,57.926
11,0.900,Cow,23-5,1541,1502,0,3043,50.641,50.641
11,0.900,Deer Mouse,16-23,0,0,0,0,NaN,NaN
11,0.900,Deer Mouse,23-5,0,0,0,0,NaN,NaN
11,0.900,OVERALL,16-23,3820,2524,0,6344,60.214,60.214
11,0.900,OVERALL,23-5,4469,3133,0,7602,58.787,58.787
11,0.950,Chicken,16-23,0,1,0,1,0.000,0.000
11,0.950,Chicken,23-5,8,8,0,16,50.000,50.000
11,0.950,Sea Lion,16-23,0,0,0,0,NaN,NaN
11,0.950,Sea Lion,23-5,1,10,0,11,9.091,9.091
11,0.950,Hu and Cw,16-23,1,4,0,5,20.000,20.000
11,0.950,Hu and Cw,23-5,7,8,0,15,46.667,46.667
11,0.950,Sheep,16-23,47,51,0,98,47.959,47.959
11,0.950,Sheep,23-5,53,37,0,90,58.889,58.889
11,0.950,Hu and Dg,16-23,8,13,0,21,38.095,38.095
11,0.950,Hu and Dg,23-5,18,21,0,39,46.154,46.154
11,0.950,Common Loon,16-23,0,0,0,0,NaN,NaN
11,0.950,Common Loon,23-5,0,0,0,0,NaN,NaN
11,0.950,Red-Winged Blackbird,16-23,0,1,0,1,0.000,0.000
11,0.950,Red-Winged Blackbird,23-5,0,0,0,0,NaN,NaN
11,0.950,Cw,16-23,8,13,0,21,38.095,38.095
11,0.950,Cw,23-5,10,25,0,35,28.571,28.571
11,0.950,Cliff Sparrow,16-23,2,9,0,11,18.182,18.182
11,0.950,Cliff Sparrow,23-5,0,0,0,0,NaN,NaN
11,0.950,Pig,16-23,10,6,0,16,62.500,62.500
11,0.950,Pig,23-5,3,3,0,6,50.000,50.000
11,0.950,Barn Owl,16-23,0,0,0,0,NaN,NaN
11,0.950,Barn Owl,23-5,0,0,0,0,NaN,NaN
11,0.950,Wild Pig,16-23,0,0,0,0,NaN,NaN
11,0.950,Wild Pig,23-5,1,3,0,4,25.000,25.000
11,0.950,Pennington Creek Water,16-23,0,0,0,0,NaN,NaN
11,0.950,Pennington Creek Water,23-5,0,0,0,0,NaN,NaN
11,0.950,Guinni,16-23,0,0,0,0,NaN,NaN
11,0.950,Guinni,23-5,0,0,0,0,NaN,NaN
11,0.950,Racoon,16-23,0,0,0,0,NaN,NaN
11,0.950,Racoon,23-5,0,0,0,0,NaN,NaN
11,0.950,Hu,16-23,15,15,0,30,50.000,50.000
11,0.950,Hu,23-5,24,14,0,38,63.158,63.158
11,0.950,Cw and Dg,16-23,6,16,0,22,27.273,27.273
11,0.950,Cw and Dg,23-5,14,18,0,32,43.750,43.750
11,0.950,Red Wind Blackbird,16-23,0,0,0,0,NaN,NaN
11,0.950,Red Wind Blackbird,23-5,0,0,0,0,NaN,NaN
11,0.950,Tree Swallow,16-23,0,0,0,0,NaN,NaN
11,0.950,Tree Swallow,23-5,0,0,0,0,NaN,NaN
11,0.950,Turkey Vulture,16-23,0,0,0,0,NaN,NaN
11,0.950,Turkey Vulture,23-5,0,0,0,0,NaN,NaN
11,0.950,Dg,16-23,6,9,0,15,40.000,40.000
11,0.950,Dg,23-5,32,32,0,64,50.000,50.000
11,0.950,Western Kingbird,16-23,0,0,0,0,NaN,NaN
11,0.950,Western Kingbird,23-5,0,0,0,0,NaN,NaN
11,0.950,White Crowned Sparrow,16-23,0,0,0,0,NaN,NaN
11,0.950,White Crowned Sparrow,23-5,0,3,0,3,0.000,0.000
11,0.950,Eared Grebe,16-23,0,0,0,0,NaN,NaN
11,0.950,Eared Grebe,23-5,0,10,0,10,0.000,0.000
11,0.950,cougar,16-23,0,0,0,0,NaN,NaN
11,0.950,cougar,23-5,0,0,0,0,NaN,NaN
11,0.950,Ocean Water,16-23,0,0,0,0,NaN,NaN
11,0.950,Ocean Water,23-5,0,0,0,0,NaN,NaN
11,0.950,Red Tailed Hawk,16-23,0,0,0,0,NaN,NaN
11,0.950,Red Tailed Hawk,23-5,0,7,0,7,0.000,0.000
11,0.950,Dog,16-23,55,69,0,124,44.355,44.355
11,0.950,Dog,23-5,94,133,0,227,41.410,41.410
11,0.950,Human,16-23,1756,788,0,2544,69.025,69.025
11,0.950,Human,23-5,2187,626,0,2813,77.746,77.746
11,0.950,Wild Turkey,16-23,1,4,0,5,20.000,20.000
11,0.950,Wild Turkey,23-5,0,11,0,11,0.000,0.000
11,0.950,Clark Grebe,16-23,0,0,0,0,NaN,NaN
11,0.950,Clark Grebe,23-5,0,0,0,0,NaN,NaN
11,0.950,Seagull,16-23,0,0,0,0,NaN,NaN
11,0.950,Seagull,23-5,44,8,0,52,84.615,84.615
11,0.950,Surf Scoter,16-23,0,0,0,0,NaN,NaN
11,0.950,Surf Scoter,23-5,0,0,0,0,NaN,NaN
11,0.950,Pigeon,16-23,83,141,0,224,37.054,37.054
11,0.950,Pigeon,23-5,123,148,0,271,45.387,45.387
11,0.950,Pacific Ocean Water,16-23,0,0,0,0,NaN,NaN
11,0.950,Pacific Ocean Water,23-5,0,0,0,0,NaN,NaN
11,0.950,Cat,16-23,19,22,0,41,46.341,46.341
11,0.950,Cat,23-5,26,20,0,46,56.522,56.522
11,0.950,Horse,16-23,5,19,0,24,20.833,20.833
11,0.950,Horse,23-5,25,115,0,140,17.857,17.857
11,0.950,orangutan,16-23,0,0,0,0,NaN,NaN
11,0.950,orangutan,23-5,0,0,0,0,NaN,NaN
11,0.950,Bat,16-23,36,31,0,67,53.731,53.731
11,0.950,Bat,23-5,37,35,0,72,51.389,51.389
11,0.950,Deer,16-23,14,24,0,38,36.842,36.842
11,0.950,Deer,23-5,19,121,0,140,13.571,13.571
11,0.950,Great Horned Owl,16-23,0,0,0,0,NaN,NaN
11,0.950,Great Horned Owl,23-5,0,0,0,0,NaN,NaN
11,0.950,Freshwater Lagoon,16-23,0,0,0,0,NaN,NaN
11,0.950,Freshwater Lagoon,23-5,0,0,0,0,NaN,NaN
11,0.950,Unknown Avian,16-23,0,0,0,0,NaN,NaN
11,0.950,Unknown Avian,23-5,0,0,0,0,NaN,NaN
11,0.950,Human UTI,16-23,78,71,0,149,52.349,52.349
11,0.950,Human UTI,23-5,102,106,0,208,49.038,49.038
11,0.950,unknown,16-23,0,0,0,0,NaN,NaN
11,0.950,unknown,23-5,0,2,0,2,0.000,0.000
11,0.950,SLO Creek Water,16-23,0,0,0,0,NaN,NaN
11,0.950,SLO Creek Water,23-5,0,0,0,0,NaN,NaN
11,0.950,Pig/Swine,16-23,5,7,0,12,41.667,41.667
11,0.950,Pig/Swine,23-5,9,12,0,21,42.857,42.857
11,0.950,Klebsiella,16-23,0,0,0,0,NaN,NaN
11,0.950,Klebsiella,23-5,0,0,0,0,NaN,NaN
11,0.950,Hu Cw and Dg,16-23,7,11,0,18,38.889,38.889
11,0.950,Hu Cw and Dg,23-5,8,14,0,22,36.364,36.364
11,0.950,Ground Squirrel,16-23,87,53,0,140,62.143,62.143
11,0.950,Ground Squirrel,23-5,84,71,0,155,54.194,54.194
11,0.950,Opossum,16-23,0,0,0,0,NaN,NaN
11,0.950,Opossum,23-5,0,0,0,0,NaN,NaN
11,0.950,Cow,16-23,1576,1124,0,2700,58.370,58.370
11,0.950,Cow,23-5,1540,1500,0,3040,50.658,50.658
11,0.950,Deer Mouse,16-23,0,0,0,0,NaN,NaN
11,0.950,Deer Mouse,23-5,0,0,0,0,NaN,NaN
11,0.950,OVERALL,16-23,3825,2502,0,6327,60.455,60.455
11,0.950,OVERALL,23-5,4469,3121,0,7590,58.880,58.880
11,0.960,Chicken,16-23,0,1,0,1,0.000,0.000
11,0.960,Chicken,23-5,8,8,0,16,50.000,50.000
11,0.960,Sea Lion,16-23,0,0,0,0,NaN,NaN
11,0.960,Sea Lion,23-5,1,10,0,11,9.091,9.091
11,0.960,Hu and Cw,16-23,1,4,0,5,20.000,20.000
11,0.960,Hu and Cw,23-5,7,8,0,15,46.667,46.667
11,0.960,Sheep,16-23,47,51,0,98,47.959,47.959
11,0.960,Sheep,23-5,53,38,0,91,58.242,58.242
11,0.960,Hu and Dg,16-23,8,13,0,21,38.095,38.095
11,0.960,Hu and Dg,23-5,18,21,0,39,46.154,46.154
11,0.960,Common Loon,16-23,0,0,0,0,NaN,NaN
11,0.960,Common Loon,23-5,0,0,0,0,NaN,NaN
11,0.960,Red-Winged Blackbird,16-23,0,1,0,1,0.000,0.000
11,0.960,Red-Winged Blackbird,23-5,0,0,0,0,NaN,NaN
11,0.960,Cw,16-23,8,13,0,21,38.095,38.095
11,0.960,Cw,23-5,10,25,0,35,28.571,28.571
11,0.960,Cliff Sparrow,16-23,2,9,0,11,18.182,18.182
11,0.960,Cliff Sparrow,23-5,0,0,0,0,NaN,NaN
11,0.960,Pig,16-23,10,6,0,16,62.500,62.500
11,0.960,Pig,23-5,3,3,0,6,50.000,50.000
11,0.960,Barn Owl,16-23,0,0,0,0,NaN,NaN
11,0.960,Barn Owl,23-5,0,0,0,0,NaN,NaN
11,0.960,Wild Pig,16-23,0,0,0,0,NaN,NaN
11,0.960,Wild Pig,23-5,1,3,0,4,25.000,25.000
11,0.960,Pennington Creek Water,16-23,0,0,0,0,NaN,NaN
11,0.960,Pennington Creek Water,23-5,0,0,0,0,NaN,NaN
11,0.960,Guinni,16-23,0,0,0,0,NaN,NaN
11,0.960,Guinni,23-5,0,0,0,0,NaN,NaN
11,0.960,Racoon,16-23,0,0,0,0,NaN,NaN
11,0.960,Racoon,23-5,0,0,0,0,NaN,NaN
11,0.960,Hu,16-23,15,15,0,30,50.000,50.000
11,0.960,Hu,23-5,24,14,0,38,63.158,63.158
11,0.960,Cw and Dg,16-23,6,16,0,22,27.273,27.273
11,0.960,Cw and Dg,23-5,14,18,0,32,43.750,43.750
11,0.960,Red Wind Blackbird,16-23,0,0,0,0,NaN,NaN
11,0.960,Red Wind Blackbird,23-5,0,0,0,0,NaN,NaN
11,0.960,Tree Swallow,16-23,0,0,0,0,NaN,NaN
11,0.960,Tree Swallow,23-5,0,0,0,0,NaN,NaN
11,0.960,Turkey Vulture,16-23,0,0,0,0,NaN,NaN
11,0.960,Turkey Vulture,23-5,0,0,0,0,NaN,NaN
11,0.960,Dg,16-23,6,9,0,15,40.000,40.000
11,0.960,Dg,23-5,32,32,0,64,50.000,50.000
11,0.960,Western Kingbird,16-23,0,0,0,0,NaN,NaN
11,0.960,Western Kingbird,23-5,0,0,0,0,NaN,NaN
11,0.960,White Crowned Sparrow,16-23,0,0,0,0,NaN,NaN
11,0.960,White Crowned Sparrow,23-5,0,3,0,3,0.000,0.000
11,0.960,Eared Grebe,16-23,0,0,0,0,NaN,NaN
11,0.960,Eared Grebe,23-5,0,10,0,10,0.000,0.000
11,0.960,cougar,16-23,0,0,0,0,NaN,NaN
11,0.960,cougar,23-5,0,0,0,0,NaN,NaN
11,0.960,Ocean Water,16-23,0,0,0,0,NaN,NaN
11,0.960,Ocean Water,23-5,0,0,0,0,NaN,NaN
11,0.960,Red Tailed Hawk,16-23,0,0,0,0,NaN,NaN
11,0.960,Red Tailed Hawk,23-5,0,7,0,7,0.000,0.000
11,0.960,Dog,16-23,55,69,0,124,44.355,44.355
11,0.960,Dog,23-5,94,128,0,222,42.342,42.342
11,0.960,Human,16-23,1758,786,0,2544,69.104,69.104
11,0.960,Human,23-5,2187,612,0,2799,78.135,78.135
11,0.960,Wild Turkey,16-23,1,4,0,5,20.000,20.000
11,0.960,Wild Turkey,23-5,0,15,0,15,0.000,0.000
11,0.960,Clark Grebe,16-23,0,0,0,0,NaN,NaN
11,0.960,Clark Grebe,23-5,0,0,0,0,NaN,NaN
11,0.960,Seagull,16-23,0,0,0,0,NaN,NaN
11,0.960,Seagull,23-5,44,9,0,53,83.019,83.019
11,0.960,Surf Scoter,16-23,0,0,0,0,NaN,NaN
11,0.960,Surf Scoter,23-5,0,2,0,2,0.000,0.000
11,0.960,Pigeon,16-23,82,141,0,223,36.771,36.771
11,0.960,Pigeon,23-5,124,162,0,286,43.357,43.357
11,0.960,Pacific Ocean Water,16-23,0,0,0,0,NaN,NaN
11,0.960,Pacific Ocean Water,23-5,0,0,0,0,NaN,NaN
11,0.960,Cat,16-23,19,22,0,41,46.341,46.341
11,0.960,Cat,23-5,26,21,0,47,55.319,55.319
11,0.960,Horse,16-23,5,19,0,24,20.833,20.833
11,0.960,Horse,23-5,25,115,0,140,17.857,17.857
11,0.960,orangutan,16-23,0,0,0,0,NaN,NaN
11,0.960,orangutan,23-5,0,0,0,0,NaN,NaN
11,0.960,Bat,16-23,36,31,0,67,53.731,53.731
11,0.960,Bat,23-5,37,35,0,72,51.389,51.389
11,0.960,Deer,16-23,14,24,0,38,36.842,36.842
11,0.960,Deer,23-5,19,121,0,140,13.571,13.571
11,0.960,Great Horned Owl,16-23,0,0,0,0,NaN,NaN
11,0.960,Great Horned Owl,23-5,0,0,0,0,NaN,NaN
11,0.960,Freshwater Lagoon,16-23,0,0,0,0,NaN,NaN
11,0.960,Freshwater Lagoon,23-5,0,0,0,0,NaN,NaN
11,0.960,Unknown Avian,16-23,0,0,0,0,NaN,NaN
11,0.960,Unknown Avian,23-5,0,0,0,0,NaN,NaN
11,0.960,Human UTI,16-23,78,72,0,150,52.000,52.000
11,0.960,Human UTI,23-5,102,105,0,207,49.275,49.275
11,0.960,unknown,16-23,0,0,0,0,NaN,NaN
11,0.960,unknown,23-5,0,2,0,2,0.000,0.000
11,0.960,SLO Creek Water,16-23,0,0,0,0,NaN,NaN
11,0.960,SLO Creek Water,23-5,0,0,0,0,NaN,NaN
11,0.960,Pig/Swine,16-23,5,7,0,12,41.667,41.667
11,0.960,Pig/Swine,23-5,9,12,0,21,42.857,42.857
11,0.960,Klebsiella,16-23,0,0,0,0,NaN,NaN
11,0.960,Klebsiella,23-5,0,0,0,0,NaN,NaN
11,0.960,Hu Cw and Dg,16-23,7,11,0,18,38.889,38.889
11,0.960,Hu Cw and Dg,23-5,8,14,0,22,36.364,36.364
11,0.960,Ground Squirrel,16-23,87,53,0,140,62.143,62.143
11,0.960,Ground Squirrel,23-5,84,73,0,157,53.503,53.503
11,0.960,Opossum,16-23,0,0,0,0,NaN,NaN
11,0.960,Opossum,23-5,0,0,0,0,NaN,NaN
11,0.960,Cow,16-23,1574,1115,0,2689,58.535,58.535
11,0.960,Cow,23-5,1540,1484,0,3024,50.926,50.926
11,0.960,Deer Mouse,16-23,0,0,0,0,NaN,NaN
11,0.960,Deer Mouse,23-5,0,0,0,0,NaN,NaN
11,0.960,OVERALL,16-23,3824,2492,0,6316,60.545,60.545
11,0.960,OVERALL,23-5,4470,3110,0,7580,58.971,58.971
11,0.970,Chicken,16-23,0,1,0,1,0.000,0.000
11,0.970,Chicken,23-5,8,8,0,16,50.000,50.000
11,0.970,Sea Lion,16-23,0,0,0,0,NaN,NaN
11,0.970,Sea Lion,23-5,1,10,0,11,9.091,9.091
11,0.970,Hu and Cw,16-23,1,4,0,5,20.000,20.000
11,0.970,Hu and Cw,23-5,7,8,0,15,46.667,46.667
11,0.970,Sheep,16-23,48,52,0,100,48.000,48.000
11,0.970,Sheep,23-5,53,37,0,90,58.889,58.889
11,0.970,Hu and Dg,16-23,8,13,0,21,38.095,38.095
11,0.970,Hu and Dg,23-5,18,21,0,39,46.154,46.154
11,0.970,Common Loon,16-23,0,0,0,0,NaN,NaN
11,0.970,Common Loon,23-5,0,0,0,0,NaN,NaN
11,0.970,Red-Winged Blackbird,16-23,0,1,0,1,0.000,0.000
11,0.970,Red-Winged Blackbird,23-5,0,0,0,0,NaN,NaN
11,0.970,Cw,16-23,8,14,0,22,36.364,36.364
11,0.970,Cw,23-5,10,25,0,35,28.571,28.571
11,0.970,Cliff Sparrow,16-23,2,9,0,11,18.182,18.182
11,0.970,Cliff Sparrow,23-5,0,0,0,0,NaN,NaN
11,0.970,Pig,16-23,10,6,0,16,62.500,62.500
11,0.970,Pig,23-5,3,3,0,6,50.000,50.000
11,0.970,Barn Owl,16-23,0,0,0,0,NaN,NaN
11,0.970,Barn Owl,23-5,0,0,0,0,NaN,NaN
11,0.970,Wild Pig,16-23,0,0,0,0,NaN,NaN
11,0.970,Wild Pig,23-5,0,3,0,3,0.000,0.000
11,0.970,Pennington Creek Water,16-23,0,0,0,0,NaN,NaN
11,0.970,Pennington Creek Water,23-5,0,0,0,0,NaN,NaN
11,0.970,Guinni,16-23,0,0,0,0,NaN,NaN
11,0.970,Guinni,23-5,0,0,0,0,NaN,NaN
11,0.970,Racoon,16-23,0,0,0,0,NaN,NaN
11,0.970,Racoon,23-5,0,0,0,0,NaN,NaN
11,0.970,Hu,16-23,15,15,0,30,50.000,50.000
11,0.970,Hu,23-5,24,14,0,38,63.158,63.158
11,0.970,Cw and Dg,16-23,6,16,0,22,27.273,27.273
11,0.970,Cw and Dg,23-5,14,18,0,32,43.750,43.750
11,0.970,Red Wind Blackbird,16-23,0,0,0,0,NaN,NaN
11,0.970,Red Wind Blackbird,23-5,0,0,0,0,NaN,NaN
11,0.970,Tree Swallow,16-23,0,0,0,0,NaN,NaN
11,0.970,Tree Swallow,23-5,0,0,0,0,NaN,NaN
11,0.970,Turkey Vulture,16-23,0,0,0,0,NaN,NaN
11,0.970,Turkey Vulture,23-5,0,0,0,0,NaN,NaN
11,0.970,Dg,16-23,6,9,0,15,40.000,40.000
11,0.970,Dg,23-5,32,31,0,63,50.794,50.794
11,0.970,Western Kingbird,16-23,0,0,0,0,NaN,NaN
11,0.970,Western Kingbird,23-5,0,0,0,0,NaN,NaN
11,0.970,White Crowned Sparrow,16-23,0,0,0,0,NaN,NaN
11,0.970,White Crowned Sparrow,23-5,0,3,0,3,0.000,0.000
11,0.970,Eared Grebe,16-23,0,0,0,0,NaN,NaN
11,0.970,Eared Grebe,23-5,0,10,0,10,0.000,0.000
11,0.970,cougar,16-23,0,0,0,0,NaN,NaN
11,0.970,cougar,23-5,0,0,0,0,NaN,NaN
11,0.970,Ocean Water,16-23,0,0,0,0,NaN,NaN
11,0.970,Ocean Water,23-5,0,0,0,0,NaN,NaN
11,0.970,Red Tailed Hawk,16-23,0,0,0,0,NaN,NaN
11,0.970,Red Tailed Hawk,23-5,0,7,0,7,0.000,0.000
11,0.970,Dog,16-23,55,69,0,124,44.355,44.355
11,0.970,Dog,23-5,94,126,0,220,42.727,42.727
11,0.970,Human,16-23,1757,784,0,2541,69.146,69.146
11,0.970,Human,23-5,2185,612,0,2797,78.119,78.119
11,0.970,Wild Turkey,16-23,1,6,0,7,14.286,14.286
11,0.970,Wild Turkey,23-5,2,15,0,17,11.765,11.765
11,0.970,Clark Grebe,16-23,0,0,0,0,NaN,NaN
11,0.970,Clark Grebe,23-5,0,0,0,0,NaN,NaN
11,0.970,Seagull,16-23,0,0,0,0,NaN,NaN
11,0.970,Seagull,23-5,44,10,0,54,81.481,81.481
11,0.970,Surf Scoter,16-23,0,0,0,0,NaN,NaN
11,0.970,Surf Scoter,23-5,0,2,0,2,0.000,0.000
11,0.970,Pigeon,16-23,80,140,0,220,36.364,36.364
11,0.970,Pigeon,23-5,124,179,0,303,40.924,40.924
11,0.970,Pacific Ocean Water,16-23,0,0,0,0,NaN,NaN
11,0.970,Pacific Ocean Water,23-5,0,0,0,0,NaN,NaN
11,0.970,Cat,16-23,19,22,0,41,46.341,46.341
11,0.970,Cat,23-5,26,21,0,47,55.319,55.319
11,0.970,Horse,16-23,5,19,0,24,20.833,20.833
11,0.970,Horse,23-5,25,116,0,141,17.730,17.730
11,0.970,orangutan,16-23,0,0,0,0,NaN,NaN
11,0.970,orangutan,23-5,0,0,0,0,NaN,NaN
11,0.970,Bat,16-23,36,31,0,67,53.731,53.731
11,0.970,Bat,23-5,37,35,0,72,51.389,51.389
11,0.970,Deer,16-23,14,24,0,38,36.842,36.842
11,0.970,Deer,23-5,19,121,0,140,13.571,13.571
11,0.970,Great Horned Owl,16-23,0,0,0,0,NaN,NaN
11,0.970,Great Horned Owl,23-5,0,0,0,0,NaN,NaN
11,0.970,Freshwater Lagoon,16-23,0,0,0,0,NaN,NaN
11,0.970,Freshwater Lagoon,23-5,0,0,0,0,NaN,NaN
11,0.970,Unknown Avian,16-23,0,0,0,0,NaN,NaN
11,0.970,Unknown Avian,23-5,0,0,0,0,NaN,NaN
11,0.970,Human UTI,16-23,78,73,0,151,51.656,51.656
11,0.970,Human UTI,23-5,101,105,0,206,49.029,49.029
11,0.970,unknown,16-23,0,0,0,0,NaN,NaN
11,0.970,unknown,23-5,0,2,0,2,0.000,0.000
11,0.970,SLO Creek Water,16-23,0,0,0,0,NaN,NaN
11,0.970,SLO Creek Water,23-5,0,0,0,0,NaN,NaN
11,0.970,Pig/Swine,16-23,5,7,0,12,41.667,41.667
11,0.970,Pig/Swine,23-5,9,12,0,21,42.857,42.857
11,0.970,Klebsiella,16-23,0,0,0,0,NaN,NaN
11,0.970,Klebsiella,23-5,0,0,0,0,NaN,NaN
11,0.970,Hu Cw and Dg,16-23,7,11,0,18,38.889,38.889
11,0.970,Hu Cw and Dg,23-5,8,14,0,22,36.364,36.364
11,0.970,Ground Squirrel,16-23,87,51,0,138,63.043,63.043
11,0.970,Ground Squirrel,23-5,84,71,0,155,54.194,54.194
11,0.970,Opossum,16-23,0,0,0,0,NaN,NaN
11,0.970,Opossum,23-5,0,0,0,0,NaN,NaN
11,0.970,Cow,16-23,1568,1113,0,2681,58.486,58.486
11,0.970,Cow,23-5,1537,1457,0,2994,51.336,51.336
11,0.970,Deer Mouse,16-23,0,0,0,0,NaN,NaN
11,0.970,Deer Mouse,23-5,0,0,0,0,NaN,NaN
11,0.970,OVERALL,16-23,3816,2490,0,6306,60.514,60.514
11,0.970,OVERALL,23-5,4465,3096,0,7561,59.053,59.053
11,0.980,Chicken,16-23,0,1,0,1,0.000,0.000
11,0.980,Chicken,23-5,9,8,0,17,52.941,52.941
11,0.980,Sea Lion,16-23,0,0,0,0,NaN,NaN
11,0.980,Sea Lion,23-5,1,9,0,10,10.000,10.000
11,0.980,Hu and Cw,16-23,1,4,0,5,20.000,20.000
11,0.980,Hu and Cw,23-5,7,18,0,25,28.000,28.000
11,0.980,Sheep,16-23,50,50,0,100,50.000,50.000
11,0.980,Sheep,23-5,52,36,0,88,59.091,59.091
11,0.980,Hu and Dg,16-23,8,12,0,20,40.000,40.000
11,0.980,Hu and Dg,23-5,18,18,0,36,50.000,50.000
11,0.980,Common Loon,16-23,0,0,0,0,NaN,NaN
11,0.980,Common Loon,23-5,0,0,0,0,NaN,NaN
11,0.980,Red-Winged Blackbird,16-23,0,1,0,1,0.000,0.000
11,0.980,Red-Winged Blackbird,23-5,0,0,0,0,NaN,NaN
11,0.980,Cw,16-23,8,13,0,21,38.095,38.095
11,0.980,Cw,23-5,10,26,0,36,27.778,27.778
11,0.980,Cliff Sparrow,16-23,2,9,0,11,18.182,18.182
11,0.980,Cliff Sparrow,23-5,0,0,0,0,NaN,NaN
11,0.980,Pig,16-23,10,6,0,16,62.500,62.500
11,0.980,Pig,23-5,3,3,0,6,50.000,50.000
11,0.980,Barn Owl,16-23,0,0,0,0,NaN,NaN
11,0.980,Barn Owl,23-5,0,0,0,0,NaN,NaN
11,0.980,Wild Pig,16-23,0,0,0,0,NaN,NaN
11,0.980,Wild Pig,23-5,0,3,0,3,0.000,0.000
11,0.980,Pennington Creek Water,16-23,0,0,0,0,NaN,NaN
11,0.980,Pennington Creek Water,23-5,0,0,0,0,NaN,NaN
11,0.980,Guinni,16-23,0,0,0,0,NaN,NaN
11,0.980,Guinni,23-5,0,0,0,0,NaN,NaN
11,0.980,Racoon,16-23,0,0,0,0,NaN,NaN
11,0.980,Racoon,23-5,0,0,0,0,NaN,NaN
11,0.980,Hu,16-23,15,15,0,30,50.000,50.000
11,0.980,Hu,23-5,24,15,0,39,61.538,61.538
11,0.980,Cw and Dg,16-23,6,16,0,22,27.273,27.273
11,0.980,Cw and Dg,23-5,14,19,0,33,42.424,42.424
11,0.980,Red Wind Blackbird,16-23,0,0,0,0,NaN,NaN
11,0.980,Red Wind Blackbird,23-5,0,0,0,0,NaN,NaN
11,0.980,Tree Swallow,16-23,0,0,0,0,NaN,NaN
11,0.980,Tree Swallow,23-5,0,0,0,0,NaN,NaN
11,0.980,Turkey Vulture,16-23,0,0,0,0,NaN,NaN
11,0.980,Turkey Vulture,23-5,0,0,0,0,NaN,NaN
11,0.980,Dg,16-23,6,9,0,15,40.000,40.000
11,0.980,Dg,23-5,32,24,0,56,57.143,57.143
11,0.980,Western Kingbird,16-23,0,0,0,0,NaN,NaN
11,0.980,Western Kingbird,23-5,0,0,0,0,NaN,NaN
11,0.980,White Crowned Sparrow,16-23,0,0,0,0,NaN,NaN
11,0.980,White Crowned Sparrow,23-5,0,4,0,4,0.000,0.000
11,0.980,Eared Grebe,16-23,0,0,0,0,NaN,NaN
11,0.980,Eared Grebe,23-5,0,10,0,10,0.000,0.000
11,0.980,cougar,16-23,0,0,0,0,NaN,NaN
11,0.980,cougar,23-5,0,0,0,0,NaN,NaN
11,0.980,Ocean Water,16-23,0,0,0,0,NaN,NaN
11,0.980,Ocean Water,23-5,0,0,0,0,NaN,NaN
11,0.980,Red Tailed Hawk,16-23,0,0,0,0,NaN,NaN
11,0.980,Red Tailed Hawk,23-5,0,6,0,6,0.000,0.000
11,0.980,Dog,16-23,54,73,0,127,42.520,42.520
11,0.980,Dog,23-5,94,123,0,217,43.318,43.318
11,0.980,Human,16-23,1761,772,0,2533,69.522,69.522
11,0.980,Human,23-5,2187,598,0,2785,78.528,78.528
11,0.980,Wild Turkey,16-23,1,6,0,7,14.286,14.286
11,0.980,Wild Turkey,23-5,4,23,0,27,14.815,14.815
11,0.980,Clark Grebe,16-23,0,0,0,0,NaN,NaN
11,0.980,Clark Grebe,23-5,0,0,0,0,NaN,NaN
11,0.980,Seagull,16-23,0,0,0,0,NaN,NaN
11,0.980,Seagull,23-5,46,8,0,54,85.185,85.185
11,0.980,Surf Scoter,16-23,0,0,0,0,NaN,NaN
11,0.980,Surf Scoter,23-5,2,0,0,2,100.000,100.000
11,0.980,Pigeon,16-23,80,137,0,217,36.866,36.866
11,0.980,Pigeon,23-5,123,186,0,309,39.806,39.806
11,0.980,Pacific Ocean Water,16-23,0,0,0,0,NaN,NaN
11,0.980,Pacific Ocean Water,23-5,0,0,0,0,NaN,NaN
11,0.980,Cat,16-23,19,22,0,41,46.341,46.341
11,0.980,Cat,23-5,28,20,0,48,58.333,58.333
11,0.980,Horse,16-23,5,19,0,24,20.833,20.833
11,0.980,Horse,23-5,25,113,0,138,18.116,18.116
11,0.980,orangutan,16-23,0,0,0,0,NaN,NaN
11,0.980,orangutan,23-5,0,0,0,0,NaN,NaN
11,0.980,Bat,16-23,36,31,0,67,53.731,53.731
11,0.980,Bat,23-5,37,34,0,71,52.113,52.113
11,0.980,Deer,16-23,14,24,0,38,36.842,36.842
11,0.980,Deer,23-5,19,121,0,140,13.571,13.571
11,0.980,Great Horned Owl,16-23,0,0,0,0,NaN,NaN
11,0.980,Great Horned Owl,23-5,0,0,0,0,NaN,NaN
11,0.980,Freshwater Lagoon,16-23,0,0,0,0,NaN,NaN
11,0.980,Freshwater Lagoon,23-5,0,0,0,0,NaN,NaN
11,0.980,Unknown Avian,16-23,0,0,0,0,NaN,NaN
11,0.980,Unknown Avian,23-5,0,0,0,0,NaN,NaN
11,0.980,Human UTI,16-23,78,76,0,154,50.649,50.649
11,0.980,Human UTI,23-5,101,104,0,205,49.268,49.268
11,0.980,unknown,16-23,0,0,0,0,NaN,NaN
11,0.980,unknown,23-5,0,3,0,3,0.000,0.000
11,0.980,SLO Creek Water,16-23,0,0,0,0,NaN,NaN
11,0.980,SLO Creek Water,23-5,0,0,0,0,NaN,NaN
11,0.980,Pig/Swine,16-23,5,7,0,12,41.667,41.667
11,0.980,Pig/Swine,23-5,9,12,0,21,42.857,42.857
11,0.980,Klebsiella,16-23,0,0,0,0,NaN,NaN
11,0.980,Klebsiella,23-5,0,0,0,0,NaN,NaN
11,0.980,Hu Cw and Dg,16-23,7,11,0,18,38.889,38.889
11,0.980,Hu Cw and Dg,23-5,8,13,0,21,38.095,38.095
11,0.980,Ground Squirrel,16-23,90,53,0,143,62.937,62.937
11,0.980,Ground Squirrel,23-5,85,69,0,154,55.195,55.195
11,0.980,Opossum,16-23,0,0,0,0,NaN,NaN
11,0.980,Opossum,23-5,0,0,0,0,NaN,NaN
11,0.980,Cow,16-23,1562,1093,0,2655,58.832,58.832
11,0.980,Cow,23-5,1531,1427,0,2958,51.758,51.758
11,0.980,Deer Mouse,16-23,0,0,0,0,NaN,NaN
11,0.980,Deer Mouse,23-5,0,0,0,0,NaN,NaN
11,0.980,OVERALL,16-23,3818,2460,0,6278,60.816,60.816
11,0.980,OVERALL,23-5,4469,3053,0,7522,59.412,59.412
11,0.990,Chicken,16-23,2,6,0,8,25.000,25.000
11,0.990,Chicken,23-5,10,8,0,18,55.556,55.556
11,0.990,Sea Lion,16-23,0,0,0,0,NaN,NaN
11,0.990,Sea Lion,23-5,4,6,0,10,40.000,40.000
11,0.990,Hu and Cw,16-23,2,4,0,6,33.333,33.333
11,0.990,Hu and Cw,23-5,9,25,0,34,26.471,26.471
11,0.990,Sheep,16-23,49,50,0,99,49.495,49.495
11,0.990,Sheep,23-5,54,35,0,89,60.674,60.674
11,0.990,Hu and Dg,16-23,8,13,0,21,38.095,38.095
11,0.990,Hu and Dg,23-5,18,17,0,35,51.429,51.429
11,0.990,Common Loon,16-23,0,0,0,0,NaN,NaN
11,0.990,Common Loon,23-5,0,2,0,2,0.000,0.000
11,0.990,Red-Winged Blackbird,16-23,0,3,0,3,0.000,0.000
11,0.990,Red-Winged Blackbird,23-5,0,0,0,0,NaN,NaN
11,0.990,Cw,16-23,9,13,0,22,40.909,40.909
11,0.990,Cw,23-5,16,27,0,43,37.209,37.209
11,0.990,Cliff Sparrow,16-23,2,10,0,12,16.667,16.667
11,0.990,Cliff Sparrow,23-5,0,4,0,4,0.000,0.000
11,0.990,Pig,16-23,10,7,0,17,58.824,58.824
11,0.990,Pig,23-5,7,7,0,14,50.000,50.000
11,0.990,Barn Owl,16-23,0,0,0,0,NaN,NaN
11,0.990,Barn Owl,23-5,0,0,0,0,NaN,NaN
11,0.990,Wild Pig,16-23,0,1,0,1,0.000,0.000
11,0.990,Wild Pig,23-5,0,3,0,3,0.000,0.000
11,0.990,Pennington Creek Water,16-23,0,0,0,0,NaN,NaN
11,0.990,Pennington Creek Water,23-5,0,0,0,0,NaN,NaN
11,0.990,Guinni,16-23,0,0,0,0,NaN,NaN
11,0.990,Guinni,23-5,0,0,0,0,NaN,NaN
11,0.990,Racoon,16-23,0,0,0,0,NaN,NaN
11,0.990,Racoon,23-5,0,1,0,1,0.000,0.000
11,0.990,Hu,16-23,15,14,0,29,51.724,51.724
11,0.990,Hu,23-5,24,12,0,36,66.667,66.667
11,0.990,Cw and Dg,16-23,6,16,0,22,27.273,27.273
11,0.990,Cw and Dg,23-5,14,11,0,25,56.000,56.000
11,0.990,Red Wind Blackbird,16-23,0,0,0,0,NaN,NaN
11,0.990,Red Wind Blackbird,23-5,0,0,0,0,NaN,NaN
11,0.990,Tree Swallow,16-23,0,0,0,0,NaN,NaN
11,0.990,Tree Swallow,23-5,0,0,0,0,NaN,NaN
11,0.990,Turkey Vulture,16-23,0,0,0,0,NaN,NaN
11,0.990,Turkey Vulture,23-5,0,0,0,0,NaN,NaN
11,0.990,Dg,16-23,6,10,0,16,37.500,37.500
11,0.990,Dg,23-5,32,19,0,51,62.745,62.745
11,0.990,Western Kingbird,16-23,0,0,0,0,NaN,NaN
11,0.990,Western Kingbird,23-5,0,0,0,0,NaN,NaN
11,0.990,White Crowned Sparrow,16-23,0,0,0,0,NaN,NaN
11,0.990,White Crowned Sparrow,23-5,0,5,0,5,0.000,0.000
11,0.990,Eared Grebe,16-23,0,0,0,0,NaN,NaN
11,0.990,Eared Grebe,23-5,0,11,0,11,0.000,0.000
11,0.990,cougar,16-23,0,1,0,1,0.000,0.000
11,0.990,cougar,23-5,0,0,0,0,NaN,NaN
11,0.990,Ocean Water,16-23,0,0,0,0,NaN,NaN
11,0.990,Ocean Water,23-5,0,0,0,0,NaN,NaN
11,0.990,Red Tailed Hawk,16-23,0,0,0,0,NaN,NaN
11,0.990,Red Tailed Hawk,23-5,0,6,0,6,0.000,0.000
11,0.990,Dog,16-23,57,73,0,130,43.846,43.846
11,0.990,Dog,23-5,98,112,0,210,46.667,46.667
11,0.990,Human,16-23,1750,733,0,2483,70.479,70.479
11,0.990,Human,23-5,2174,547,0,2721,79.897,79.897
11,0.990,Wild Turkey,16-23,3,11,0,14,21.429,21.429
11,0.990,Wild Turkey,23-5,4,23,0,27,14.815,14.815
11,0.990,Clark Grebe,16-23,0,0,0,0,NaN,NaN
11,0.990,Clark Grebe,23-5,2,3,0,5,40.000,40.000
11,0.990,Seagull,16-23,0,0,0,0,NaN,NaN
11,0.990,Seagull,23-5,48,7,0,55,87.273,87.273
11,0.990,Surf Scoter,16-23,0,0,0,0,NaN,NaN
11,0.990,Surf Scoter,23-5,2,0,0,2,100.000,100.000
11,0.990,Pigeon,16-23,88,131,0,219,40.183,40.183
11,0.990,Pigeon,23-5,129,202,0,331,38.973,38.973
11,0.990,Pacific Ocean Water,16-23,0,0,0,0,NaN,NaN
11,0.990,Pacific Ocean Water,23-5,0,0,0,0,NaN,NaN
11,0.990,Cat,16-23,21,24,0,45,46.667,46.667
11,0.990,Cat,23-5,29,23,0,52,55.769,55.769
11,0.990,Horse,16-23,8,19,0,27,29.630,29.630
11,0.990,Horse,23-5,25,121,0,146,17.123,17.123
11,0.990,orangutan,16-23,0,0,0,0,NaN,NaN
11,0.990,orangutan,23-5,0,0,0,0,NaN,NaN
11,0.990,Bat,16-23,36,28,0,64,56.250,56.250
11,0.990,Bat,23-5,37,33,0,70,52.857,52.857
11,0.990,Deer,16-23,14,25,0,39,35.897,35.897
11,0.990,Deer,23-5,19,110,0,129,14.729,14.729
11,0.990,Great Horned Owl,16-23,0,0,0,0,NaN,NaN
11,0.990,Great Horned Owl,23-5,0,0,0,0,NaN,NaN
11,0.990,Freshwater Lagoon,16-23,0,0,0,0,NaN,NaN
11,0.990,Freshwater Lagoon,23-5,0,0,0,0,NaN,NaN
11,0.990,Unknown Avian,16-23,0,0,0,0,NaN,NaN
11,0.990,Unknown Avian,23-5,0,0,0,0,NaN,NaN
11,0.990,Human UTI,16-23,82,68,0,150,54.667,54.667
11,0.990,Human UTI,23-5,101,80,0,181,55.801,55.801
11,0.990,unknown,16-23,0,0,0,0,NaN,NaN
11,0.990,unknown,23-5,0,5,0,5,0.000,0.000
11,0.990,SLO Creek Water,16-23,0,0,0,0,NaN,NaN
11,0.990,SLO Creek Water,23-5,0,0,0,0,NaN,NaN
11,0.990,Pig/Swine,16-23,6,8,0,14,42.857,42.857
11,0.990,Pig/Swine,23-5,9,11,0,20,45.000,45.000
11,0.990,Klebsiella,16-23,0,0,0,0,NaN,NaN
11,0.990,Klebsiella,23-5,0,0,0,0,NaN,NaN
11,0.990,Hu Cw and Dg,16-23,7,11,0,18,38.889,38.889
11,0.990,Hu Cw and Dg,23-5,8,14,0,22,36.364,36.364
11,0.990,Ground Squirrel,16-23,93,52,0,145,64.138,64.138
11,0.990,Ground Squirrel,23-5,87,73,0,160,54.375,54.375
11,0.990,Opossum,16-23,1,0,0,1,100.000,100.000
11,0.990,Opossum,23-5,2,0,0,2,100.000,100.000
11,0.990,Cow,16-23,1525,994,0,2519,60.540,60.540
11,0.990,Cow,23-5,1492,1309,0,2801,53.267,53.267
11,0.990,Deer Mouse,16-23,0,0,0,0,NaN,NaN
11,0.990,Deer Mouse,23-5,0,0,0,0,NaN,NaN
11,0.990,OVERALL,16-23,3800,2325,0,6125,62.041,62.041
11,0.990,OVERALL,23-5,4454,2872,0,7326,60.797,60.797
11,1.000,Chicken,16-23,0,0,0,0,NaN,NaN
11,1.000,Chicken,23-5,0,0,0,0,NaN,NaN
11,1.000,Sea Lion,16-23,0,0,0,0,NaN,NaN
11,1.000,Sea Lion,23-5,0,0,0,0,NaN,NaN
11,1.000,Hu and Cw,16-23,0,0,0,0,NaN,NaN
11,1.000,Hu and Cw,23-5,0,0,0,0,NaN,NaN
11,1.000,Sheep,16-23,0,0,0,0,NaN,NaN
11,1.000,Sheep,23-5,0,0,0,0,NaN,NaN
11,1.000,Hu and Dg,16-23,0,0,0,0,NaN,NaN
11,1.000,Hu and Dg,23-5,0,0,0,0,NaN,NaN
11,1.000,Common Loon,16-23,0,0,0,0,NaN,NaN
11,1.000,Common Loon,23-5,0,0,0,0,NaN,NaN
11,1.000,Red-Winged Blackbird,16-23,0,0,0,0,NaN,NaN
11,1.000,Red-Winged Blackbird,23-5,0,0,0,0,NaN,NaN
11,1.000,Cw,16-23,0,0,0,0,NaN,NaN
11,1.000,Cw,23-5,0,0,0,0,NaN,NaN
11,1.000,Cliff Sparrow,16-23,0,0,0,0,NaN,NaN
11,1.000,Cliff Sparrow,23-5,0,0,0,0,NaN,NaN
11,1.000,Pig,16-23,0,0,0,0,NaN,NaN
11,1.000,Pig,23-5,0,0,0,0,NaN,NaN
11,1.000,Barn Owl,16-23,0,0,0,0,NaN,NaN
11,1.000,Barn Owl,23-5,0,0,0,0,NaN,NaN
11,1.000,Wild Pig,16-23,0,0,0,0,NaN,NaN
11,1.000,Wild Pig,23-5,0,0,0,0,NaN,NaN
11,1.000,Pennington Creek Water,16-23,0,0,0,0,NaN,NaN
11,1.000,Pennington Creek Water,23-5,0,0,0,0,NaN,NaN
11,1.000,Guinni,16-23,0,0,0,0,NaN,NaN
11,1.000,Guinni,23-5,0,0,0,0,NaN,NaN
11,1.000,Racoon,16-23,0,0,0,0,NaN,NaN
11,1.000,Racoon,23-5,0,0,0,0,NaN,NaN
11,1.000,Hu,16-23,0,0,0,0,NaN,NaN
11,1.000,Hu,23-5,0,0,0,0,NaN,NaN
11,1.000,Cw and Dg,16-23,0,0,0,0,NaN,NaN
11,1.000,Cw and Dg,23-5,0,0,0,0,NaN,NaN
11,1.000,Red Wind Blackbird,16-23,0,0,0,0,NaN,NaN
11,1.000,Red Wind Blackbird,23-5,0,0,0,0,NaN,NaN
11,1.000,Tree Swallow,16-23,0,0,0,0,NaN,NaN
11,1.000,Tree Swallow,23-5,0,0,0,0,NaN,NaN
11,1.000,Turkey Vulture,16-23,0,0,0,0,NaN,NaN
11,1.000,Turkey Vulture,23-5,0,0,0,0,NaN,NaN
11,1.000,Dg,16-23,0,0,0,0,NaN,NaN
11,1.000,Dg,23-5,0,0,0,0,NaN,NaN
11,1.000,Western Kingbird,16-23,0,0,0,0,NaN,NaN
11,1.000,Western Kingbird,23-5,0,0,0,0,NaN,NaN
11,1.000,White Crowned Sparrow,16-23,0,0,0,0,NaN,NaN
11,1.000,White Crowned Sparrow,23-5,0,0,0,0,NaN,NaN
11,1.000,Eared Grebe,16-23,0,0,0,0,NaN,NaN
11,1.000,Eared Grebe,23-5,0,0,0,0,NaN,NaN
11,1.000,cougar,16-23,0,0,0,0,NaN,NaN
11,1.000,cougar,23-5,0,0,0,0,NaN,NaN
11,1.000,Ocean Water,16-23,0,0,0,0,NaN,NaN
11,1.000,Ocean Water,23-5,0,0,0,0,NaN,NaN
11,1.000,Red Tailed Hawk,16-23,0,0,0,0,NaN,NaN
11,1.000,Red Tailed Hawk,23-5,0,0,0,0,NaN,NaN
11,1.000,Dog,16-23,0,0,0,0,NaN,NaN
11,1.000,Dog,23-5,0,0,0,0,NaN,NaN
11,1.000,Human,16-23,68,0,0,68,100.000,100.000
11,1.000,Human,23-5,90,0,0,90,100.000,100.000
11,1.000,Wild Turkey,16-23,0,0,0,0,NaN,NaN
11,1.000,Wild Turkey,23-5,0,0,0,0,NaN,NaN
11,1.000,Clark Grebe,16-23,0,0,0,0,NaN,NaN
11,1.000,Clark Grebe,23-5,0,0,0,0,NaN,NaN
11,1.000,Seagull,16-23,0,0,0,0,NaN,NaN
11,1.000,Seagull,23-5,0,0,0,0,NaN,NaN
11,1.000,Surf Scoter,16-23,0,0,0,0,NaN,NaN
11,1.000,Surf Scoter,23-5,0,0,0,0,NaN,NaN
11,1.000,Pigeon,16-23,0,0,0,0,NaN,NaN
11,1.000,Pigeon,23-5,0,0,0,0,NaN,NaN
11,1.000,Pacific Ocean Water,16-23,0,0,0,0,NaN,NaN
11,1.000,Pacific Ocean Water,23-5,0,0,0,0,NaN,NaN
11,1.000,Cat,16-23,0,0,0,0,NaN,NaN
11,1.000,Cat,23-5,0,0,0,0,NaN,NaN
11,1.000,Horse,16-23,0,0,0,0,NaN,NaN
11,1.000,Horse,23-5,0,0,0,0,NaN,NaN
11,1.000,orangutan,16-23,0,0,0,0,NaN,NaN
11,1.000,orangutan,23-5,0,0,0,0,NaN,NaN
11,1.000,Bat,16-23,0,0,0,0,NaN,NaN
11,1.000,Bat,23-5,0,0,0,0,NaN,NaN
11,1.000,Deer,16-23,0,0,0,0,NaN,NaN
11,1.000,Deer,23-5,0,0,0,0,NaN,NaN
11,1.000,Great Horned Owl,16-23,0,0,0,0,NaN,NaN
11,1.000,Great Horned Owl,23-5,0,0,0,0,NaN,NaN
11,1.000,Freshwater Lagoon,16-23,0,0,0,0,NaN,NaN
11,1.000,Freshwater Lagoon,23-5,0,0,0,0,NaN,NaN
11,1.000,Unknown Avian,16-23,0,0,0,0,NaN,NaN
11,1.000,Unknown Avian,23-5,0,0,0,0,NaN,NaN
11,1.000,Human UTI,16-23,0,0,0,0,NaN,NaN
11,1.000,Human UTI,23-5,0,0,0,0,NaN,NaN
11,1.000,unknown,16-23,0,0,0,0,NaN,NaN
11,1.000,unknown,23-5,0,0,0,0,NaN,NaN
11,1.000,SLO Creek Water,16-23,0,0,0,0,NaN,NaN
11,1.000,SLO Creek Water,23-5,0,0,0,0,NaN,NaN
11,1.000,Pig/Swine,16-23,0,0,0,0,NaN,NaN
11,1.000,Pig/Swine,23-5,0,0,0,0,NaN,NaN
11,1.000,Klebsiella,16-23,0,0,0,0,NaN,NaN
11,1.000,Klebsiella,23-5,0,0,0,0,NaN,NaN
11,1.000,Hu Cw and Dg,16-23,0,0,0,0,NaN,NaN
11,1.000,Hu Cw and Dg,23-5,0,0,0,0,NaN,NaN
11,1.000,Ground Squirrel,16-23,0,0,0,0,NaN,NaN
11,1.000,Ground Squirrel,23-5,0,0,0,0,NaN,NaN
11,1.000,Opossum,16-23,0,0,0,0,NaN,NaN
11,1.000,Opossum,23-5,0,0,0,0,NaN,NaN
11,1.000,Cow,16-23,0,0,0,0,NaN,NaN
11,1.000,Cow,23-5,0,0,0,0,NaN,NaN
11,1.000,Deer Mouse,16-23,0,0,0,0,NaN,NaN
11,1.000,Deer Mouse,23-5,0,0,0,0,NaN,NaN
11,1.000,OVERALL,16-23,68,0,0,68,100.000,100.000
11,1.000,OVERALL,23-5,90,0,0,90,100.000,100.000
12,0.000,Chicken,16-23,0,1,0,1,0.000,0.000
12,0.000,Chicken,23-5,5,6,0,11,45.455,45.455
12,0.000,Sea Lion,16-23,0,0,0,0,NaN,NaN
12,0.000,Sea Lion,23-5,0,10,0,10,0.000,0.000
12,0.000,Hu and Cw,16-23,2,5,0,7,28.571,28.571
12,0.000,Hu and Cw,23-5,7,8,0,15,46.667,46.667
12,0.000,Sheep,16-23,44,51,0,95,46.316,46.316
12,0.000,Sheep,23-5,56,38,0,94,59.574,59.574
12,0.000,Hu and Dg,16-23,6,13,0,19,31.579,31.579
12,0.000,Hu and Dg,23-5,19,23,0,42,45.238,45.238
12,0.000,Common Loon,16-23,0,0,0,0,NaN,NaN
12,0.000,Common Loon,23-5,0,0,0,0,NaN,NaN
12,0.000,Red-Winged Blackbird,16-23,0,2,0,2,0.000,0.000
12,0.000,Red-Winged Blackbird,23-5,0,0,0,0,NaN,NaN
12,0.000,Cw,16-23,7,11,0,18,38.889,38.889
12,0.000,Cw,23-5,10,24,0,34,29.412,29.412
12,0.000,Cliff Sparrow,16-23,1,10,0,11,9.091,9.091
12,0.000,Cliff Sparrow,23-5,0,0,0,0,NaN,NaN
12,0.000,Pig,16-23,7,5,0,12,58.333,58.333
12,0.000,Pig,23-5,3,1,0,4,75.000,75.000
12,0.000,Barn Owl,16-23,0,0,0,0,NaN,NaN
12,0.000,Barn Owl,23-5,0,0,0,0,NaN,NaN
12,0.000,Wild Pig,16-23,0,0,0,0,NaN,NaN
12,0.000,Wild Pig,23-5,1,0,0,1,100.000,100.000
12,0.000,Pennington Creek Water,16-23,0,0,0,0,NaN,NaN
12,0.000,Pennington Creek Water,23-5,0,0,0,0,NaN,NaN
12,0.000,Guinni,16-23,0,0,0,0,NaN,NaN
12,0.000,Guinni,23-5,0,0,0,0,NaN,NaN
12,0.000,Racoon,16-23,0,0,0,0,NaN,NaN
12,0.000,Racoon,23-5,0,0,0,0,NaN,NaN
12,0.000,Hu,16-23,12,14,0,26,46.154,46.154
12,0.000,Hu,23-5,23,16,0,39,58.974,58.974
12,0.000,Cw and Dg,16-23,8,15,0,23,34.783,34.783
12,0.000,Cw and Dg,23-5,13,18,0,31,41.935,41.935
12,0.000,Red Wind Blackbird,16-23,0,0,0,0,NaN,NaN
12,0.000,Red Wind Blackbird,23-5,0,0,0,0,NaN,NaN
12,0.000,Tree Swallow,16-23,0,0,0,0,NaN,NaN
12,0.000,Tree Swallow,23-5,0,0,0,0,NaN,NaN
12,0.000,Turkey Vulture,16-23,0,0,0,0,NaN,NaN
12,0.000,Turkey Vulture,23-5,0,0,0,0,NaN,NaN
12,0.000,Dg,16-23,7,11,0,18,38.889,38.889
12,0.000,Dg,23-5,32,32,0,64,50.000,50.000
12,0.000,Western Kingbird,16-23,0,0,0,0,NaN,NaN
12,0.000,Western Kingbird,23-5,0,0,0,0,NaN,NaN
12,0.000,White Crowned Sparrow,16-23,0,0,0,0,NaN,NaN
12,0.000,White Crowned Sparrow,23-5,0,2,0,2,0.000,0.000
12,0.000,Eared Grebe,16-23,0,0,0,0,NaN,NaN
12,0.000,Eared Grebe,23-5,0,7,0,7,0.000,0.000
12,0.000,cougar,16-23,0,0,0,0,NaN,NaN
12,0.000,cougar,23-5,0,0,0,0,NaN,NaN
12,0.000,Ocean Water,16-23,0,0,0,0,NaN,NaN
12,0.000,Ocean Water,23-5,0,0,0,0,NaN,NaN
12,0.000,Red Tailed Hawk,16-23,0,0,0,0,NaN,NaN
12,0.000,Red Tailed Hawk,23-5,0,6,0,6,0.000,0.000
12,0.000,Dog,16-23,54,68,0,122,44.262,44.262
12,0.000,Dog,23-5,92,140,0,232,39.655,39.655
12,0.000,Human,16-23,1770,813,0,2583,68.525,68.525
12,0.000,Human,23-5,2177,672,0,2849,76.413,76.413
12,0.000,Wild Turkey,16-23,1,3,0,4,25.000,25.000
12,0.000,Wild Turkey,23-5,0,11,0,11,0.000,0.000
12,0.000,Clark Grebe,16-23,0,0,0,0,NaN,NaN
12,0.000,Clark Grebe,23-5,0,0,0,0,NaN,NaN
12,0.000,Seagull,16-23,0,0,0,0,NaN,NaN
12,0.000,Seagull,23-5,44,8,0,52,84.615,84.615
12,0.000,Surf Scoter,16-23,0,0,0,0,NaN,NaN
12,0.000,Surf Scoter,23-5,0,0,0,0,NaN,NaN
12,0.000,Pigeon,16-23,74,133,0,207,35.749,35.749
12,0.000,Pigeon,23-5,123,134,0,257,47.860,47.860
12,0.000,Pacific Ocean Water,16-23,0,0,0,0,NaN,NaN
12,0.000,Pacific Ocean Water,23-5,0,0,0,0,NaN,NaN
12,0.000,Cat,16-23,18,19,0,37,48.649,48.649
12,0.000,Cat,23-5,25,19,0,44,56.818,56.818
12,0.000,Horse,16-23,6,16,0,22,27.273,27.273
12,0.000,Horse,23-5,24,103,0,127,18.898,18.898
12,0.000,orangutan,16-23,0,0,0,0,NaN,NaN
12,0.000,orangutan,23-5,0,0,0,0,NaN,NaN
12,0.000,Bat,16-23,36,34,0,70,51.429,51.429
12,0.000,Bat,23-5,37,37,0,74,50.000,50.000
12,0.000,Deer,16-23,13,26,0,39,33.333,33.333
12,0.000,Deer,23-5,17,121,0,138,12.319,12.319
12,0.000,Great Horned Owl,16-23,0,0,0,0,NaN,NaN
12,0.000,Great Horned Owl,23-5,0,1,0,1,0.000,0.000
12,0.000,Freshwater Lagoon,16-23,0,0,0,0,NaN,NaN
12,0.000,Freshwater Lagoon,23-5,0,0,0,0,NaN,NaN
12,0.000,Unknown Avian,16-23,0,0,0,0,NaN,NaN
12,0.000,Unknown Avian,23-5,0,0,0,0,NaN,NaN
12,0.000,Human UTI,16-23,75,71,0,146,51.370,51.370
12,0.000,Human UTI,23-5,101,105,0,206,49.029,49.029
12,0.000,unknown,16-23,0,0,0,0,NaN,NaN
12,0.000,unknown,23-5,0,3,0,3,0.000,0.000
12,0.000,SLO Creek Water,16-23,0,0,0,0,NaN,NaN
12,0.000,SLO Creek Water,23-5,0,0,0,0,NaN,NaN
12,0.000,Pig/Swine,16-23,4,5,0,9,44.444,44.444
12,0.000,Pig/Swine,23-5,8,10,0,18,44.444,44.444
12,0.000,Klebsiella,16-23,0,0,0,0,NaN,NaN
12,0.000,Klebsiella,23-5,0,0,0,0,NaN,NaN
12,0.000,Hu Cw and Dg,16-23,6,8,0,14,42.857,42.857
12,0.000,Hu Cw and Dg,23-5,8,13,0,21,38.095,38.095
12,0.000,Ground Squirrel,16-23,82,47,0,129,63.566,63.566
12,0.000,Ground Squirrel,23-5,83,75,0,158,52.532,52.532
12,0.000,Opossum,16-23,0,0,0,0,NaN,NaN
12,0.000,Opossum,23-5,0,0,0,0,NaN,NaN
12,0.000,Cow,16-23,1556,1178,0,2734,56.913,56.913
12,0.000,Cow,23-5,1524,1535,0,3059,49.820,49.820
12,0.000,Deer Mouse,16-23,0,0,0,0,NaN,NaN
12,0.000,Deer Mouse,23-5,0,0,0,0,NaN,NaN
12,0.000,OVERALL,16-23,3789,2559,0,6348,59.688,59.688
12,0.000,OVERALL,23-5,4432,3178,0,7610,58.239,58.239
12,0.500,Chicken,16-23,0,1,0,1,0.000,0.000
12,0.500,Chicken,23-5,5,6,0,11,45.455,45.455
12,0.500,Sea Lion,16-23,0,0,0,0,NaN,NaN
12,0.500,Sea Lion,23-5,0,10,0,10,0.000,0.000
12,0.500,Hu and Cw,16-23,2,5,0,7,28.571,28.571
12,0.500,Hu and Cw,23-5,7,8,0,15,46.667,46.667
12,0.500,Sheep,16-23,44,51,0,95,46.316,46.316
12,0.500,Sheep,23-5,56,38,0,94,59.574,59.574
12,0.500,Hu and Dg,16-23,6,13,0,19,31.579,31.579
12,0.500,Hu and Dg,23-5,19,23,0,42,45.238,45.238
12,0.500,Common Loon,16-23,0,0,0,0,NaN,NaN
12,0.500,Common Loon,23-5,0,0,0,0,NaN,NaN
12,0.500,Red-Winged Blackbird,16-23,0,2,0,2,0.000,0.000
12,0.500,Red-Winged Blackbird,23-5,0,0,0,0,NaN,NaN
12,0.500,Cw,16-23,7,11,0,18,38.889,38.889
12,0.500,Cw,23-5,10,24,0,34,29.412,29.412
12,0.500,Cliff Sparrow,16-23,1,10,0,11,9.091,9.091
12,0.500,Cliff Sparrow,23-5,0,0,0,0,NaN,NaN
12,0.500,Pig,16-23,7,5,0,12,58.333,58.333
12,0.500,Pig,23-5,3,1,0,4,75.000,75.000
12,0.500,Barn Owl,16-23,0,0,0,0,NaN,NaN
12,0.500,Barn Owl,23-5,0,0,0,0,NaN,NaN
12,0.500,Wild Pig,16-23,0,0,0,0,NaN,NaN
12,0.500,Wild Pig,23-5,1,0,0,1,100.000,100.000
12,0.500,Pennington Creek Water,16-23,0,0,0,0,NaN,NaN
12,0.500,Pennington Creek Water,23-5,0,0,0,0,NaN,NaN
12,0.500,Guinni,16-23,0,0,0,0,NaN,NaN
12,0.500,Guinni,23-5,0,0,0,0,NaN,NaN
12,0.500,Racoon,16-23,0,0,0,0,NaN,NaN
12,0.500,Racoon,23-5,0,0,0,0,NaN,NaN
12,0.500,Hu,16-23,12,14,0,26,46.154,46.154
12,0.500,Hu,23-5,23,16,0,39,58.974,58.974
12,0.500,Cw and Dg,16-23,8,15,0,23,34.783,34.783
12,0.500,Cw and Dg,23-5,13,18,0,31,41.935,41.935
12,0.500,Red Wind Blackbird,16-23,0,0,0,0,NaN,NaN
12,0.500,Red Wind Blackbird,23-5,0,0,0,0,NaN,NaN
12,0.500,Tree Swallow,16-23,0,0,0,0,NaN,NaN
12,0.500,Tree Swallow,23-5,0,0,0,0,NaN,NaN
12,0.500,Turkey Vulture,16-23,0,0,0,0,NaN,NaN
12,0.500,Turkey Vulture,23-5,0,0,0,0,NaN,NaN
12,0.500,Dg,16-23,7,11,0,18,38.889,38.889
12,0.500,Dg,23-5,32,32,0,64,50.000,50.000
12,0.500,Western Kingbird,16-23,0,0,0,0,NaN,NaN
12,0.500,Western Kingbird,23-5,0,0,0,0,NaN,NaN
12,0.500,White Crowned Sparrow,16-23,0,0,0,0,NaN,NaN
12,0.500,White Crowned Sparrow,23-5,0,2,0,2,0.000,0.000
12,0.500,Eared Grebe,16-23,0,0,0,0,NaN,NaN
12,0.500,Eared Grebe,23-5,0,7,0,7,0.000,0.000
12,0.500,cougar,16-23,0,0,0,0,NaN,NaN
12,0.500,cougar,23-5,0,0,0,0,NaN,NaN
12,0.500,Ocean Water,16-23,0,0,0,0,NaN,NaN
12,0.500,Ocean Water,23-5,0,0,0,0,NaN,NaN
12,0.500,Red Tailed Hawk,16-23,0,0,0,0,NaN,NaN
12,0.500,Red Tailed Hawk,23-5,0,6,0,6,0.000,0.000
12,0.500,Dog,16-23,54,68,0,122,44.262,44.262
12,0.500,Dog,23-5,92,140,0,232,39.655,39.655
12,0.500,Human,16-23,1770,813,0,2583,68.525,68.525
12,0.500,Human,23-5,2177,672,0,2849,76.413,76.413
12,0.500,Wild Turkey,16-23,1,3,0,4,25.000,25.000
12,0.500,Wild Turkey,23-5,0,11,0,11,0.000,0.000
12,0.500,Clark Grebe,16-23,0,0,0,0,NaN,NaN
12,0.500,Clark Grebe,23-5,0,0,0,0,NaN,NaN
12,0.500,Seagull,16-23,0,0,0,0,NaN,NaN
12,0.500,Seagull,23-5,44,8,0,52,84.615,84.615
12,0.500,Surf Scoter,16-23,0,0,0,0,NaN,NaN
12,0.500,Surf Scoter,23-5,0,0,0,0,NaN,NaN
12,0.500,Pigeon,16-23,74,133,0,207,35.749,35.749
12,0.500,Pigeon,23-5,123,134,0,257,47.860,47.860
12,0.500,Pacific Ocean Water,16-23,0,0,0,0,NaN,NaN
12,0.500,Pacific Ocean Water,23-5,0,0,0,0,NaN,NaN
12,0.500,Cat,16-23,18,19,0,37,48.649,48.649
12,0.500,Cat,23-5,25,19,0,44,56.818,56.818
12,0.500,Horse,16-23,6,16,0,22,27.273,27.273
12,0.500,Horse,23-5,24,103,0,127,18.898,18.898
12,0.500,orangutan,16-23,0,0,0,0,NaN,NaN
12,0.500,orangutan,23-5,0,0,0,0,NaN,NaN
12,0.500,Bat,16-23,36,34,0,70,51.429,51.429
12,0.500,Bat,23-5,37,37,0,74,50.000,50.000
12,0.500,Deer,16-23,13,26,0,39,33.333,33.333
12,0.500,Deer,23-5,17,121,0,138,12.319,12.319
12,0.500,Great Horned Owl,16-23,0,0,0,0,NaN,NaN
12,0.500,Great Horned Owl,23-5,0,1,0,1,0.000,0.000
12,0.500,Freshwater Lagoon,16-23,0,0,0,0,NaN,NaN
12,0.500,Freshwater Lagoon,23-5,0,0,0,0,NaN,NaN
12,0.500,Unknown Avian,16-23,0,0,0,0,NaN,NaN
12,0.500,Unknown Avian,23-5,0,0,0,0,NaN,NaN
12,0.500,Human UTI,16-23,75,71,0,146,51.370,51.370
12,0.500,Human UTI,23-5,101,105,0,206,49.029,49.029
12,0.500,unknown,16-23,0,0,0,0,NaN,NaN
12,0.500,unknown,23-5,0,3,0,3,0.000,0.000
12,0.500,SLO Creek Water,16-23,0,0,0,0,NaN,NaN
12,0.500,SLO Creek Water,23-5,0,0,0,0,NaN,NaN
12,0.500,Pig/Swine,16-23,4,5,0,9,44.444,44.444
12,0.500,Pig/Swine,23-5,8,10,0,18,44.444,44.444
12,0.500,Klebsiella,16-23,0,0,0,0,NaN,NaN
12,0.500,Klebsiella,23-5,0,0,0,0,NaN,NaN
12,0.500,Hu Cw and Dg,16-23,6,8,0,14,42.857,42.857
12,0.500,Hu Cw and Dg,23-5,8,13,0,21,38.095,38.095
12,0.500,Ground Squirrel,16-23,82,47,0,129,63.566,63.566
12,0.500,Ground Squirrel,23-5,83,75,0,158,52.532,52.532
12,0.500,Opossum,16-23,0,0,0,0,NaN,NaN
12,0.500,Opossum,23-5,0,0,0,0,NaN,NaN
12,0.500,Cow,16-23,1556,1178,0,2734,56.913,56.913
12,0.500,Cow,23-5,1524,1535,0,3059,49.820,49.820
12,0.500,Deer Mouse,16-23,0,0,0,0,NaN,NaN
12,0.500,Deer Mouse,23-5,0,0,0,0,NaN,NaN
12,0.500,OVERALL,16-23,3789,2559,0,6348,59.688,59.688
12,0.500,OVERALL,23-5,4432,3178,0,7610,58.239,58.239
12,0.900,Chicken,16-23,0,1,0,1,0.000,0.000
12,0.900,Chicken,23-5,5,6,0,11,45.455,45.455
12,0.900,Sea Lion,16-23,0,0,0,0,NaN,NaN
12,0.900,Sea Lion,23-5,0,10,0,10,0.000,0.000
12,0.900,Hu and Cw,16-23,2,5,0,7,28.571,28.571
12,0.900,Hu and Cw,23-5,7,8,0,15,46.667,46.667
12,0.900,Sheep,16-23,44,51,0,95,46.316,46.316
12,0.900,Sheep,23-5,56,38,0,94,59.574,59.574
12,0.900,Hu and Dg,16-23,6,13,0,19,31.579,31.579
12,0.900,Hu and Dg,23-5,19,23,0,42,45.238,45.238
12,0.900,Common Loon,16-23,0,0,0,0,NaN,NaN
12,0.900,Common Loon,23-5,0,0,0,0,NaN,NaN
12,0.900,Red-Winged Blackbird,16-23,0,2,0,2,0.000,0.000
12,0.900,Red-Winged Blackbird,23-5,0,0,0,0,NaN,NaN
12,0.900,Cw,16-23,7,11,0,18,38.889,38.889
12,0.900,Cw,23-5,10,24,0,34,29.412,29.412
12,0.900,Cliff Sparrow,16-23,1,10,0,11,9.091,9.091
12,0.900,Cliff Sparrow,23-5,0,0,0,0,NaN,NaN
12,0.900,Pig,16-23,7,5,0,12,58.333,58.333
12,0.900,Pig,23-5,3,1,0,4,75.000,75.000
12,0.900,Barn Owl,16-23,0,0,0,0,NaN,NaN
12,0.900,Barn Owl,23-5,0,0,0,0,NaN,NaN
12,0.900,Wild Pig,16-23,0,0,0,0,NaN,NaN
12,0.900,Wild Pig,23-5,1,0,0,1,100.000,100.000
12,0.900,Pennington Creek Water,16-23,0,0,0,0,NaN,NaN
12,0.900,Pennington Creek Water,23-5,0,0,0,0,NaN,NaN
12,0.900,Guinni,16-23,0,0,0,0,NaN,NaN
12,0.900,Guinni,23-5,0,0,0,0,NaN,NaN
12,0.900,Racoon,16-23,0,0,0,0,NaN,NaN
12,0.900,Racoon,23-5,0,0,0,0,NaN,NaN
12,0.900,Hu,16-23,12,14,0,26,46.154,46.154
12,0.900,Hu,23-5,23,16,0,39,58.974,58.974
12,0.900,Cw and Dg,16-23,8,15,0,23,34.783,34.783
12,0.900,Cw and Dg,23-5,13,18,0,31,41.935,41.935
12,0.900,Red Wind Blackbird,16-23,0,0,0,0,NaN,NaN
12,0.900,Red Wind Blackbird,23-5,0,0,0,0,NaN,NaN
12,0.900,Tree Swallow,16-23,0,0,0,0,NaN,NaN
12,0.900,Tree Swallow,23-5,0,0,0,0,NaN,NaN
12,0.900,Turkey Vulture,16-23,0,0,0,0,NaN,NaN
12,0.900,Turkey Vulture,23-5,0,0,0,0,NaN,NaN
12,0.900,Dg,16-23,7,11,0,18,38.889,38.889
12,0.900,Dg,23-5,32,32,0,64,50.000,50.000
12,0.900,Western Kingbird,16-23,0,0,0,0,NaN,NaN
12,0.900,Western Kingbird,23-5,0,0,0,0,NaN,NaN
12,0.900,White Crowned Sparrow,16-23,0,0,0,0,NaN,NaN
12,0.900,White Crowned Sparrow,23-5,0,2,0,2,0.000,0.000
12,0.900,Eared Grebe,16-23,0,0,0,0,NaN,NaN
12,0.900,Eared Grebe,23-5,0,7,0,7,0.000,0.000
12,0.900,cougar,16-23,0,0,0,0,NaN,NaN
12,0.900,cougar,23-5,0,0,0,0,NaN,NaN
12,0.900,Ocean Water,16-23,0,0,0,0,NaN,NaN
12,0.900,Ocean Water,23-5,0,0,0,0,NaN,NaN
12,0.900,Red Tailed Hawk,16-23,0,0,0,0,NaN,NaN
12,0.900,Red Tailed Hawk,23-5,0,6,0,6,0.000,0.000
12,0.900,Dog,16-23,54,68,0,122,44.262,44.262
12,0.900,Dog,23-5,92,135,0,227,40.529,40.529
12,0.900,Human,16-23,1770,812,0,2582,68.552,68.552
12,0.900,Human,23-5,2177,668,0,2845,76.520,76.520
12,0.900,Wild Turkey,16-23,1,3,0,4,25.000,25.000
12,0.900,Wild Turkey,23-5,0,11,0,11,0.000,0.000
12,0.900,Clark Grebe,16-23,0,0,0,0,NaN,NaN
12,0.900,Clark Grebe,23-5,0,0,0,0,NaN,NaN
12,0.900,Seagull,16-23,0,0,0,0,NaN,NaN
12,0.900,Seagull,23-5,44,9,0,53,83.019,83.019
12,0.900,Surf Scoter,16-23,0,0,0,0,NaN,NaN
12,0.900,Surf Scoter,23-5,0,0,0,0,NaN,NaN
12,0.900,Pigeon,16-23,74,134,0,208,35.577,35.577
12,0.900,Pigeon,23-5,123,134,0,257,47.860,47.860
12,0.900,Pacific Ocean Water,16-23,0,0,0,0,NaN,NaN
12,0.900,Pacific Ocean Water,23-5,0,0,0,0,NaN,NaN
12,0.900,Cat,16-23,18,19,0,37,48.649,48.649
12,0.900,Cat,23-5,25,19,0,44,56.818,56.818
12,0.900,Horse,16-23,6,16,0,22,27.273,27.273
12,0.900,Horse,23-5,24,103,0,127,18.898,18.898
12,0.900,orangutan,16-23,0,0,0,0,NaN,NaN
12,0.900,orangutan,23-5,0,0,0,0,NaN,NaN
12,0.900,Bat,16-23,36,34,0,70,51.429,51.429
12,0.900,Bat,23-5,37,37,0,74,50.000,50.000
12,0.900,Deer,16-23,13,26,0,39,33.333,33.333
12,0.900,Deer,23-5,17,121,0,138,12.319,12.319
12,0.900,Great Horned Owl,16-23,0,0,0,0,NaN,NaN
12,0.900,Great Horned Owl,23-5,0,1,0,1,0.000,0.000
12,0.900,Freshwater Lagoon,16-23,0,0,0,0,NaN,NaN
12,0.900,Freshwater Lagoon,23-5,0,0,0,0,NaN,NaN
12,0.900,Unknown Avian,16-23,0,0,0,0,NaN,NaN
12,0.900,Unknown Avian,23-5,0,0,0,0,NaN,NaN
12,0.900,Human UTI,16-23,75,71,0,146,51.370,51.370
12,0.900,Human UTI,23-5,104,105,0,209,49.761,49.761
12,0.900,unknown,16-23,0,0,0,0,NaN,NaN
12,0.900,unknown,23-5,0,3,0,3,0.000,0.000
12,0.900,SLO Creek Water,16-23,0,0,0,0,NaN,NaN
12,0.900,SLO Creek Water,23-5,0,0,0,0,NaN,NaN
12,0.900,Pig/Swine,16-23,4,5,0,9,44.444,44.444
12,0.900,Pig/Swine,23-5,8,10,0,18,44.444,44.444
12,0.900,Klebsiella,16-23,0,0,0,0,NaN,NaN
12,0.900,Klebsiella,23-5,0,0,0,0,NaN,NaN
12,0.900,Hu Cw and Dg,16-23,6,8,0,14,42.857,42.857
12,0.900,Hu Cw and Dg,23-5,8,13,0,21,38.095,38.095
12,0.900,Ground Squirrel,16-23,82,47,0,129,63.566,63.566
12,0.900,Ground Squirrel,23-5,83,75,0,158,52.532,52.532
12,0.900,Opossum,16-23,0,0,0,0,NaN,NaN
12,0.900,Opossum,23-5,0,0,0,0,NaN,NaN
12,0.900,Cow,16-23,1556,1174,0,2730,56.996,56.996
12,0.900,Cow,23-5,1524,1532,0,3056,49.869,49.869
12,0.900,Deer Mouse,16-23,0,0,0,0,NaN,NaN
12,0.900,Deer Mouse,23-5,0,0,0,0,NaN,NaN
12,0.900,OVERALL,16-23,3789,2555,0,6344,59.726,59.726
12,0.900,OVERALL,23-5,4435,3167,0,7602,58.340,58.340
12,0.950,Chicken,16-23,0,1,0,1,0.000,0.000
12,0.950,Chicken,23-5,5,6,0,11,45.455,45.455
12,0.950,Sea Lion,16-23,0,0,0,0,NaN,NaN
12,0.950,Sea Lion,23-5,0,10,0,10,0.000,0.000
12,0.950,Hu and Cw,16-23,2,5,0,7,28.571,28.571
12,0.950,Hu and Cw,23-5,7,8,0,15,46.667,46.667
12,0.950,Sheep,16-23,44,51,0,95,46.316,46.316
12,0.950,Sheep,23-5,56,38,0,94,59.574,59.574
12,0.950,Hu and Dg,16-23,6,13,0,19,31.579,31.579
12,0.950,Hu and Dg,23-5,19,23,0,42,45.238,45.238
12,0.950,Common Loon,16-23,0,0,0,0,NaN,NaN
12,0.950,Common Loon,23-5,0,0,0,0,NaN,NaN
12,0.950,Red-Winged Blackbird,16-23,0,2,0,2,0.000,0.000
12,0.950,Red-Winged Blackbird,23-5,0,0,0,0,NaN,NaN
12,0.950,Cw,16-23,7,11,0,18,38.889,38.889
12,0.950,Cw,23-5,10,24,0,34,29.412,29.412
12,0.950,Cliff Sparrow,16-23,1,10,0,11,9.091,9.091
12,0.950,Cliff Sparrow,23-5,0,0,0,0,NaN,NaN
12,0.950,Pig,16-23,7,5,0,12,58.333,58.333
12,0.950,Pig,23-5,3,1,0,4,75.000,75.000
12,0.950,Barn Owl,16-23,0,0,0,0,NaN,NaN
12,0.950,Barn Owl,23-5,0,0,0,0,NaN,NaN
12,0.950,Wild Pig,16-23,0,0,0,0,NaN,NaN
12,0.950,Wild Pig,23-5,1,0,0,1,100.000,100.000
12,0.950,Pennington Creek Water,16-23,0,0,0,0,NaN,NaN
12,0.950,Pennington Creek Water,23-5,0,0,0,0,NaN,NaN
12,0.950,Guinni,16-23,0,0,0,0,NaN,NaN
12,0.950,Guinni,23-5,0,0,0,0,NaN,NaN
12,0.950,Racoon,16-23,0,0,0,0,NaN,NaN
12,0.950,Racoon,23-5,0,0,0,0,NaN,NaN
12,0.950,Hu,16-23,12,14,0,26,46.154,46.154
12,0.950,Hu,23-5,23,16,0,39,58.974,58.974
12,0.950,Cw and Dg,16-23,8,15,0,23,34.783,34.783
12,0.950,Cw and Dg,23-5,13,18,0,31,41.935,41.935
12,0.950,Red Wind Blackbird,16-23,0,0,0,0,NaN,NaN
12,0.950,Red Wind Blackbird,23-5,0,0,0,0,NaN,NaN
12,0.950,Tree Swallow,16-23,0,0,0,0,NaN,NaN
12,0.950,Tree Swallow,23-5,0,0,0,0,NaN,NaN
12,0.950,Turkey Vulture,16-23,0,0,0,0,NaN,NaN
12,0.950,Turkey Vulture,23-5,0,0,0,0,NaN,NaN
12,0.950,Dg,16-23,7,11,0,18,38.889,38.889
12,0.950,Dg,23-5,32,32,0,64,50.000,50.000
12,0.950,Western Kingbird,16-23,0,0,0,0,NaN,NaN
12,0.950,Western Kingbird,23-5,0,0,0,0,NaN,NaN
12,0.950,White Crowned Sparrow,16-23,0,0,0,0,NaN,NaN
12,0.950,White Crowned Sparrow,23-5,0,2,0,2,0.000,0.000
12,0.950,Eared Grebe,16-23,0,0,0,0,NaN,NaN
12,0.950,Eared Grebe,23-5,0,7,0,7,0.000,0.000
12,0.950,cougar,16-23,0,0,0,0,NaN,NaN
12,0.950,cougar,23-5,0,0,0,0,NaN,NaN
12,0.950,Ocean Water,16-23,0,0,0,0,NaN,NaN
12,0.950,Ocean Water,23-5,0,0,0,0,NaN,NaN
12,0.950,Red Tailed Hawk,16-23,0,0,0,0,NaN,NaN
12,0.950,Red Tailed Hawk,23-5,0,6,0,6,0.000,0.000
12,0.950,Dog,16-23,54,68,0,122,44.262,44.262
12,0.950,Dog,23-5,92,133,0,225,40.889,40.889
12,0.950,Human,16-23,1770,810,0,2580,68.605,68.605
12,0.950,Human,23-5,2179,659,0,2838,76.779,76.779
12,0.950,Wild Turkey,16-23,1,3,0,4,25.000,25.000
12,0.950,Wild Turkey,23-5,0,10,0,10,0.000,0.000
12,0.950,Clark Grebe,16-23,0,0,0,0,NaN,NaN
12,0.950,Clark Grebe,23-5,0,0,0,0,NaN,NaN
12,0.950,Seagull,16-23,0,0,0,0,NaN,NaN
12,0.950,Seagull,23-5,44,8,0,52,84.615,84.615
12,0.950,Surf Scoter,16-23,0,0,0,0,NaN,NaN
12,0.950,Surf Scoter,23-5,0,0,0,0,NaN,NaN
12,0.950,Pigeon,16-23,75,133,0,208,36.058,36.058
12,0.950,Pigeon,23-5,123,135,0,258,47.674,47.674
12,0.950,Pacific Ocean Water,16-23,0,0,0,0,NaN,NaN
12,0.950,Pacific Ocean Water,23-5,0,0,0,0,NaN,NaN
12,0.950,Cat,16-23,18,19,0,37,48.649,48.649
12,0.950,Cat,23-5,25,19,0,44,56.818,56.818
12,0.950,Horse,16-23,6,16,0,22,27.273,27.273
12,0.950,Horse,23-5,24,103,0,127,18.898,18.898
12,0.950,orangutan,16-23,0,0,0,0,NaN,NaN
12,0.950,orangutan,23-5,0,0,0,0,NaN,NaN
12,0.950,Bat,16-23,36,34,0,70,51.429,51.429
12,0.950,Bat,23-5,37,36,0,73,50.685,50.685
12,0.950,Deer,16-23,13,26,0,39,33.333,33.333
12,0.950,Deer,23-5,17,121,0,138,12.319,12.319
12,0.950,Great Horned Owl,16-23,0,0,0,0,NaN,NaN
12,0.950,Great Horned Owl,23-5,0,1,0,1,0.000,0.000
12,0.950,Freshwater Lagoon,16-23,0,0,0,0,NaN,NaN
12,0.950,Freshwater Lagoon,23-5,0,0,0,0,NaN,NaN
12,0.950,Unknown Avian,16-23,0,0,0,0,NaN,NaN
12,0.950,Unknown Avian,23-5,0,0,0,0,NaN,NaN
12,0.950,Human UTI,16-23,78,72,0,150,52.000,52.000
12,0.950,Human UTI,23-5,103,108,0,211,48.815,48.815
12,0.950,unknown,16-23,0,0,0,0,NaN,NaN
12,0.950,unknown,23-5,0,3,0,3,0.000,0.000
12,0.950,SLO Creek Water,16-23,0,0,0,0,NaN,NaN
12,0.950,SLO Creek Water,23-5,0,0,0,0,NaN,NaN
12,0.950,Pig/Swine,16-23,4,5,0,9,44.444,44.444
12,0.950,Pig/Swine,23-5,8,10,0,18,44.444,44.444
12,0.950,Klebsiella,16-23,0,0,0,0,NaN,NaN
12,0.950,Klebsiella,23-5,0,0,0,0,NaN,NaN
12,0.950,Hu Cw and Dg,16-23,6,8,0,14,42.857,42.857
12,0.950,Hu Cw and Dg,23-5,8,13,0,21,38.095,38.095
12,0.950,Ground Squirrel,16-23,82,47,0,129,63.566,63.566
12,0.950,Ground Squirrel,23-5,83,74,0,157,52.866,52.866
12,0.950,Opossum,16-23,0,0,0,0,NaN,NaN
12,0.950,Opossum,23-5,0,0,0,0,NaN,NaN
12,0.950,Cow,16-23,1558,1153,0,2711,57.470,57.470
12,0.950,Cow,23-5,1523,1531,0,3054,49.869,49.869
12,0.950,Deer Mouse,16-23,0,0,0,0,NaN,NaN
12,0.950,Deer Mouse,23-5,0,0,0,0,NaN,NaN
12,0.950,OVERALL,16-23,3795,2532,0,6327,59.981,59.981
12,0.950,OVERALL,23-5,4435,3155,0,7590,58.432,58.432
12,0.960,Chicken,16-23,0,1,0,1,0.000,0.000
12,0.960,Chicken,23-5,5,6,0,11,45.455,45.455
12,0.960,Sea Lion,16-23,0,0,0,0,NaN,NaN
12,0.960,Sea Lion,23-5,0,10,0,10,0.000,0.000
12,0.960,Hu and Cw,16-23,2,5,0,7,28.571,28.571
12,0.960,Hu and Cw,23-5,7,8,0,15,46.667,46.667
12,0.960,Sheep,16-23,44,51,0,95,46.316,46.316
12,0.960,Sheep,23-5,56,39,0,95,58.947,58.947
12,0.960,Hu and Dg,16-23,6,13,0,19,31.579,31.579
12,0.960,Hu and Dg,23-5,19,23,0,42,45.238,45.238
12,0.960,Common Loon,16-23,0,0,0,0,NaN,NaN
12,0.960,Common Loon,23-5,0,0,0,0,NaN,NaN
12,0.960,Red-Winged Blackbird,16-23,0,2,0,2,0.000,0.000
12,0.960,Red-Winged Blackbird,23-5,0,0,0,0,NaN,NaN
12,0.960,Cw,16-23,7,11,0,18,38.889,38.889
12,0.960,Cw,23-5,10,24,0,34,29.412,29.412
12,0.960,Cliff Sparrow,16-23,1,10,0,11,9.091,9.091
12,0.960,Cliff Sparrow,23-5,0,0,0,0,NaN,NaN
12,0.960,Pig,16-23,7,5,0,12,58.333,58.333
12,0.960,Pig,23-5,3,1,0,4,75.000,75.000
12,0.960,Barn Owl,16-23,0,0,0,0,NaN,NaN
12,0.960,Barn Owl,23-5,0,0,0,0,NaN,NaN
12,0.960,Wild Pig,16-23,0,0,0,0,NaN,NaN
12,0.960,Wild Pig,23-5,1,0,0,1,100.000,100.000
12,0.960,Pennington Creek Water,16-23,0,0,0,0,NaN,NaN
12,0.960,Pennington Creek Water,23-5,0,0,0,0,NaN,NaN
12,0.960,Guinni,16-23,0,0,0,0,NaN,NaN
12,0.960,Guinni,23-5,0,0,0,0,NaN,NaN
12,0.960,Racoon,16-23,0,0,0,0,NaN,NaN
12,0.960,Racoon,23-5,0,0,0,0,NaN,NaN
12,0.960,Hu,16-23,12,14,0,26,46.154,46.154
12,0.960,Hu,23-5,23,16,0,39,58.974,58.974
12,0.960,Cw and Dg,16-23,8,15,0,23,34.783,34.783
12,0.960,Cw and Dg,23-5,13,18,0,31,41.935,41.935
12,0.960,Red Wind Blackbird,16-23,0,0,0,0,NaN,NaN
12,0.960,Red Wind Blackbird,23-5,0,0,0,0,NaN,NaN
12,0.960,Tree Swallow,16-23,0,0,0,0,NaN,NaN
12,0.960,Tree Swallow,23-5,0,0,0,0,NaN,NaN
12,0.960,Turkey Vulture,16-23,0,0,0,0,NaN,NaN
12,0.960,Turkey Vulture,23-5,0,0,0,0,NaN,NaN
12,0.960,Dg,16-23,7,11,0,18,38.889,38.889
12,0.960,Dg,23-5,32,32,0,64,50.000,50.000
12,0.960,Western Kingbird,16-23,0,0,0,0,NaN,NaN
12,0.960,Western Kingbird,23-5,0,0,0,0,NaN,NaN
12,0.960,White Crowned Sparrow,16-23,0,0,0,0,NaN,NaN
12,0.960,White Crowned Sparrow,23-5,0,2,0,2,0.000,0.000
12,0.960,Eared Grebe,16-23,0,0,0,0,NaN,NaN
12,0.960,Eared Grebe,23-5,0,7,0,7,0.000,0.000
12,0.960,cougar,16-23,0,0,0,0,NaN,NaN
12,0.960,cougar,23-5,0,0,0,0,NaN,NaN
12,0.960,Ocean Water,16-23,0,0,0,0,NaN,NaN
12,0.960,Ocean Water,23-5,0,0,0,0,NaN,NaN
12,0.960,Red Tailed Hawk,16-23,0,0,0,0,NaN,NaN
12,0.960,Red Tailed Hawk,23-5,0,6,0,6,0.000,0.000
12,0.960,Dog,16-23,54,68,0,122,44.262,44.262
12,0.960,Dog,23-5,92,128,0,220,41.818,41.818
12,0.960,Human,16-23,1772,809,0,2581,68.656,68.656
12,0.960,Human,23-5,2179,644,0,2823,77.187,77.187
12,0.960,Wild Turkey,16-23,1,3,0,4,25.000,25.000
12,0.960,Wild Turkey,23-5,0,14,0,14,0.000,0.000
12,0.960,Clark Grebe,16-23,0,0,0,0,NaN,NaN
12,0.960,Clark Grebe,23-5,0,0,0,0,NaN,NaN
12,0.960,Seagull,16-23,0,0,0,0,NaN,NaN
12,0.960,Seagull,23-5,44,9,0,53,83.019,83.019
12,0.960,Surf Scoter,16-23,0,0,0,0,NaN,NaN
12,0.960,Surf Scoter,23-5,0,2,0,2,0.000,0.000
12,0.960,Pigeon,16-23,74,133,0,207,35.749,35.749
12,0.960,Pigeon,23-5,124,150,0,274,45.255,45.255
12,0.960,Pacific Ocean Water,16-23,0,0,0,0,NaN,NaN
12,0.960,Pacific Ocean Water,23-5,0,0,0,0,NaN,NaN
12,0.960,Cat,16-23,18,19,0,37,48.649,48.649
12,0.960,Cat,23-5,25,20,0,45,55.556,55.556
12,0.960,Horse,16-23,6,16,0,22,27.273,27.273
12,0.960,Horse,23-5,24,103,0,127,18.898,18.898
12,0.960,orangutan,16-23,0,0,0,0,NaN,NaN
12,0.960,orangutan,23-5,0,0,0,0,NaN,NaN
12,0.960,Bat,16-23,36,34,0,70,51.429,51.429
12,0.960,Bat,23-5,37,36,0,73,50.685,50.685
12,0.960,Deer,16-23,13,26,0,39,33.333,33.333
12,0.960,Deer,23-5,17,121,0,138,12.319,12.319
12,0.960,Great Horned Owl,16-23,0,0,0,0,NaN,NaN
12,0.960,Great Horned Owl,23-5,0,1,0,1,0.000,0.000
12,0.960,Freshwater Lagoon,16-23,0,0,0,0,NaN,NaN
12,0.960,Freshwater Lagoon,23-5,0,0,0,0,NaN,NaN
12,0.960,Unknown Avian,16-23,0,0,0,0,NaN,NaN
12,0.960,Unknown Avian,23-5,0,0,0,0,NaN,NaN
12,0.960,Human UTI,16-23,78,73,0,151,51.656,51.656
12,0.960,Human UTI,23-5,103,107,0,210,49.048,49.048
12,0.960,unknown,16-23,0,0,0,0,NaN,NaN
12,0.960,unknown,23-5,0,3,0,3,0.000,0.000
12,0.960,SLO Creek Water,16-23,0,0,0,0,NaN,NaN
12,0.960,SLO Creek Water,23-5,0,0,0,0,NaN,NaN
12,0.960,Pig/Swine,16-23,4,5,0,9,44.444,44.444
12,0.960,Pig/Swine,23-5,8,10,0,18,44.444,44.444
12,0.960,Klebsiella,16-23,0,0,0,0,NaN,NaN
12,0.960,Klebsiella,23-5,0,0,0,0,NaN,NaN
12,0.960,Hu Cw and Dg,16-23,6,8,0,14,42.857,42.857
12,0.960,Hu Cw and Dg,23-5,8,13,0,21,38.095,38.095
12,0.960,Ground Squirrel,16-23,82,47,0,129,63.566,63.566
12,0.960,Ground Squirrel,23-5,83,76,0,159,52.201,52.201
12,0.960,Opossum,16-23,0,0,0,0,NaN,NaN
12,0.960,Opossum,23-5,0,0,0,0,NaN,NaN
12,0.960,Cow,16-23,1556,1143,0,2699,57.651,57.651
12,0.960,Cow,23-5,1523,1515,0,3038,50.132,50.132
12,0.960,Deer Mouse,16-23,0,0,0,0,NaN,NaN
12,0.960,Deer Mouse,23-5,0,0,0,0,NaN,NaN
12,0.960,OVERALL,16-23,3794,2522,0,6316,60.070,60.070
12,0.960,OVERALL,23-5,4436,3144,0,7580,58.522,58.522
12,0.970,Chicken,16-23,0,1,0,1,0.000,0.000
12,0.970,Chicken,23-5,5,6,0,11,45.455,45.455
12,0.970,Sea Lion,16-23,0,0,0,0,NaN,NaN
12,0.970,Sea Lion,23-5,0,10,0,10,0.000,0.000
12,0.970,Hu and Cw,16-23,2,5,0,7,28.571,28.571
12,0.970,Hu and Cw,23-5,7,8,0,15,46.667,46.667
12,0.970,Sheep,16-23,45,52,0,97,46.392,46.392
12,0.970,Sheep,23-5,56,38,0,94,59.574,59.574
12,0.970,Hu and Dg,16-23,6,13,0,19,31.579,31.579
12,0.970,Hu and Dg,23-5,19,23,0,42,45.238,45.238
12,0.970,Common Loon,16-23,0,0,0,0,NaN,NaN
12,0.970,Common Loon,23-5,0,0,0,0,NaN,NaN
12,0.970,Red-Winged Blackbird,16-23,0,2,0,2,0.000,0.000
12,0.970,Red-Winged Blackbird,23-5,0,0,0,0,NaN,NaN
12,0.970,Cw,16-23,7,12,0,19,36.842,36.842
12,0.970,Cw,23-5,10,24,0,34,29.412,29.412
12,0.970,Cliff Sparrow,16-23,1,10,0,11,9.091,9.091
12,0.970,Cliff Sparrow,23-5,0,0,0,0,NaN,NaN
12,0.970,Pig,16-23,7,5,0,12,58.333,58.333
12,0.970,Pig,23-5,3,1,0,4,75.000,75.000
12,0.970,Barn Owl,16-23,0,0,0,0,NaN,NaN
12,0.970,Barn Owl,23-5,0,0,0,0,NaN,NaN
12,0.970,Wild Pig,16-23,0,0,0,0,NaN,NaN
12,0.970,Wild Pig,23-5,0,0,0,0,NaN,NaN
12,0.970,Pennington Creek Water,16-23,0,0,0,0,NaN,NaN
12,0.970,Pennington Creek Water,23-5,0,0,0,0,NaN,NaN
12,0.970,Guinni,16-23,0,0,0,0,NaN,NaN
12,0.970,Guinni,23-5,0,0,0,0,NaN,NaN
12,0.970,Racoon,16-23,0,0,0,0,NaN,NaN
12,0.970,Racoon,23-5,0,0,0,0,NaN,NaN
12,0.970,Hu,16-23,12,14,0,26,46.154,46.154
12,0.970,Hu,23-5,23,16,0,39,58.974,58.974
12,0.970,Cw and Dg,16-23,8,15,0,23,34.783,34.783
12,0.970,Cw and Dg,23-5,13,18,0,31,41.935,41.935
12,0.970,Red Wind Blackbird,16-23,0,0,0,0,NaN,NaN
12,0.970,Red Wind Blackbird,23-5,0,0,0,0,NaN,NaN
12,0.970,Tree Swallow,16-23,0,0,0,0,NaN,NaN
12,0.970,Tree Swallow,23-5,0,0,0,0,NaN,NaN
12,0.970,Turkey Vulture,16-23,0,0,0,0,NaN,NaN
12,0.970,Turkey Vulture,23-5,0,0,0,0,NaN,NaN
12,0.970,Dg,16-23,7,11,0,18,38.889,38.889
12,0.970,Dg,23-5,32,31,0,63,50.794,50.794
12,0.970,Western Kingbird,16-23,0,0,0,0,NaN,NaN
12,0.970,Western Kingbird,23-5,0,0,0,0,NaN,NaN
12,0.970,White Crowned Sparrow,16-23,0,0,0,0,NaN,NaN
12,0.970,White Crowned Sparrow,23-5,0,2,0,2,0.000,0.000
12,0.970,Eared Grebe,16-23,0,0,0,0,NaN,NaN
12,0.970,Eared Grebe,23-5,0,7,0,7,0.000,0.000
12,0.970,cougar,16-23,0,0,0,0,NaN,NaN
12,0.970,cougar,23-5,0,0,0,0,NaN,NaN
12,0.970,Ocean Water,16-23,0,0,0,0,NaN,NaN
12,0.970,Ocean Water,23-5,0,0,0,0,NaN,NaN
12,0.970,Red Tailed Hawk,16-23,0,0,0,0,NaN,NaN
12,0.970,Red Tailed Hawk,23-5,0,6,0,6,0.000,0.000
12,0.970,Dog,16-23,54,68,0,122,44.262,44.262
12,0.970,Dog,23-5,92,126,0,218,42.202,42.202
12,0.970,Human,16-23,1771,807,0,2578,68.697,68.697
12,0.970,Human,23-5,2177,644,0,2821,77.171,77.171
12,0.970,Wild Turkey,16-23,1,5,0,6,16.667,16.667
12,0.970,Wild Turkey,23-5,2,13,0,15,13.333,13.333
12,0.970,Clark Grebe,16-23,0,0,0,0,NaN,NaN
12,0.970,Clark Grebe,23-5,0,0,0,0,NaN,NaN
12,0.970,Seagull,16-23,0,0,0,0,NaN,NaN
12,0.970,Seagull,23-5,44,10,0,54,81.481,81.481
12,0.970,Surf Scoter,16-23,0,0,0,0,NaN,NaN
12,0.970,Surf Scoter,23-5,0,2,0,2,0.000,0.000
12,0.970,Pigeon,16-23,72,132,0,204,35.294,35.294
12,0.970,Pigeon,23-5,124,167,0,291,42.612,42.612
12,0.970,Pacific Ocean Water,16-23,0,0,0,0,NaN,NaN
12,0.970,Pacific Ocean Water,23-5,0,0,0,0,NaN,NaN
12,0.970,Cat,16-23,18,19,0,37,48.649,48.649
12,0.970,Cat,23-5,25,20,0,45,55.556,55.556
12,0.970,Horse,16-23,6,16,0,22,27.273,27.273
12,0.970,Horse,23-5,24,104,0,128,18.750,18.750
12,0.970,orangutan,16-23,0,0,0,0,NaN,NaN
12,0.970,orangutan,23-5,0,0,0,0,NaN,NaN
12,0.970,Bat,16-23,36,34,0,70,51.429,51.429
12,0.970,Bat,23-5,37,36,0,73,50.685,50.685
12,0.970,Deer,16-23,13,26,0,39,33.333,33.333
12,0.970,Deer,23-5,17,121,0,138,12.319,12.319
12,0.970,Great Horned Owl,16-23,0,0,0,0,NaN,NaN
12,0.970,Great Horned Owl,23-5,0,1,0,1,0.000,0.000
12,0.970,Freshwater Lagoon,16-23,0,0,0,0,NaN,NaN
12,0.970,Freshwater Lagoon,23-5,0,0,0,0,NaN,NaN
12,0.970,Unknown Avian,16-23,0,0,0,0,NaN,NaN
12,0.970,Unknown Avian,23-5,0,0,0,0,NaN,NaN
12,0.970,Human UTI,16-23,78,74,0,152,51.316,51.316
12,0.970,Human UTI,23-5,102,107,0,209,48.804,48.804
12,0.970,unknown,16-23,0,0,0,0,NaN,NaN
12,0.970,unknown,23-5,0,3,0,3,0.000,0.000
12,0.970,SLO Creek Water,16-23,0,0,0,0,NaN,NaN
12,0.970,SLO Creek Water,23-5,0,0,0,0,NaN,NaN
12,0.970,Pig/Swine,16-23,4,5,0,9,44.444,44.444
12,0.970,Pig/Swine,23-5,8,10,0,18,44.444,44.444
12,0.970,Klebsiella,16-23,0,0,0,0,NaN,NaN
12,0.970,Klebsiella,23-5,0,0,0,0,NaN,NaN
12,0.970,Hu Cw and Dg,16-23,6,8,0,14,42.857,42.857
12,0.970,Hu Cw and Dg,23-5,8,13,0,21,38.095,38.095
12,0.970,Ground Squirrel,16-23,82,45,0,127,64.567,64.567
12,0.970,Ground Squirrel,23-5,83,74,0,157,52.866,52.866
12,0.970,Opossum,16-23,0,0,0,0,NaN,NaN
12,0.970,Opossum,23-5,0,0,0,0,NaN,NaN
12,0.970,Cow,16-23,1550,1141,0,2691,57.599,57.599
12,0.970,Cow,23-5,1520,1489,0,3009,50.515,50.515
12,0.970,Deer Mouse,16-23,0,0,0,0,NaN,NaN
12,0.970,Deer Mouse,23-5,0,0,0,0,NaN,NaN
12,0.970,OVERALL,16-23,3786,2520,0,6306,60.038,60.038
12,0.970,OVERALL,23-5,4431,3130,0,7561,58.603,58.603
12,0.980,Chicken,16-23,0,1,0,1,0.000,0.000
12,0.980,Chicken,23-5,6,6,0,12,50.000,50.000
12,0.980,Sea Lion,16-23,0,0,0,0,NaN,NaN
12,0.980,Sea Lion,23-5,0,9,0,9,0.000,0.000
12,0.980,Hu and Cw,16-23,2,5,0,7,28.571,28.571
12,0.980,Hu and Cw,23-5,7,18,0,25,28.000,28.000
12,0.980,Sheep,16-23,48,50,0,98,48.980,48.980
12,0.980,Sheep,23-5,55,37,0,92,59.783,59.783
12,0.980,Hu and Dg,16-23,6,12,0,18,33.333,33.333
12,0.980,Hu and Dg,23-5,19,20,0,39,48.718,48.718
12,0.980,Common Loon,16-23,0,0,0,0,NaN,NaN
12,0.980,Common Loon,23-5,0,0,0,0,NaN,NaN
12,0.980,Red-Winged Blackbird,16-23,0,2,0,2,0.000,0.000
12,0.980,Red-Winged Blackbird,23-5,0,0,0,0,NaN,NaN
12,0.980,Cw,16-23,7,11,0,18,38.889,38.889
12,0.980,Cw,23-5,10,25,0,35,28.571,28.571
12,0.980,Cliff Sparrow,16-23,1,10,0,11,9.091,9.091
12,0.980,Cliff Sparrow,23-5,0,0,0,0,NaN,NaN
12,0.980,Pig,16-23,7,5,0,12,58.333,58.333
12,0.980,Pig,23-5,3,1,0,4,75.000,75.000
12,0.980,Barn Owl,16-23,0,0,0,0,NaN,NaN
12,0.980,Barn Owl,23-5,0,0,0,0,NaN,NaN
12,0.980,Wild Pig,16-23,0,0,0,0,NaN,NaN
12,0.980,Wild Pig,23-5,0,0,0,0,NaN,NaN
12,0.980,Pennington Creek Water,16-23,0,0,0,0,NaN,NaN
12,0.980,Pennington Creek Water,23-5,0,0,0,0,NaN,NaN
12,0.980,Guinni,16-23,0,0,0,0,NaN,NaN
12,0.980,Guinni,23-5,0,0,0,0,NaN,NaN
12,0.980,Racoon,16-23,0,0,0,0,NaN,NaN
12,0.980,Racoon,23-5,0,0,0,0,NaN,NaN
12,0.980,Hu,16-23,12,14,0,26,46.154,46.154
12,0.980,Hu,23-5,23,17,0,40,57.500,57.500
12,0.980,Cw and Dg,16-23,8,15,0,23,34.783,34.783
12,0.980,Cw and Dg,23-5,13,19,0,32,40.625,40.625
12,0.980,Red Wind Blackbird,16-23,0,0,0,0,NaN,NaN
12,0.980,Red Wind Blackbird,23-5,0,0,0,0,NaN,NaN
12,0.980,Tree Swallow,16-23,0,0,0,0,NaN,NaN
12,0.980,Tree Swallow,23-5,0,0,0,0,NaN,NaN
12,0.980,Turkey Vulture,16-23,0,0,0,0,NaN,NaN
12,0.980,Turkey Vulture,23-5,0,0,0,0,NaN,NaN
12,0.980,Dg,16-23,7,11,0,18,38.889,38.889
12,0.980,Dg,23-5,32,24,0,56,57.143,57.143
12,0.980,Western Kingbird,16-23,0,0,0,0,NaN,NaN
12,0.980,Western Kingbird,23-5,0,0,0,0,NaN,NaN
12,0.980,White Crowned Sparrow,16-23,0,0,0,0,NaN,NaN
12,0.980,White Crowned Sparrow,23-5,0,3,0,3,0.000,0.000
12,0.980,Eared Grebe,16-23,0,0,0,0,NaN,NaN
12,0.980,Eared Grebe,23-5,0,7,0,7,0.000,0.000
12,0.980,cougar,16-23,0,0,0,0,NaN,NaN
12,0.980,cougar,23-5,0,0,0,0,NaN,NaN
12,0.980,Ocean Water,16-23,0,0,0,0,NaN,NaN
12,0.980,Ocean Water,23-5,0,0,0,0,NaN,NaN
12,0.980,Red Tailed Hawk,16-23,0,0,0,0,NaN,NaN
12,0.980,Red Tailed Hawk,23-5,0,5,0,5,0.000,0.000
12,0.980,Dog,16-23,53,72,0,125,42.400,42.400
12,0.980,Dog,23-5,92,123,0,215,42.791,42.791
12,0.980,Human,16-23,1775,796,0,2571,69.039,69.039
12,0.980,Human,23-5,2179,629,0,2808,77.600,77.600
12,0.980,Wild Turkey,16-23,1,5,0,6,16.667,16.667
12,0.980,Wild Turkey,23-5,4,21,0,25,16.000,16.000
12,0.980,Clark Grebe,16-23,0,0,0,0,NaN,NaN
12,0.980,Clark Grebe,23-5,0,0,0,0,NaN,NaN
12,0.980,Seagull,16-23,0,0,0,0,NaN,NaN
12,0.980,Seagull,23-5,46,8,0,54,85.185,85.185
12,0.980,Surf Scoter,16-23,0,0,0,0,NaN,NaN
12,0.980,Surf Scoter,23-5,2,0,0,2,100.000,100.000
12,0.980,Pigeon,16-23,72,129,0,201,35.821,35.821
12,0.980,Pigeon,23-5,123,175,0,298,41.275,41.275
12,0.980,Pacific Ocean Water,16-23,0,0,0,0,NaN,NaN
12,0.980,Pacific Ocean Water,23-5,0,0,0,0,NaN,NaN
12,0.980,Cat,16-23,18,19,0,37,48.649,48.649
12,0.980,Cat,23-5,27,19,0,46,58.696,58.696
12,0.980,Horse,16-23,6,16,0,22,27.273,27.273
12,0.980,Horse,23-5,24,101,0,125,19.200,19.200
12,0.980,orangutan,16-23,0,0,0,0,NaN,NaN
12,0.980,orangutan,23-5,0,0,0,0,NaN,NaN
12,0.980,Bat,16-23,36,34,0,70,51.429,51.429
12,0.980,Bat,23-5,37,35,0,72,51.389,51.389
12,0.980,Deer,16-23,13,26,0,39,33.333,33.333
12,0.980,Deer,23-5,17,121,0,138,12.319,12.319
12,0.980,Great Horned Owl,16-23,0,0,0,0,NaN,NaN
12,0.980,Great Horned Owl,23-5,0,1,0,1,0.000,0.000
12,0.980,Freshwater Lagoon,16-23,0,0,0,0,NaN,NaN
12,0.980,Freshwater Lagoon,23-5,0,0,0,0,NaN,NaN
12,0.980,Unknown Avian,16-23,0,0,0,0,NaN,NaN
12,0.980,Unknown Avian,23-5,0,0,0,0,NaN,NaN
12,0.980,Human UTI,16-23,78,76,0,154,50.649,50.649
12,0.980,Human UTI,23-5,102,107,0,209,48.804,48.804
12,0.980,unknown,16-23,0,0,0,0,NaN,NaN
12,0.980,unknown,23-5,0,4,0,4,0.000,0.000
12,0.980,SLO Creek Water,16-23,0,0,0,0,NaN,NaN
12,0.980,SLO Creek Water,23-5,0,0,0,0,NaN,NaN
12,0.980,Pig/Swine,16-23,4,5,0,9,44.444,44.444
12,0.980,Pig/Swine,23-5,8,10,0,18,44.444,44.444
12,0.980,Klebsiella,16-23,0,0,0,0,NaN,NaN
12,0.980,Klebsiella,23-5,0,0,0,0,NaN,NaN
12,0.980,Hu Cw and Dg,16-23,6,8,0,14,42.857,42.857
12,0.980,Hu Cw and Dg,23-5,8,12,0,20,40.000,40.000
12,0.980,Ground Squirrel,16-23,85,47,0,132,64.394,64.394
12,0.980,Ground Squirrel,23-5,84,73,0,157,53.503,53.503
12,0.980,Opossum,16-23,0,0,0,0,NaN,NaN
12,0.980,Opossum,23-5,0,0,0,0,NaN,NaN
12,0.980,Cow,16-23,1544,1120,0,2664,57.958,57.958
12,0.980,Cow,23-5,1513,1458,0,2971,50.926,50.926
12,0.980,Deer Mouse,16-23,0,0,0,0,NaN,NaN
12,0.980,Deer Mouse,23-5,0,0,0,0,NaN,NaN
12,0.980,OVERALL,16-23,3789,2489,0,6278,60.354,60.354
12,0.980,OVERALL,23-5,4434,3088,0,7522,58.947,58.947
12,0.990,Chicken,16-23,2,6,0,8,25.000,25.000
12,0.990,Chicken,23-5,7,6,0,13,53.846,53.846
12,0.990,Sea Lion,16-23,0,0,0,0,NaN,NaN
12,0.990,Sea Lion,23-5,4,6,0,10,40.000,40.000
12,0.990,Hu and Cw,16-23,3,5,0,8,37.500,37.500
12,0.990,Hu and Cw,23-5,9,25,0,34,26.471,26.471
12,0.990,Sheep,16-23,47,50,0,97,48.454,48.454
12,0.990,Sheep,23-5,56,36,0,92,60.870,60.870
12,0.990,Hu and Dg,16-23,6,14,0,20,30.000,30.000
12,0.990,Hu and Dg,23-5,19,17,0,36,52.778,52.778
12,0.990,Common Loon,16-23,0,0,0,0,NaN,NaN
12,0.990,Common Loon,23-5,0,2,0,2,0.000,0.000
12,0.990,Red-Winged Blackbird,16-23,0,4,0,4,0.000,0.000
12,0.990,Red-Winged Blackbird,23-5,0,0,0,0,NaN,NaN
12,0.990,Cw,16-23,8,11,0,19,42.105,42.105
12,0.990,Cw,23-5,16,26,0,42,38.095,38.095
12,0.990,Cliff Sparrow,16-23,1,11,0,12,8.333,8.333
12,0.990,Cliff Sparrow,23-5,0,4,0,4,0.000,0.000
12,0.990,Pig,16-23,7,6,0,13,53.846,53.846
12,0.990,Pig,23-5,7,6,0,13,53.846,53.846
12,0.990,Barn Owl,16-23,0,0,0,0,NaN,NaN
12,0.990,Barn Owl,23-5,0,0,0,0,NaN,NaN
12,0.990,Wild Pig,16-23,0,1,0,1,0.000,0.000
12,0.990,Wild Pig,23-5,0,1,0,1,0.000,0.000
12,0.990,Pennington Creek Water,16-23,0,0,0,0,NaN,NaN
12,0.990,Pennington Creek Water,23-5,0,0,0,0,NaN,NaN
12,0.990,Guinni,16-23,0,0,0,0,NaN,NaN
12,0.990,Guinni,23-5,0,0,0,0,NaN,NaN
12,0.990,Racoon,16-23,0,0,0,0,NaN,NaN
12,0.990,Racoon,23-5,0,1,0,1,0.000,0.000
12,0.990,Hu,16-23,12,13,0,25,48.000,48.000
12,0.990,Hu,23-5,23,12,0,35,65.714,65.714
12,0.990,Cw and Dg,16-23,8,15,0,23,34.783,34.783
12,0.990,Cw and Dg,23-5,13,13,0,26,50.000,50.000
12,0.990,Red Wind Blackbird,16-23,0,0,0,0,NaN,NaN
12,0.990,Red Wind Blackbird,23-5,0,0,0,0,NaN,NaN
12,0.990,Tree Swallow,16-23,0,0,0,0,NaN,NaN
12,0.990,Tree Swallow,23-5,0,0,0,0,NaN,NaN
12,0.990,Turkey Vulture,16-23,0,0,0,0,NaN,NaN
12,0.990,Turkey Vulture,23-5,0,0,0,0,NaN,NaN
12,0.990,Dg,16-23,7,12,0,19,36.842,36.842
12,0.990,Dg,23-5,32,19,0,51,62.745,62.745
12,0.990,Western Kingbird,16-23,0,0,0,0,NaN,NaN
12,0.990,Western Kingbird,23-5,0,0,0,0,NaN,NaN
12,0.990,White Crowned Sparrow,16-23,0,0,0,0,NaN,NaN
12,0.990,White Crowned Sparrow,23-5,0,4,0,4,0.000,0.000
12,0.990,Eared Grebe,16-23,0,0,0,0,NaN,NaN
12,0.990,Eared Grebe,23-5,0,8,0,8,0.000,0.000
12,0.990,cougar,16-23,0,1,0,1,0.000,0.000
12,0.990,cougar,23-5,0,0,0,0,NaN,NaN
12,0.990,Ocean Water,16-23,0,0,0,0,NaN,NaN
12,0.990,Ocean Water,23-5,0,0,0,0,NaN,NaN
12,0.990,Red Tailed Hawk,16-23,0,0,0,0,NaN,NaN
12,0.990,Red Tailed Hawk,23-5,0,5,0,5,0.000,0.000
12,0.990,Dog,16-23,56,72,0,128,43.750,43.750
12,0.990,Dog,23-5,96,110,0,206,46.602,46.602
12,0.990,Human,16-23,1764,759,0,2523,69.917,69.917
12,0.990,Human,23-5,2173,579,0,2752,78.961,78.961
12,0.990,Wild Turkey,16-23,3,10,0,13,23.077,23.077
12,0.990,Wild Turkey,23-5,4,22,0,26,15.385,15.385
12,0.990,Clark Grebe,16-23,0,0,0,0,NaN,NaN
12,0.990,Clark Grebe,23-5,2,3,0,5,40.000,40.000
12,0.990,Seagull,16-23,0,0,0,0,NaN,NaN
12,0.990,Seagull,23-5,48,7,0,55,87.273,87.273
12,0.990,Surf Scoter,16-23,0,0,0,0,NaN,NaN
12,0.990,Surf Scoter,23-5,2,0,0,2,100.000,100.000
12,0.990,Pigeon,16-23,82,124,0,206,39.806,39.806
12,0.990,Pigeon,23-5,129,193,0,322,40.062,40.062
12,0.990,Pacific Ocean Water,16-23,0,0,0,0,NaN,NaN
12,0.990,Pacific Ocean Water,23-5,0,0,0,0,NaN,NaN
12,0.990,Cat,16-23,21,21,0,42,50.000,50.000
12,0.990,Cat,23-5,28,22,0,50,56.000,56.000
12,0.990,Horse,16-23,9,17,0,26,34.615,34.615
12,0.990,Horse,23-5,24,114,0,138,17.391,17.391
12,0.990,orangutan,16-23,0,0,0,0,NaN,NaN
12,0.990,orangutan,23-5,0,0,0,0,NaN,NaN
12,0.990,Bat,16-23,36,30,0,66,54.545,54.545
12,0.990,Bat,23-5,37,34,0,71,52.113,52.113
12,0.990,Deer,16-23,13,27,0,40,32.500,32.500
12,0.990,Deer,23-5,17,110,0,127,13.386,13.386
12,0.990,Great Horned Owl,16-23,0,0,0,0,NaN,NaN
12,0.990,Great Horned Owl,23-5,0,1,0,1,0.000,0.000
12,0.990,Freshwater Lagoon,16-23,0,0,0,0,NaN,NaN
12,0.990,Freshwater Lagoon,23-5,0,0,0,0,NaN,NaN
12,0.990,Unknown Avian,16-23,0,0,0,0,NaN,NaN
12,0.990,Unknown Avian,23-5,0,0,0,0,NaN,NaN
12,0.990,Human UTI,16-23,82,66,0,148,55.405,55.405
12,0.990,Human UTI,23-5,101,83,0,184,54.891,54.891
12,0.990,unknown,16-23,0,0,0,0,NaN,NaN
12,0.990,unknown,23-5,0,6,0,6,0.000,0.000
12,0.990,SLO Creek Water,16-23,0,0,0,0,NaN,NaN
12,0.990,SLO Creek Water,23-5,0,0,0,0,NaN,NaN
12,0.990,Pig/Swine,16-23,5,6,0,11,45.455,45.455
12,0.990,Pig/Swine,23-5,8,9,0,17,47.059,47.059
12,0.990,Klebsiella,16-23,0,0,0,0,NaN,NaN
12,0.990,Klebsiella,23-5,0,0,0,0,NaN,NaN
12,0.990,Hu Cw and Dg,16-23,6,8,0,14,42.857,42.857
12,0.990,Hu Cw and Dg,23-5,8,13,0,21,38.095,38.095
12,0.990,Ground Squirrel,16-23,88,47,0,135,65.185,65.185
12,0.990,Ground Squirrel,23-5,86,74,0,160,53.750,53.750
12,0.990,Opossum,16-23,1,0,0,1,100.000,100.000
12,0.990,Opossum,23-5,2,0,0,2,100.000,100.000
12,0.990,Cow,16-23,1509,1013,0,2522,59.833,59.833
12,0.990,Cow,23-5,1476,1328,0,2804,52.639,52.639
12,0.990,Deer Mouse,16-23,0,0,0,0,NaN,NaN
12,0.990,Deer Mouse,23-5,0,0,0,0,NaN,NaN
12,0.990,OVERALL,16-23,3776,2349,0,6125,61.649,61.649
12,0.990,OVERALL,23-5,4427,2899,0,7326,60.429,60.429
12,1.000,Chicken,16-23,0,0,0,0,NaN,NaN
12,1.000,Chicken,23-5,0,0,0,0,NaN,NaN
12,1.000,Sea Lion,16-23,0,0,0,0,NaN,NaN
12,1.000,Sea Lion,23-5,0,0,0,0,NaN,NaN
12,1.000,Hu and Cw,16-23,0,0,0,0,NaN,NaN
12,1.000,Hu and Cw,23-5,0,0,0,0,NaN,NaN
12,1.000,Sheep,16-23,0,0,0,0,NaN,NaN
12,1.000,Sheep,23-5,0,0,0,0,NaN,NaN
12,1.000,Hu and Dg,16-23,0,0,0,0,NaN,NaN
12,1.000,Hu and Dg,23-5,0,0,0,0,NaN,NaN
12,1.000,Common Loon,16-23,0,0,0,0,NaN,NaN
12,1.000,Common Loon,23-5,0,0,0,0,NaN,NaN
12,1.000,Red-Winged Blackbird,16-23,0,0,0,0,NaN,NaN
12,1.000,Red-Winged Blackbird,23-5,0,0,0,0,NaN,NaN
12,1.000,Cw,16-23,0,0,0,0,NaN,NaN
12,1.000,Cw,23-5,0,0,0,0,NaN,NaN
12,1.000,Cliff Sparrow,16-23,0,0,0,0,NaN,NaN
12,1.000,Cliff Sparrow,23-5,0,0,0,0,NaN,NaN
12,1.000,Pig,16-23,0,0,0,0,NaN,NaN
12,1.000,Pig,23-5,0,0,0,0,NaN,NaN
12,1.000,Barn Owl,16-23,0,0,0,0,NaN,NaN
12,1.000,Barn Owl,23-5,0,0,0,0,NaN,NaN
12,1.000,Wild Pig,16-23,0,0,0,0,NaN,NaN
12,1.000,Wild Pig,23-5,0,0,0,0,NaN,NaN
12,1.000,Pennington Creek Water,16-23,0,0,0,0,NaN,NaN
12,1.000,Pennington Creek Water,23-5,0,0,0,0,NaN,NaN
12,1.000,Guinni,16-23,0,0,0,0,NaN,NaN
12,1.000,Guinni,23-5,0,0,0,0,NaN,NaN
12,1.000,Racoon,16-23,0,0,0,0,NaN,NaN
12,1.000,Racoon,23-5,0,0,0,0,NaN,NaN
12,1.000,Hu,16-23,0,0,0,0,NaN,NaN
12,1.000,Hu,23-5,0,0,0,0,NaN,NaN
12,1.000,Cw and Dg,16-23,0,0,0,0,NaN,NaN
12,1.000,Cw and Dg,23-5,0,0,0,0,NaN,NaN
12,1.000,Red Wind Blackbird,16-23,0,0,0,0,NaN,NaN
12,1.000,Red Wind Blackbird,23-5,0,0,0,0,NaN,NaN
12,1.000,Tree Swallow,16-23,0,0,0,0,NaN,NaN
12,1.000,Tree Swallow,23-5,0,0,0,0,NaN,NaN
12,1.000,Turkey Vulture,16-23,0,0,0,0,NaN,NaN
12,1.000,Turkey Vulture,23-5,0,0,0,0,NaN,NaN
12,1.000,Dg,16-23,0,0,0,0,NaN,NaN
12,1.000,Dg,23-5,0,0,0,0,NaN,NaN
12,1.000,Western Kingbird,16-23,0,0,0,0,NaN,NaN
12,1.000,Western Kingbird,23-5,0,0,0,0,NaN,NaN
12,1.000,White Crowned Sparrow,16-23,0,0,0,0,NaN,NaN
12,1.000,White Crowned Sparrow,23-5,0,0,0,0,NaN,NaN
12,1.000,Eared Grebe,16-23,0,0,0,0,NaN,NaN
12,1.000,Eared Grebe,23-5,0,0,0,0,NaN,NaN
12,1.000,cougar,16-23,0,0,0,0,NaN,NaN
12,1.000,cougar,23-5,0,0,0,0,NaN,NaN
12,1.000,Ocean Water,16-23,0,0,0,0,NaN,NaN
12,1.000,Ocean Water,23-5,0,0,0,0,NaN,NaN
12,1.000,Red Tailed Hawk,16-23,0,0,0,0,NaN,NaN
12,1.000,Red Tailed Hawk,23-5,0,0,0,0,NaN,NaN
12,1.000,Dog,16-23,0,0,0,0,NaN,NaN
12,1.000,Dog,23-5,0,0,0,0,NaN,NaN
12,1.000,Human,16-23,68,0,0,68,100.000,100.000
12,1.000,Human,23-5,90,0,0,90,100.000,100.000
12,1.000,Wild Turkey,16-23,0,0,0,0,NaN,NaN
12,1.000,Wild Turkey,23-5,0,0,0,0,NaN,NaN
12,1.000,Clark Grebe,16-23,0,0,0,0,NaN,NaN
12,1.000,Clark Grebe,23-5,0,0,0,0,NaN,NaN
12,1.000,Seagull,16-23,0,0,0,0,NaN,NaN
12,1.000,Seagull,23-5,0,0,0,0,NaN,NaN
12,1.000,Surf Scoter,16-23,0,0,0,0,NaN,NaN
12,1.000,Surf Scoter,23-5,0,0,0,0,NaN,NaN
12,1.000,Pigeon,16-23,0,0,0,0,NaN,NaN
12,1.000,Pigeon,23-5,0,0,0,0,NaN,NaN
12,1.000,Pacific Ocean Water,16-23,0,0,0,0,NaN,NaN
12,1.000,Pacific Ocean Water,23-5,0,0,0,0,NaN,NaN
12,1.000,Cat,16-23,0,0,0,0,NaN,NaN
12,1.000,Cat,23-5,0,0,0,0,NaN,NaN
12,1.000,Horse,16-23,0,0,0,0,NaN,NaN
12,1.000,Horse,23-5,0,0,0,0,NaN,NaN
12,1.000,orangutan,16-23,0,0,0,0,NaN,NaN
12,1.000,orangutan,23-5,0,0,0,0,NaN,NaN
12,1.000,Bat,16-23,0,0,0,0,NaN,NaN
12,1.000,Bat,23-5,0,0,0,0,NaN,NaN
12,1.000,Deer,16-23,0,0,0,0,NaN,NaN
12,1.000,Deer,23-5,0,0,0,0,NaN,NaN
12,1.000,Great Horned Owl,16-23,0,0,0,0,NaN,NaN
12,1.000,Great Horned Owl,23-5,0,0,0,0,NaN,NaN
12,1.000,Freshwater Lagoon,16-23,0,0,0,0,NaN,NaN
12,1.000,Freshwater Lagoon,23-5,0,0,0,0,NaN,NaN
12,1.000,Unknown Avian,16-23,0,0,0,0,NaN,NaN
12,1.000,Unknown Avian,23-5,0,0,0,0,NaN,NaN
12,1.000,Human UTI,16-23,0,0,0,0,NaN,NaN
12,1.000,Human UTI,23-5,0,0,0,0,NaN,NaN
12,1.000,unknown,16-23,0,0,0,0,NaN,NaN
12,1.000,unknown,23-5,0,0,0,0,NaN,NaN
12,1.000,SLO Creek Water,16-23,0,0,0,0,NaN,NaN
12,1.000,SLO Creek Water,23-5,0,0,0,0,NaN,NaN
12,1.000,Pig/Swine,16-23,0,0,0,0,NaN,NaN
12,1.000,Pig/Swine,23-5,0,0,0,0,NaN,NaN
12,1.000,Klebsiella,16-23,0,0,0,0,NaN,NaN
12,1.000,Klebsiella,23-5,0,0,0,0,NaN,NaN
12,1.000,Hu Cw and Dg,16-23,0,0,0,0,NaN,NaN
12,1.000,Hu Cw and Dg,23-5,0,0,0,0,NaN,NaN
12,1.000,Ground Squirrel,16-23,0,0,0,0,NaN,NaN
12,1.000,Ground Squirrel,23-5,0,0,0,0,NaN,NaN
12,1.000,Opossum,16-23,0,0,0,0,NaN,NaN
12,1.000,Opossum,23-5,0,0,0,0,NaN,NaN
12,1.000,Cow,16-23,0,0,0,0,NaN,NaN
12,1.000,Cow,23-5,0,0,0,0,NaN,NaN
12,1.000,Deer Mouse,16-23,0,0,0,0,NaN,NaN
12,1.000,Deer Mouse,23-5,0,0,0,0,NaN,NaN
12,1.000,OVERALL,16-23,68,0,0,68,100.000,100.000
12,1.000,OVERALL,23-5,90,0,0,90,100.000,100.000
13,0.000,Chicken,16-23,0,0,0,0,NaN,NaN
13,0.000,Chicken,23-5,4,6,0,10,40.000,40.000
13,0.000,Sea Lion,16-23,0,0,0,0,NaN,NaN
13,0.000,Sea Lion,23-5,0,10,0,10,0.000,0.000
13,0.000,Hu and Cw,16-23,1,5,0,6,16.667,16.667
13,0.000,Hu and Cw,23-5,8,8,0,16,50.000,50.000
13,0.000,Sheep,16-23,44,52,0,96,45.833,45.833
13,0.000,Sheep,23-5,55,34,0,89,61.798,61.798
13,0.000,Hu and Dg,16-23,6,9,0,15,40.000,40.000
13,0.000,Hu and Dg,23-5,20,27,0,47,42.553,42.553
13,0.000,Common Loon,16-23,0,0,0,0,NaN,NaN
13,0.000,Common Loon,23-5,0,0,0,0,NaN,NaN
13,0.000,Red-Winged Blackbird,16-23,0,0,0,0,NaN,NaN
13,0.000,Red-Winged Blackbird,23-5,0,0,0,0,NaN,NaN
13,0.000,Cw,16-23,6,10,0,16,37.500,37.500
13,0.000,Cw,23-5,7,18,0,25,28.000,28.000
13,0.000,Cliff Sparrow,16-23,1,8,0,9,11.111,11.111
13,0.000,Cliff Sparrow,23-5,0,0,0,0,NaN,NaN
13,0.000,Pig,16-23,6,5,0,11,54.545,54.545
13,0.000,Pig,23-5,0,1,0,1,0.000,0.000
13,0.000,Barn Owl,16-23,0,0,0,0,NaN,NaN
13,0.000,Barn Owl,23-5,0,0,0,0,NaN,NaN
13,0.000,Wild Pig,16-23,0,0,0,0,NaN,NaN
13,0.000,Wild Pig,23-5,0,0,0,0,NaN,NaN
13,0.000,Pennington Creek Water,16-23,0,0,0,0,NaN,NaN
13,0.000,Pennington Creek Water,23-5,0,0,0,0,NaN,NaN
13,0.000,Guinni,16-23,0,0,0,0,NaN,NaN
13,0.000,Guinni,23-5,0,0,0,0,NaN,NaN
13,0.000,Racoon,16-23,0,0,0,0,NaN,NaN
13,0.000,Racoon,23-5,0,0,0,0,NaN,NaN
13,0.000,Hu,16-23,11,10,0,21,52.381,52.381
13,0.000,Hu,23-5,23,17,0,40,57.500,57.500
13,0.000,Cw and Dg,16-23,8,15,0,23,34.783,34.783
13,0.000,Cw and Dg,23-5,12,14,0,26,46.154,46.154
13,0.000,Red Wind Blackbird,16-23,0,0,0,0,NaN,NaN
13,0.000,Red Wind Blackbird,23-5,0,0,0,0,NaN,NaN
13,0.000,Tree Swallow,16-23,0,0,0,0,NaN,NaN
13,0.000,Tree Swallow,23-5,0,0,0,0,NaN,NaN
13,0.000,Turkey Vulture,16-23,0,0,0,0,NaN,NaN
13,0.000,Turkey Vulture,23-5,0,0,0,0,NaN,NaN
13,0.000,Dg,16-23,6,9,0,15,40.000,40.000
13,0.000,Dg,23-5,31,32,0,63,49.206,49.206
13,0.000,Western Kingbird,16-23,0,0,0,0,NaN,NaN
13,0.000,Western Kingbird,23-5,0,0,0,0,NaN,NaN
13,0.000,White Crowned Sparrow,16-23,0,0,0,0,NaN,NaN
13,0.000,White Crowned Sparrow,23-5,0,1,0,1,0.000,0.000
13,0.000,Eared Grebe,16-23,0,0,0,0,NaN,NaN
13,0.000,Eared Grebe,23-5,0,4,0,4,0.000,0.000
13,0.000,cougar,16-23,0,0,0,0,NaN,NaN
13,0.000,cougar,23-5,0,0,0,0,NaN,NaN
13,0.000,Ocean Water,16-23,0,0,0,0,NaN,NaN
13,0.000,Ocean Water,23-5,0,0,0,0,NaN,NaN
13,0.000,Red Tailed Hawk,16-23,0,0,0,0,NaN,NaN
13,0.000,Red Tailed Hawk,23-5,0,2,0,2,0.000,0.000
13,0.000,Dog,16-23,53,67,0,120,44.167,44.167
13,0.000,Dog,23-5,88,133,0,221,39.819,39.819
13,0.000,Human,16-23,1762,827,0,2589,68.057,68.057
13,0.000,Human,23-5,2175,686,0,2861,76.022,76.022
13,0.000,Wild Turkey,16-23,1,2,0,3,33.333,33.333
13,0.000,Wild Turkey,23-5,0,6,0,6,0.000,0.000
13,0.000,Clark Grebe,16-23,0,0,0,0,NaN,NaN
13,0.000,Clark Grebe,23-5,0,0,0,0,NaN,NaN
13,0.000,Seagull,16-23,0,0,0,0,NaN,NaN
13,0.000,Seagull,23-5,44,8,0,52,84.615,84.615
13,0.000,Surf Scoter,16-23,0,0,0,0,NaN,NaN
13,0.000,Surf Scoter,23-5,0,0,0,0,NaN,NaN
13,0.000,Pigeon,16-23,61,133,0,194,31.443,31.443
13,0.000,Pigeon,23-5,116,129,0,245,47.347,47.347
13,0.000,Pacific Ocean Water,16-23,0,0,0,0,NaN,NaN
13,0.000,Pacific Ocean Water,23-5,0,0,0,0,NaN,NaN
13,0.000,Cat,16-23,18,19,0,37,48.649,48.649
13,0.000,Cat,23-5,20,16,0,36,55.556,55.556
13,0.000,Horse,16-23,6,14,0,20,30.000,30.000
13,0.000,Horse,23-5,22,86,0,108,20.370,20.370
13,0.000,orangutan,16-23,0,0,0,0,NaN,NaN
13,0.000,orangutan,23-5,0,0,0,0,NaN,NaN
13,0.000,Bat,16-23,36,35,0,71,50.704,50.704
13,0.000,Bat,23-5,37,36,0,73,50.685,50.685
13,0.000,Deer,16-23,11,26,0,37,29.730,29.730
13,0.000,Deer,23-5,17,125,0,142,11.972,11.972
13,0.000,Great Horned Owl,16-23,0,0,0,0,NaN,NaN
13,0.000,Great Horned Owl,23-5,0,1,0,1,0.000,0.000
13,0.000,Freshwater Lagoon,16-23,0,0,0,0,NaN,NaN
13,0.000,Freshwater Lagoon,23-5,0,0,0,0,NaN,NaN
13,0.000,Unknown Avian,16-23,0,0,0,0,NaN,NaN
13,0.000,Unknown Avian,23-5,0,0,0,0,NaN,NaN
13,0.000,Human UTI,16-23,74,65,0,139,53.237,53.237
13,0.000,Human UTI,23-5,98,113,0,211,46.445,46.445
13,0.000,unknown,16-23,0,0,0,0,NaN,NaN
13,0.000,unknown,23-5,0,2,0,2,0.000,0.000
13,0.000,SLO Creek Water,16-23,0,0,0,0,NaN,NaN
13,0.000,SLO Creek Water,23-5,0,0,0,0,NaN,NaN
13,0.000,Pig/Swine,16-23,3,5,0,8,37.500,37.500
13,0.000,Pig/Swine,23-5,9,10,0,19,47.368,47.368
13,0.000,Klebsiella,16-23,0,0,0,0,NaN,NaN
13,0.000,Klebsiella,23-5,0,0,0,0,NaN,NaN
13,0.000,Hu Cw and Dg,16-23,5,8,0,13,38.462,38.462
13,0.000,Hu Cw and Dg,23-5,6,10,0,16,37.500,37.500
13,0.000,Ground Squirrel,16-23,76,45,0,121,62.810,62.810
13,0.000,Ground Squirrel,23-5,81,67,0,148,54.730,54.730
13,0.000,Opossum,16-23,0,0,0,0,NaN,NaN
13,0.000,Opossum,23-5,0,0,0,0,NaN,NaN
13,0.000,Cow,16-23,1563,1221,0,2784,56.142,56.142
13,0.000,Cow,23-5,1545,1590,0,3135,49.282,49.282
13,0.000,Deer Mouse,16-23,0,0,0,0,NaN,NaN
13,0.000,Deer Mouse,23-5,0,0,0,0,NaN,NaN
13,0.000,OVERALL,16-23,3758,2590,0,6348,59.200,59.200
13,0.000,OVERALL,23-5,4418,3192,0,7610,58.055,58.055
13,0.500,Chicken,16-23,0,0,0,0,NaN,NaN
13,0.500,Chicken,23-5,4,6,0,10,40.000,40.000
13,0.500,Sea Lion,16-23,0,0,0,0,NaN,NaN
13,0.500,Sea Lion,23-5,0,10,0,10,0.000,0.000
13,0.500,Hu and Cw,16-23,1,5,0,6,16.667,16.667
13,0.500,Hu and Cw,23-5,8,8,0,16,50.000,50.000
13,0.500,Sheep,16-23,44,52,0,96,45.833,45.833
13,0.500,Sheep,23-5,55,34,0,89,61.798,61.798
13,0.500,Hu and Dg,16-23,6,9,0,15,40.000,40.000
13,0.500,Hu and Dg,23-5,20,27,0,47,42.553,42.553
13,0.500,Common Loon,16-23,0,0,0,0,NaN,NaN
13,0.500,Common Loon,23-5,0,0,0,0,NaN,NaN
13,0.500,Red-Winged Blackbird,16-23,0,0,0,0,NaN,NaN
13,0.500,Red-Winged Blackbird,23-5,0,0,0,0,NaN,NaN
13,0.500,Cw,16-23,6,10,0,16,37.500,37.500
13,0.500,Cw,23-5,7,18,0,25,28.000,28.000
13,0.500,Cliff Sparrow,16-23,1,8,0,9,11.111,11.111
13,0.500,Cliff Sparrow,23-5,0,0,0,0,NaN,NaN
13,0.500,Pig,16-23,6,5,0,11,54.545,54.545
13,0.500,Pig,23-5,0,1,0,1,0.000,0.000
13,0.500,Barn Owl,16-23,0,0,0,0,NaN,NaN
13,0.500,Barn Owl,23-5,0,0,0,0,NaN,NaN
13,0.500,Wild Pig,16-23,0,0,0,0,NaN,NaN
13,0.500,Wild Pig,23-5,0,0,0,0,NaN,NaN
13,0.500,Pennington Creek Water,16-23,0,0,0,0,NaN,NaN
13,0.500,Pennington Creek Water,23-5,0,0,0,0,NaN,NaN
13,0.500,Guinni,16-23,0,0,0,0,NaN,NaN
13,0.500,Guinni,23-5,0,0,0,0,NaN,NaN
13,0.500,Racoon,16-23,0,0,0,0,NaN,NaN
13,0.500,Racoon,23-5,0,0,0,0,NaN,NaN
13,0.500,Hu,16-23,11,10,0,21,52.381,52.381
13,0.500,Hu,23-5,23,17,0,40,57.500,57.500
13,0.500,Cw and Dg,16-23,8,15,0,23,34.783,34.783
13,0.500,Cw and Dg,23-5,12,14,0,26,46.154,46.154
13,0.500,Red Wind Blackbird,16-23,0,0,0,0,NaN,NaN
13,0.500,Red Wind Blackbird,23-5,0,0,0,0,NaN,NaN
13,0.500,Tree Swallow,16-23,0,0,0,0,NaN,NaN
13,0.500,Tree Swallow,23-5,0,0,0,0,NaN,NaN
13,0.500,Turkey Vulture,16-23,0,0,0,0,NaN,NaN
13,0.500,Turkey Vulture,23-5,0,0,0,0,NaN,NaN
13,0.500,Dg,16-23,6,9,0,15,40.000,40.000
13,0.500,Dg,23-5,31,32,0,63,49.206,49.206
13,0.500,Western Kingbird,16-23,0,0,0,0,NaN,NaN
13,0.500,Western Kingbird,23-5,0,0,0,0,NaN,NaN
13,0.500,White Crowned Sparrow,16-23,0,0,0,0,NaN,NaN
13,0.500,White Crowned Sparrow,23-5,0,1,0,1,0.000,0.000
13,0.500,Eared Grebe,16-23,0,0,0,0,NaN,NaN
13,0.500,Eared Grebe,23-5,0,4,0,4,0.000,0.000
13,0.500,cougar,16-23,0,0,0,0,NaN,NaN
13,0.500,cougar,23-5,0,0,0,0,NaN,NaN
13,0.500,Ocean Water,16-23,0,0,0,0,NaN,NaN
13,0.500,Ocean Water,23-5,0,0,0,0,NaN,NaN
13,0.500,Red Tailed Hawk,16-23,0,0,0,0,NaN,NaN
13,0.500,Red Tailed Hawk,23-5,0,2,0,2,0.000,0.000
13,0.500,Dog,16-23,53,67,0,120,44.167,44.167
13,0.500,Dog,23-5,88,133,0,221,39.819,39.819
13,0.500,Human,16-23,1762,827,0,2589,68.057,68.057
13,0.500,Human,23-5,2175,686,0,2861,76.022,76.022
13,0.500,Wild Turkey,16-23,1,2,0,3,33.333,33.333
13,0.500,Wild Turkey,23-5,0,6,0,6,0.000,0.000
13,0.500,Clark Grebe,16-23,0,0,0,0,NaN,NaN
13,0.500,Clark Grebe,23-5,0,0,0,0,NaN,NaN
13,0.500,Seagull,16-23,0,0,0,0,NaN,NaN
13,0.500,Seagull,23-5,44,8,0,52,84.615,84.615
13,0.500,Surf Scoter,16-23,0,0,0,0,NaN,NaN
13,0.500,Surf Scoter,23-5,0,0,0,0,NaN,NaN
13,0.500,Pigeon,16-23,61,133,0,194,31.443,31.443
13,0.500,Pigeon,23-5,116,129,0,245,47.347,47.347
13,0.500,Pacific Ocean Water,16-23,0,0,0,0,NaN,NaN
13,0.500,Pacific Ocean Water,23-5,0,0,0,0,NaN,NaN
13,0.500,Cat,16-23,18,19,0,37,48.649,48.649
13,0.500,Cat,23-5,20,16,0,36,55.556,55.556
13,0.500,Horse,16-23,6,14,0,20,30.000,30.000
13,0.500,Horse,23-5,22,86,0,108,20.370,20.370
13,0.500,orangutan,16-23,0,0,0,0,NaN,NaN
13,0.500,orangutan,23-5,0,0,0,0,NaN,NaN
13,0.500,Bat,16-23,36,35,0,71,50.704,50.704
13,0.500,Bat,23-5,37,36,0,73,50.685,50.685
13,0.500,Deer,16-23,11,26,0,37,29.730,29.730
13,0.500,Deer,23-5,17,125,0,142,11.972,11.972
13,0.500,Great Horned Owl,16-23,0,0,0,0,NaN,NaN
13,0.500,Great Horned Owl,23-5,0,1,0,1,0.000,0.000
13,0.500,Freshwater Lagoon,16-23,0,0,0,0,NaN,NaN
13,0.500,Freshwater Lagoon,23-5,0,0,0,0,NaN,NaN
13,0.500,Unknown Avian,16-23,0,0,0,0,NaN,NaN
13,0.500,Unknown Avian,23-5,0,0,0,0,NaN,NaN
13,0.500,Human UTI,16-23,74,65,0,139,53.237,53.237
13,0.500,Human UTI,23-5,98,113,0,211,46.445,46.445
13,0.500,unknown,16-23,0,0,0,0,NaN,NaN
13,0.500,unknown,23-5,0,2,0,2,0.000,0.000
13,0.500,SLO Creek Water,16-23,0,0,0,0,NaN,NaN
13,0.500,SLO Creek Water,23-5,0,0,0,0,NaN,NaN
13,0.500,Pig/Swine,16-23,3,5,0,8,37.500,37.500
13,0.500,Pig/Swine,23-5,9,10,0,19,47.368,47.368
13,0.500,Klebsiella,16-23,0,0,0,0,NaN,NaN
13,0.500,Klebsiella,23-5,0,0,0,0,NaN,NaN
13,0.500,Hu Cw and Dg,16-23,5,8,0,13,38.462,38.462
13,0.500,Hu Cw and Dg,23-5,6,10,0,16,37.500,37.500
13,0.500,Ground Squirrel,16-23,76,45,0,121,62.810,62.810
13,0.500,Ground Squirrel,23-5,81,67,0,148,54.730,54.730
13,0.500,Opossum,16-23,0,0,0,0,NaN,NaN
13,0.500,Opossum,23-5,0,0,0,0,NaN,NaN
13,0.500,Cow,16-23,1563,1221,0,2784,56.142,56.142
13,0.500,Cow,23-5,1545,1590,0,3135,49.282,49.282
13,0.500,Deer Mouse,16-23,0,0,0,0,NaN,NaN
13,0.500,Deer Mouse,23-5,0,0,0,0,NaN,NaN
13,0.500,OVERALL,16-23,3758,2590,0,6348,59.200,59.200
13,0.500,OVERALL,23-5,4418,3192,0,7610,58.055,58.055
13,0.900,Chicken,16-23,0,0,0,0,NaN,NaN
13,0.900,Chicken,23-5,4,6,0,10,40.000,40.000
13,0.900,Sea Lion,16-23,0,0,0,0,NaN,NaN
13,0.900,Sea Lion,23-5,0,10,0,10,0.000,0.000
13,0.900,Hu and Cw,16-23,1,5,0,6,16.667,16.667
13,0.900,Hu and Cw,23-5,8,8,0,16,50.000,50.000
13,0.900,Sheep,16-23,44,52,0,96,45.833,45.833
13,0.900,Sheep,23-5,55,34,0,89,61.798,61.798
13,0.900,Hu and Dg,16-23,6,9,0,15,40.000,40.000
13,0.900,Hu and Dg,23-5,20,27,0,47,42.553,42.553
13,0.900,Common Loon,16-23,0,0,0,0,NaN,NaN
13,0.900,Common Loon,23-5,0,0,0,0,NaN,NaN
13,0.900,Red-Winged Blackbird,16-23,0,0,0,0,NaN,NaN
13,0.900,Red-Winged Blackbird,23-5,0,0,0,0,NaN,NaN
13,0.900,Cw,16-23,6,10,0,16,37.500,37.500
13,0.900,Cw,23-5,7,18,0,25,28.000,28.000
13,0.900,Cliff Sparrow,16-23,1,8,0,9,11.111,11.111
13,0.900,Cliff Sparrow,23-5,0,0,0,0,NaN,NaN
13,0.900,Pig,16-23,6,5,0,11,54.545,54.545
13,0.900,Pig,23-5,0,1,0,1,0.000,0.000
13,0.900,Barn Owl,16-23,0,0,0,0,NaN,NaN
13,0.900,Barn Owl,23-5,0,0,0,0,NaN,NaN
13,0.900,Wild Pig,16-23,0,0,0,0,NaN,NaN
13,0.900,Wild Pig,23-5,0,0,0,0,NaN,NaN
13,0.900,Pennington Creek Water,16-23,0,0,0,0,NaN,NaN
13,0.900,Pennington Creek Water,23-5,0,0,0,0,NaN,NaN
13,0.900,Guinni,16-23,0,0,0,0,NaN,NaN
13,0.900,Guinni,23-5,0,0,0,0,NaN,NaN
13,0.900,Racoon,16-23,0,0,0,0,NaN,NaN
13,0.900,Racoon,23-5,0,0,0,0,NaN,NaN
13,0.900,Hu,16-23,11,10,0,21,52.381,52.381
13,0.900,Hu,23-5,23,17,0,40,57.500,57.500
13,0.900,Cw and Dg,16-23,8,15,0,23,34.783,34.783
13,0.900,Cw and Dg,23-5,12,14,0,26,46.154,46.154
13,0.900,Red Wind Blackbird,16-23,0,0,0,0,NaN,NaN
13,0.900,Red Wind Blackbird,23-5,0,0,0,0,NaN,NaN
13,0.900,Tree Swallow,16-23,0,0,0,0,NaN,NaN
13,0.900,Tree Swallow,23-5,0,0,0,0,NaN,NaN
13,0.900,Turkey Vulture,16-23,0,0,0,0,NaN,NaN
13,0.900,Turkey Vulture,23-5,0,0,0,0,NaN,NaN
13,0.900,Dg,16-23,6,9,0,15,40.000,40.000
13,0.900,Dg,23-5,31,32,0,63,49.206,49.206
13,0.900,Western Kingbird,16-23,0,0,0,0,NaN,NaN
13,0.900,Western Kingbird,23-5,0,0,0,0,NaN,NaN
13,0.900,White Crowned Sparrow,16-23,0,0,0,0,NaN,NaN
13,0.900,White Crowned Sparrow,23-5,0,1,0,1,0.000,0.000
13,0.900,Eared Grebe,16-23,0,0,0,0,NaN,NaN
13,0.900,Eared Grebe,23-5,0,4,0,4,0.000,0.000
13,0.900,cougar,16-23,0,0,0,0,NaN,NaN
13,0.900,cougar,23-5,0,0,0,0,NaN,NaN
13,0.900,Ocean Water,16-23,0,0,0,0,NaN,NaN
13,0.900,Ocean Water,23-5,0,0,0,0,NaN,NaN
13,0.900,Red Tailed Hawk,16-23,0,0,0,0,NaN,NaN
13,0.900,Red Tailed Hawk,23-5,0,2,0,2,0.000,0.000
13,0.900,Dog,16-23,53,67,0,120,44.167,44.167
13,0.900,Dog,23-5,88,129,0,217,40.553,40.553
13,0.900,Human,16-23,1762,826,0,2588,68.083,68.083
13,0.900,Human,23-5,2175,681,0,2856,76.155,76.155
13,0.900,Wild Turkey,16-23,1,2,0,3,33.333,33.333
13,0.900,Wild Turkey,23-5,0,6,0,6,0.000,0.000
13,0.900,Clark Grebe,16-23,0,0,0,0,NaN,NaN
13,0.900,Clark Grebe,23-5,0,0,0,0,NaN,NaN
13,0.900,Seagull,16-23,0,0,0,0,NaN,NaN
13,0.900,Seagull,23-5,44,9,0,53,83.019,83.019
13,0.900,Surf Scoter,16-23,0,0,0,0,NaN,NaN
13,0.900,Surf Scoter,23-5,0,0,0,0,NaN,NaN
13,0.900,Pigeon,16-23,61,134,0,195,31.282,31.282
13,0.900,Pigeon,23-5,116,129,0,245,47.347,47.347
13,0.900,Pacific Ocean Water,16-23,0,0,0,0,NaN,NaN
13,0.900,Pacific Ocean Water,23-5,0,0,0,0,NaN,NaN
13,0.900,Cat,16-23,18,19,0,37,48.649,48.649
13,0.900,Cat,23-5,20,16,0,36,55.556,55.556
13,0.900,Horse,16-23,6,14,0,20,30.000,30.000
13,0.900,Horse,23-5,22,86,0,108,20.370,20.370
13,0.900,orangutan,16-23,0,0,0,0,NaN,NaN
13,0.900,orangutan,23-5,0,0,0,0,NaN,NaN
13,0.900,Bat,16-23,36,35,0,71,50.704,50.704
13,0.900,Bat,23-5,37,36,0,73,50.685,50.685
13,0.900,Deer,16-23,11,26,0,37,29.730,29.730
13,0.900,Deer,23-5,17,125,0,142,11.972,11.972
13,0.900,Great Horned Owl,16-23,0,0,0,0,NaN,NaN
13,0.900,Great Horned Owl,23-5,0,1,0,1,0.000,0.000
13,0.900,Freshwater Lagoon,16-23,0,0,0,0,NaN,NaN
13,0.900,Freshwater Lagoon,23-5,0,0,0,0,NaN,NaN
13,0.900,Unknown Avian,16-23,0,0,0,0,NaN,NaN
13,0.900,Unknown Avian,23-5,0,0,0,0,NaN,NaN
13,0.900,Human UTI,16-23,74,65,0,139,53.237,53.237
13,0.900,Human UTI,23-5,101,113,0,214,47.196,47.196
13,0.900,unknown,16-23,0,0,0,0,NaN,NaN
13,0.900,unknown,23-5,0,2,0,2,0.000,0.000
13,0.900,SLO Creek Water,16-23,0,0,0,0,NaN,NaN
13,0.900,SLO Creek Water,23-5,0,0,0,0,NaN,NaN
13,0.900,Pig/Swine,16-23,3,5,0,8,37.500,37.500
13,0.900,Pig/Swine,23-5,9,10,0,19,47.368,47.368
13,0.900,Klebsiella,16-23,0,0,0,0,NaN,NaN
13,0.900,Klebsiella,23-5,0,0,0,0,NaN,NaN
13,0.900,Hu Cw and Dg,16-23,5,8,0,13,38.462,38.462
13,0.900,Hu Cw and Dg,23-5,6,10,0,16,37.500,37.500
13,0.900,Ground Squirrel,16-23,76,45,0,121,62.810,62.810
13,0.900,Ground Squirrel,23-5,81,67,0,148,54.730,54.730
13,0.900,Opossum,16-23,0,0,0,0,NaN,NaN
13,0.900,Opossum,23-5,0,0,0,0,NaN,NaN
13,0.900,Cow,16-23,1563,1217,0,2780,56.223,56.223
13,0.900,Cow,23-5,1545,1587,0,3132,49.330,49.330
13,0.900,Deer Mouse,16-23,0,0,0,0,NaN,NaN
13,0.900,Deer Mouse,23-5,0,0,0,0,NaN,NaN
13,0.900,OVERALL,16-23,3758,2586,0,6344,59.237,59.237
13,0.900,OVERALL,23-5,4421,3181,0,7602,58.156,58.156
13,0.950,Chicken,16-23,0,0,0,0,NaN,NaN
13,0.950,Chicken,23-5,4,6,0,10,40.000,40.000
13,0.950,Sea Lion,16-23,0,0,0,0,NaN,NaN
13,0.950,Sea Lion,23-5,0,10,0,10,0.000,0.000
13,0.950,Hu and Cw,16-23,1,5,0,6,16.667,16.667
13,0.950,Hu and Cw,23-5,8,8,0,16,50.000,50.000
13,0.950,Sheep,16-23,44,52,0,96,45.833,45.833
13,0.950,Sheep,23-5,55,34,0,89,61.798,61.798
13,0.950,Hu and Dg,16-23,6,9,0,15,40.000,40.000
13,0.950,Hu and Dg,23-5,20,27,0,47,42.553,42.553
13,0.950,Common Loon,16-23,0,0,0,0,NaN,NaN
13,0.950,Common Loon,23-5,0,0,0,0,NaN,NaN
13,0.950,Red-Winged Blackbird,16-23,0,0,0,0,NaN,NaN
13,0.950,Red-Winged Blackbird,23-5,0,0,0,0,NaN,NaN
13,0.950,Cw,16-23,6,10,0,16,37.500,37.500
13,0.950,Cw,23-5,7,18,0,25,28.000,28.000
13,0.950,Cliff Sparrow,16-23,1,8,0,9,11.111,11.111
13,0.950,Cliff Sparrow,23-5,0,0,0,0,NaN,NaN
13,0.950,Pig,16-23,6,5,0,11,54.545,54.545
13,0.950,Pig,23-5,0,1,0,1,0.000,0.000
13,0.950,Barn Owl,16-23,0,0,0,0,NaN,NaN
13,0.950,Barn Owl,23-5,0,0,0,0,NaN,NaN
13,0.950,Wild Pig,16-23,0,0,0,0,NaN,NaN
13,0.950,Wild Pig,23-5,0,0,0,0,NaN,NaN
13,0.950,Pennington Creek Water,16-23,0,0,0,0,NaN,NaN
13,0.950,Pennington Creek Water,23-5,0,0,0,0,NaN,NaN
13,0.950,Guinni,16-23,0,0,0,0,NaN,NaN
13,0.950,Guinni,23-5,0,0,0,0,NaN,NaN
13,0.950,Racoon,16-23,0,0,0,0,NaN,NaN
13,0.950,Racoon,23-5,0,0,0,0,NaN,NaN
13,0.950,Hu,16-23,11,10,0,21,52.381,52.381
13,0.950,Hu,23-5,23,17,0,40,57.500,57.500
13,0.950,Cw and Dg,16-23,8,15,0,23,34.783,34.783
13,0.950,Cw and Dg,23-5,12,14,0,26,46.154,46.154
13,0.950,Red Wind Blackbird,16-23,0,0,0,0,NaN,NaN
13,0.950,Red Wind Blackbird,23-5,0,0,0,0,NaN,NaN
13,0.950,Tree Swallow,16-23,0,0,0,0,NaN,NaN
13,0.950,Tree Swallow,23-5,0,0,0,0,NaN,NaN
13,0.950,Turkey Vulture,16-23,0,0,0,0,NaN,NaN
13,0.950,Turkey Vulture,23-5,0,0,0,0,NaN,NaN
13,0.950,Dg,16-23,6,9,0,15,40.000,40.000
13,0.950,Dg,23-5,31,32,0,63,49.206,49.206
13,0.950,Western Kingbird,16-23,0,0,0,0,NaN,NaN
13,0.950,Western Kingbird,23-5,0,0,0,0,NaN,NaN
13,0.950,White Crowned Sparrow,16-23,0,0,0,0,NaN,NaN
13,0.950,White Crowned Sparrow,23-5,0,1,0,1,0.000,0.000
13,0.950,Eared Grebe,16-23,0,0,0,0,NaN,NaN
13,0.950,Eared Grebe,23-5,0,4,0,4,0.000,0.000
13,0.950,cougar,16-23,0,0,0,0,NaN,NaN
13,0.950,cougar,23-5,0,0,0,0,NaN,NaN
13,0.950,Ocean Water,16-23,0,0,0,0,NaN,NaN
13,0.950,Ocean Water,23-5,0,0,0,0,NaN,NaN
13,0.950,Red Tailed Hawk,16-23,0,0,0,0,NaN,NaN
13,0.950,Red Tailed Hawk,23-5,0,2,0,2,0.000,0.000
13,0.950,Dog,16-23,53,67,0,120,44.167,44.167
13,0.950,Dog,23-5,88,127,0,215,40.930,40.930
13,0.950,Human,16-23,1762,824,0,2586,68.136,68.136
13,0.950,Human,23-5,2179,673,0,2852,76.403,76.403
13,0.950,Wild Turkey,16-23,1,2,0,3,33.333,33.333
13,0.950,Wild Turkey,23-5,0,5,0,5,0.000,0.000
13,0.950,Clark Grebe,16-23,0,0,0,0,NaN,NaN
13,0.950,Clark Grebe,23-5,0,0,0,0,NaN,NaN
13,0.950,Seagull,16-23,0,0,0,0,NaN,NaN
13,0.950,Seagull,23-5,44,8,0,52,84.615,84.615
13,0.950,Surf Scoter,16-23,0,0,0,0,NaN,NaN
13,0.950,Surf Scoter,23-5,0,0,0,0,NaN,NaN
13,0.950,Pigeon,16-23,62,133,0,195,31.795,31.795
13,0.950,Pigeon,23-5,116,130,0,246,47.154,47.154
13,0.950,Pacific Ocean Water,16-23,0,0,0,0,NaN,NaN
13,0.950,Pacific Ocean Water,23-5,0,0,0,0,NaN,NaN
13,0.950,Cat,16-23,18,19,0,37,48.649,48.649
13,0.950,Cat,23-5,20,16,0,36,55.556,55.556
13,0.950,Horse,16-23,6,14,0,20,30.000,30.000
13,0.950,Horse,23-5,22,86,0,108,20.370,20.370
13,0.950,orangutan,16-23,0,0,0,0,NaN,NaN
13,0.950,orangutan,23-5,0,0,0,0,NaN,NaN
13,0.950,Bat,16-23,36,35,0,71,50.704,50.704
13,0.950,Bat,23-5,37,35,0,72,51.389,51.389
13,0.950,Deer,16-23,11,26,0,37,29.730,29.730
13,0.950,Deer,23-5,17,125,0,142,11.972,11.972
13,0.950,Great Horned Owl,16-23,0,0,0,0,NaN,NaN
13,0.950,Great Horned Owl,23-5,0,1,0,1,0.000,0.000
13,0.950,Freshwater Lagoon,16-23,0,0,0,0,NaN,NaN
13,0.950,Freshwater Lagoon,23-5,0,0,0,0,NaN,NaN
13,0.950,Unknown Avian,16-23,0,0,0,0,NaN,NaN
13,0.950,Unknown Avian,23-5,0,0,0,0,NaN,NaN
13,0.950,Human UTI,16-23,77,66,0,143,53.846,53.846
13,0.950,Human UTI,23-5,100,116,0,216,46.296,46.296
13,0.950,unknown,16-23,0,0,0,0,NaN,NaN
13,0.950,unknown,23-5,0,2,0,2,0.000,0.000
13,0.950,SLO Creek Water,16-23,0,0,0,0,NaN,NaN
13,0.950,SLO Creek Water,23-5,0,0,0,0,NaN,NaN
13,0.950,Pig/Swine,16-23,3,5,0,8,37.500,37.500
13,0.950,Pig/Swine,23-5,9,10,0,19,47.368,47.368
13,0.950,Klebsiella,16-23,0,0,0,0,NaN,NaN
13,0.950,Klebsiella,23-5,0,0,0,0,NaN,NaN
13,0.950,Hu Cw and Dg,16-23,5,8,0,13,38.462,38.462
13,0.950,Hu Cw and Dg,23-5,6,10,0,16,37.500,37.500
13,0.950,Ground Squirrel,16-23,76,45,0,121,62.810,62.810
13,0.950,Ground Squirrel,23-5,81,66,0,147,55.102,55.102
13,0.950,Opossum,16-23,0,0,0,0,NaN,NaN
13,0.950,Opossum,23-5,0,0,0,0,NaN,NaN
13,0.950,Cow,16-23,1564,1197,0,2761,56.646,56.646
13,0.950,Cow,23-5,1544,1583,0,3127,49.376,49.376
13,0.950,Deer Mouse,16-23,0,0,0,0,NaN,NaN
13,0.950,Deer Mouse,23-5,0,0,0,0,NaN,NaN
13,0.950,OVERALL,16-23,3763,2564,0,6327,59.475,59.475
13,0.950,OVERALL,23-5,4423,3167,0,7590,58.274,58.274
13,0.960,Chicken,16-23,0,0,0,0,NaN,NaN
13,0.960,Chicken,23-5,4,6,0,10,40.000,40.000
13,0.960,Sea Lion,16-23,0,0,0,0,NaN,NaN
13,0.960,Sea Lion,23-5,0,10,0,10,0.000,0.000
13,0.960,Hu and Cw,16-23,1,5,0,6,16.667,16.667
13,0.960,Hu and Cw,23-5,8,8,0,16,50.000,50.000
13,0.960,Sheep,16-23,44,52,0,96,45.833,45.833
13,0.960,Sheep,23-5,55,35,0,90,61.111,61.111
13,0.960,Hu and Dg,16-23,6,9,0,15,40.000,40.000
13,0.960,Hu and Dg,23-5,20,27,0,47,42.553,42.553
13,0.960,Common Loon,16-23,0,0,0,0,NaN,NaN
13,0.960,Common Loon,23-5,0,0,0,0,NaN,NaN
13,0.960,Red-Winged Blackbird,16-23,0,0,0,0,NaN,NaN
13,0.960,Red-Winged Blackbird,23-5,0,0,0,0,NaN,NaN
13,0.960,Cw,16-23,6,10,0,16,37.500,37.500
13,0.960,Cw,23-5,7,18,0,25,28.000,28.000
13,0.960,Cliff Sparrow,16-23,1,8,0,9,11.111,11.111
13,0.960,Cliff Sparrow,23-5,0,0,0,0,NaN,NaN
13,0.960,Pig,16-23,6,5,0,11,54.545,54.545
13,0.960,Pig,23-5,0,1,0,1,0.000,0.000
13,0.960,Barn Owl,16-23,0,0,0,0,NaN,NaN
13,0.960,Barn Owl,23-5,0,0,0,0,NaN,NaN
13,0.960,Wild Pig,16-23,0,0,0,0,NaN,NaN
13,0.960,Wild Pig,23-5,1,0,0,1,100.000,100.000
13,0.960,Pennington Creek Water,16-23,0,0,0,0,NaN,NaN
13,0.960,Pennington Creek Water,23-5,0,0,0,0,NaN,NaN
13,0.960,Guinni,16-23,0,0,0,0,NaN,NaN
13,0.960,Guinni,23-5,0,0,0,0,NaN,NaN
13,0.960,Racoon,16-23,0,0,0,0,NaN,NaN
13,0.960,Racoon,23-5,0,0,0,0,NaN,NaN
13,0.960,Hu,16-23,11,10,0,21,52.381,52.381
13,0.960,Hu,23-5,23,17,0,40,57.500,57.500
13,0.960,Cw and Dg,16-23,8,15,0,23,34.783,34.783
13,0.960,Cw and Dg,23-5,12,14,0,26,46.154,46.154
13,0.960,Red Wind Blackbird,16-23,0,0,0,0,NaN,NaN
13,0.960,Red Wind Blackbird,23-5,0,0,0,0,NaN,NaN
13,0.960,Tree Swallow,16-23,0,0,0,0,NaN,NaN
13,0.960,Tree Swallow,23-5,0,0,0,0,NaN,NaN
13,0.960,Turkey Vulture,16-23,0,0,0,0,NaN,NaN
13,0.960,Turkey Vulture,23-5,0,0,0,0,NaN,NaN
13,0.960,Dg,16-23,6,9,0,15,40.000,40.000
13,0.960,Dg,23-5,31,32,0,63,49.206,49.206
13,0.960,Western Kingbird,16-23,0,0,0,0,NaN,NaN
13,0.960,Western Kingbird,23-5,0,0,0,0,NaN,NaN
13,0.960,White Crowned Sparrow,16-23,0,0,0,0,NaN,NaN
13,0.960,White Crowned Sparrow,23-5,0,1,0,1,0.000,0.000
13,0.960,Eared Grebe,16-23,0,0,0,0,NaN,NaN
13,0.960,Eared Grebe,23-5,0,4,0,4,0.000,0.000
13,0.960,cougar,16-23,0,0,0,0,NaN,NaN
13,0.960,cougar,23-5,0,0,0,0,NaN,NaN
13,0.960,Ocean Water,16-23,0,0,0,0,NaN,NaN
13,0.960,Ocean Water,23-5,0,0,0,0,NaN,NaN
13,0.960,Red Tailed Hawk,16-23,0,0,0,0,NaN,NaN
13,0.960,Red Tailed Hawk,23-5,0,2,0,2,0.000,0.000
13,0.960,Dog,16-23,53,67,0,120,44.167,44.167
13,0.960,Dog,23-5,88,123,0,211,41.706,41.706
13,0.960,Human,16-23,1764,823,0,2587,68.187,68.187
13,0.960,Human,23-5,2181,658,0,2839,76.823,76.823
13,0.960,Wild Turkey,16-23,1,2,0,3,33.333,33.333
13,0.960,Wild Turkey,23-5,0,10,0,10,0.000,0.000
13,0.960,Clark Grebe,16-23,0,0,0,0,NaN,NaN
13,0.960,Clark Grebe,23-5,0,0,0,0,NaN,NaN
13,0.960,Seagull,16-23,0,0,0,0,NaN,NaN
13,0.960,Seagull,23-5,44,9,0,53,83.019,83.019
13,0.960,Surf Scoter,16-23,0,0,0,0,NaN,NaN
13,0.960,Surf Scoter,23-5,0,2,0,2,0.000,0.000
13,0.960,Pigeon,16-23,62,133,0,195,31.795,31.795
13,0.960,Pigeon,23-5,117,146,0,263,44.487,44.487
13,0.960,Pacific Ocean Water,16-23,0,0,0,0,NaN,NaN
13,0.960,Pacific Ocean Water,23-5,0,0,0,0,NaN,NaN
13,0.960,Cat,16-23,18,19,0,37,48.649,48.649
13,0.960,Cat,23-5,20,17,0,37,54.054,54.054
13,0.960,Horse,16-23,6,14,0,20,30.000,30.000
13,0.960,Horse,23-5,22,86,0,108,20.370,20.370
13,0.960,orangutan,16-23,0,0,0,0,NaN,NaN
13,0.960,orangutan,23-5,0,0,0,0,NaN,NaN
13,0.960,Bat,16-23,36,35,0,71,50.704,50.704
13,0.960,Bat,23-5,37,35,0,72,51.389,51.389
13,0.960,Deer,16-23,11,26,0,37,29.730,29.730
13,0.960,Deer,23-5,17,125,0,142,11.972,11.972
13,0.960,Great Horned Owl,16-23,0,0,0,0,NaN,NaN
13,0.960,Great Horned Owl,23-5,0,1,0,1,0.000,0.000
13,0.960,Freshwater Lagoon,16-23,0,0,0,0,NaN,NaN
13,0.960,Freshwater Lagoon,23-5,0,0,0,0,NaN,NaN
13,0.960,Unknown Avian,16-23,0,0,0,0,NaN,NaN
13,0.960,Unknown Avian,23-5,0,0,0,0,NaN,NaN
13,0.960,Human UTI,16-23,77,67,0,144,53.472,53.472
13,0.960,Human UTI,23-5,100,115,0,215,46.512,46.512
13,0.960,unknown,16-23,0,0,0,0,NaN,NaN
13,0.960,unknown,23-5,0,2,0,2,0.000,0.000
13,0.960,SLO Creek Water,16-23,0,0,0,0,NaN,NaN
13,0.960,SLO Creek Water,23-5,0,0,0,0,NaN,NaN
13,0.960,Pig/Swine,16-23,3,5,0,8,37.500,37.500
13,0.960,Pig/Swine,23-5,9,10,0,19,47.368,47.368
13,0.960,Klebsiella,16-23,0,0,0,0,NaN,NaN
13,0.960,Klebsiella,23-5,0,0,0,0,NaN,NaN
13,0.960,Hu Cw and Dg,16-23,5,8,0,13,38.462,38.462
13,0.960,Hu Cw and Dg,23-5,6,10,0,16,37.500,37.500
13,0.960,Ground Squirrel,16-23,76,45,0,121,62.810,62.810
13,0.960,Ground Squirrel,23-5,81,68,0,149,54.362,54.362
13,0.960,Opossum,16-23,0,0,0,0,NaN,NaN
13,0.960,Opossum,23-5,0,0,0,0,NaN,NaN
13,0.960,Cow,16-23,1562,1186,0,2748,56.841,56.841
13,0.960,Cow,23-5,1544,1561,0,3105,49.726,49.726
13,0.960,Deer Mouse,16-23,0,0,0,0,NaN,NaN
13,0.960,Deer Mouse,23-5,0,0,0,0,NaN,NaN
13,0.960,OVERALL,16-23,3763,2553,0,6316,59.579,59.579
13,0.960,OVERALL,23-5,4427,3153,0,7580,58.404,58.404
13,0.970,Chicken,16-23,0,0,0,0,NaN,NaN
13,0.970,Chicken,23-5,4,6,0,10,40.000,40.000
13,0.970,Sea Lion,16-23,0,0,0,0,NaN,NaN
13,0.970,Sea Lion,23-5,0,10,0,10,0.000,0.000
13,0.970,Hu and Cw,16-23,1,5,0,6,16.667,16.667
13,0.970,Hu and Cw,23-5,8,8,0,16,50.000,50.000
13,0.970,Sheep,16-23,45,53,0,98,45.918,45.918
13,0.970,Sheep,23-5,55,34,0,89,61.798,61.798
13,0.970,Hu and Dg,16-23,6,9,0,15,40.000,40.000
13,0.970,Hu and Dg,23-5,20,27,0,47,42.553,42.553
13,0.970,Common Loon,16-23,0,0,0,0,NaN,NaN
13,0.970,Common Loon,23-5,0,0,0,0,NaN,NaN
13,0.970,Red-Winged Blackbird,16-23,0,0,0,0,NaN,NaN
13,0.970,Red-Winged Blackbird,23-5,0,0,0,0,NaN,NaN
13,0.970,Cw,16-23,6,11,0,17,35.294,35.294
13,0.970,Cw,23-5,7,18,0,25,28.000,28.000
13,0.970,Cliff Sparrow,16-23,1,8,0,9,11.111,11.111
13,0.970,Cliff Sparrow,23-5,0,0,0,0,NaN,NaN
13,0.970,Pig,16-23,6,5,0,11,54.545,54.545
13,0.970,Pig,23-5,0,1,0,1,0.000,0.000
13,0.970,Barn Owl,16-23,0,0,0,0,NaN,NaN
13,0.970,Barn Owl,23-5,0,0,0,0,NaN,NaN
13,0.970,Wild Pig,16-23,0,0,0,0,NaN,NaN
13,0.970,Wild Pig,23-5,0,0,0,0,NaN,NaN
13,0.970,Pennington Creek Water,16-23,0,0,0,0,NaN,NaN
13,0.970,Pennington Creek Water,23-5,0,0,0,0,NaN,NaN
13,0.970,Guinni,16-23,0,0,0,0,NaN,NaN
13,0.970,Guinni,23-5,0,0,0,0,NaN,NaN
13,0.970,Racoon,16-23,0,0,0,0,NaN,NaN
13,0.970,Racoon,23-5,0,0,0,0,NaN,NaN
13,0.970,Hu,16-23,11,10,0,21,52.381,52.381
13,0.970,Hu,23-5,23,17,0,40,57.500,57.500
13,0.970,Cw and Dg,16-23,8,15,0,23,34.783,34.783
13,0.970,Cw and Dg,23-5,12,14,0,26,46.154,46.154
13,0.970,Red Wind Blackbird,16-23,0,0,0,0,NaN,NaN
13,0.970,Red Wind Blackbird,23-5,0,0,0,0,NaN,NaN
13,0.970,Tree Swallow,16-23,0,0,0,0,NaN,NaN
13,0.970,Tree Swallow,23-5,0,0,0,0,NaN,NaN
13,0.970,Turkey Vulture,16-23,0,0,0,0,NaN,NaN
13,0.970,Turkey Vulture,23-5,0,0,0,0,NaN,NaN
13,0.970,Dg,16-23,6,9,0,15,40.000,40.000
13,0.970,Dg,23-5,31,31,0,62,50.000,50.000
13,0.970,Western Kingbird,16-23,0,0,0,0,NaN,NaN
13,0.970,Western Kingbird,23-5,0,0,0,0,NaN,NaN
13,0.970,White Crowned Sparrow,16-23,0,0,0,0,NaN,NaN
13,0.970,White Crowned Sparrow,23-5,0,1,0,1,0.000,0.000
13,0.970,Eared Grebe,16-23,0,0,0,0,NaN,NaN
13,0.970,Eared Grebe,23-5,0,4,0,4,0.000,0.000
13,0.970,cougar,16-23,0,0,0,0,NaN,NaN
13,0.970,cougar,23-5,0,0,0,0,NaN,NaN
13,0.970,Ocean Water,16-23,0,0,0,0,NaN,NaN
13,0.970,Ocean Water,23-5,0,0,0,0,NaN,NaN
13,0.970,Red Tailed Hawk,16-23,0,0,0,0,NaN,NaN
13,0.970,Red Tailed Hawk,23-5,0,2,0,2,0.000,0.000
13,0.970,Dog,16-23,53,67,0,120,44.167,44.167
13,0.970,Dog,23-5,89,122,0,211,42.180,42.180
13,0.970,Human,16-23,1763,820,0,2583,68.254,68.254
13,0.970,Human,23-5,2179,656,0,2835,76.861,76.861
13,0.970,Wild Turkey,16-23,1,4,0,5,20.000,20.000
13,0.970,Wild Turkey,23-5,2,9,0,11,18.182,18.182
13,0.970,Clark Grebe,16-23,0,0,0,0,NaN,NaN
13,0.970,Clark Grebe,23-5,0,0,0,0,NaN,NaN
13,0.970,Seagull,16-23,0,0,0,0,NaN,NaN
13,0.970,Seagull,23-5,44,10,0,54,81.481,81.481
13,0.970,Surf Scoter,16-23,0,0,0,0,NaN,NaN
13,0.970,Surf Scoter,23-5,0,2,0,2,0.000,0.000
13,0.970,Pigeon,16-23,61,132,0,193,31.606,31.606
13,0.970,Pigeon,23-5,117,163,0,280,41.786,41.786
13,0.970,Pacific Ocean Water,16-23,0,0,0,0,NaN,NaN
13,0.970,Pacific Ocean Water,23-5,0,0,0,0,NaN,NaN
13,0.970,Cat,16-23,18,19,0,37,48.649,48.649
13,0.970,Cat,23-5,20,17,0,37,54.054,54.054
13,0.970,Horse,16-23,6,14,0,20,30.000,30.000
13,0.970,Horse,23-5,22,87,0,109,20.183,20.183
13,0.970,orangutan,16-23,0,0,0,0,NaN,NaN
13,0.970,orangutan,23-5,0,0,0,0,NaN,NaN
13,0.970,Bat,16-23,36,35,0,71,50.704,50.704
13,0.970,Bat,23-5,37,35,0,72,51.389,51.389
13,0.970,Deer,16-23,11,26,0,37,29.730,29.730
13,0.970,Deer,23-5,17,125,0,142,11.972,11.972
13,0.970,Great Horned Owl,16-23,0,0,0,0,NaN,NaN
13,0.970,Great Horned Owl,23-5,0,1,0,1,0.000,0.000
13,0.970,Freshwater Lagoon,16-23,0,0,0,0,NaN,NaN
13,0.970,Freshwater Lagoon,23-5,0,0,0,0,NaN,NaN
13,0.970,Unknown Avian,16-23,0,0,0,0,NaN,NaN
13,0.970,Unknown Avian,23-5,0,0,0,0,NaN,NaN
13,0.970,Human UTI,16-23,77,68,0,145,53.103,53.103
13,0.970,Human UTI,23-5,99,115,0,214,46.262,46.262
13,0.970,unknown,16-23,0,0,0,0,NaN,NaN
13,0.970,unknown,23-5,0,2,0,2,0.000,0.000
13,0.970,SLO Creek Water,16-23,0,0,0,0,NaN,NaN
13,0.970,SLO Creek Water,23-5,0,0,0,0,NaN,NaN
13,0.970,Pig/Swine,16-23,3,5,0,8,37.500,37.500
13,0.970,Pig/Swine,23-5,9,10,0,19,47.368,47.368
13,0.970,Klebsiella,16-23,0,0,0,0,NaN,NaN
13,0.970,Klebsiella,23-5,0,0,0,0,NaN,NaN
13,0.970,Hu Cw and Dg,16-23,5,8,0,13,38.462,38.462
13,0.970,Hu Cw and Dg,23-5,6,10,0,16,37.500,37.500
13,0.970,Ground Squirrel,16-23,76,44,0,120,63.333,63.333
13,0.970,Ground Squirrel,23-5,81,66,0,147,55.102,55.102
13,0.970,Opossum,16-23,0,0,0,0,NaN,NaN
13,0.970,Opossum,23-5,0,0,0,0,NaN,NaN
13,0.970,Cow,16-23,1556,1183,0,2739,56.809,56.809
13,0.970,Cow,23-5,1541,1535,0,3076,50.098,50.098
13,0.970,Deer Mouse,16-23,0,0,0,0,NaN,NaN
13,0.970,Deer Mouse,23-5,0,0,0,0,NaN,NaN
13,0.970,OVERALL,16-23,3756,2550,0,6306,59.562,59.562
13,0.970,OVERALL,23-5,4423,3138,0,7561,58.498,58.498
13,0.980,Chicken,16-23,0,0,0,0,NaN,NaN
13,0.980,Chicken,23-5,5,6,0,11,45.455,45.455
13,0.980,Sea Lion,16-23,0,0,0,0,NaN,NaN
13,0.980,Sea Lion,23-5,0,9,0,9,0.000,0.000
13,0.980,Hu and Cw,16-23,1,5,0,6,16.667,16.667
13,0.980,Hu and Cw,23-5,8,18,0,26,30.769,30.769
13,0.980,Sheep,16-23,48,51,0,99,48.485,48.485
13,0.980,Sheep,23-5,54,33,0,87,62.069,62.069
13,0.980,Hu and Dg,16-23,6,9,0,15,40.000,40.000
13,0.980,Hu and Dg,23-5,20,24,0,44,45.455,45.455
13,0.980,Common Loon,16-23,0,0,0,0,NaN,NaN
13,0.980,Common Loon,23-5,0,0,0,0,NaN,NaN
13,0.980,Red-Winged Blackbird,16-23,0,0,0,0,NaN,NaN
13,0.980,Red-Winged Blackbird,23-5,0,0,0,0,NaN,NaN
13,0.980,Cw,16-23,6,10,0,16,37.500,37.500
13,0.980,Cw,23-5,7,20,0,27,25.926,25.926
13,0.980,Cliff Sparrow,16-23,1,8,0,9,11.111,11.111
13,0.980,Cliff Sparrow,23-5,0,0,0,0,NaN,NaN
13,0.980,Pig,16-23,6,5,0,11,54.545,54.545
13,0.980,Pig,23-5,0,1,0,1,0.000,0.000
13,0.980,Barn Owl,16-23,0,0,0,0,NaN,NaN
13,0.980,Barn Owl,23-5,0,0,0,0,NaN,NaN
13,0.980,Wild Pig,16-23,0,0,0,0,NaN,NaN
13,0.980,Wild Pig,23-5,0,0,0,0,NaN,NaN
13,0.980,Pennington Creek Water,16-23,0,0,0,0,NaN,NaN
13,0.980,Pennington Creek Water,23-5,0,0,0,0,NaN,NaN
13,0.980,Guinni,16-23,0,0,0,0,NaN,NaN
13,0.980,Guinni,23-5,0,0,0,0,NaN,NaN
13,0.980,Racoon,16-23,0,0,0,0,NaN,NaN
13,0.980,Racoon,23-5,0,0,0,0,NaN,NaN
13,0.980,Hu,16-23,11,10,0,21,52.381,52.381
13,0.980,Hu,23-5,23,18,0,41,56.098,56.098
13,0.980,Cw and Dg,16-23,8,15,0,23,34.783,34.783
13,0.980,Cw and Dg,23-5,12,16,0,28,42.857,42.857
13,0.980,Red Wind Blackbird,16-23,0,0,0,0,NaN,NaN
13,0.980,Red Wind Blackbird,23-5,0,0,0,0,NaN,NaN
13,0.980,Tree Swallow,16-23,0,0,0,0,NaN,NaN
13,0.980,Tree Swallow,23-5,0,0,0,0,NaN,NaN
13,0.980,Turkey Vulture,16-23,0,0,0,0,NaN,NaN
13,0.980,Turkey Vulture,23-5,0,0,0,0,NaN,NaN
13,0.980,Dg,16-23,6,9,0,15,40.000,40.000
13,0.980,Dg,23-5,31,24,0,55,56.364,56.364
13,0.980,Western Kingbird,16-23,0,0,0,0,NaN,NaN
13,0.980,Western Kingbird,23-5,0,0,0,0,NaN,NaN
13,0.980,White Crowned Sparrow,16-23,0,0,0,0,NaN,NaN
13,0.980,White Crowned Sparrow,23-5,0,3,0,3,0.000,0.000
13,0.980,Eared Grebe,16-23,0,0,0,0,NaN,NaN
13,0.980,Eared Grebe,23-5,0,4,0,4,0.000,0.000
13,0.980,cougar,16-23,0,0,0,0,NaN,NaN
13,0.980,cougar,23-5,0,0,0,0,NaN,NaN
13,0.980,Ocean Water,16-23,0,0,0,0,NaN,NaN
13,0.980,Ocean Water,23-5,0,0,0,0,NaN,NaN
13,0.980,Red Tailed Hawk,16-23,0,0,0,0,NaN,NaN
13,0.980,Red Tailed Hawk,23-5,0,1,0,1,0.000,0.000
13,0.980,Dog,16-23,52,71,0,123,42.276,42.276
13,0.980,Dog,23-5,89,117,0,206,43.204,43.204
13,0.980,Human,16-23,1766,809,0,2575,68.583,68.583
13,0.980,Human,23-5,2181,641,0,2822,77.286,77.286
13,0.980,Wild Turkey,16-23,1,4,0,5,20.000,20.000
13,0.980,Wild Turkey,23-5,4,19,0,23,17.391,17.391
13,0.980,Clark Grebe,16-23,0,0,0,0,NaN,NaN
13,0.980,Clark Grebe,23-5,0,0,0,0,NaN,NaN
13,0.980,Seagull,16-23,0,0,0,0,NaN,NaN
13,0.980,Seagull,23-5,46,8,0,54,85.185,85.185
13,0.980,Surf Scoter,16-23,0,0,0,0,NaN,NaN
13,0.980,Surf Scoter,23-5,2,0,0,2,100.000,100.000
13,0.980,Pigeon,16-23,61,129,0,190,32.105,32.105
13,0.980,Pigeon,23-5,116,173,0,289,40.138,40.138
13,0.980,Pacific Ocean Water,16-23,0,0,0,0,NaN,NaN
13,0.980,Pacific Ocean Water,23-5,0,0,0,0,NaN,NaN
13,0.980,Cat,16-23,18,19,0,37,48.649,48.649
13,0.980,Cat,23-5,22,16,0,38,57.895,57.895
13,0.980,Horse,16-23,6,14,0,20,30.000,30.000
13,0.980,Horse,23-5,22,85,0,107,20.561,20.561
13,0.980,orangutan,16-23,0,0,0,0,NaN,NaN
13,0.980,orangutan,23-5,0,0,0,0,NaN,NaN
13,0.980,Bat,16-23,36,34,0,70,51.429,51.429
13,0.980,Bat,23-5,37,35,0,72,51.389,51.389
13,0.980,Deer,16-23,11,26,0,37,29.730,29.730
13,0.980,Deer,23-5,17,125,0,142,11.972,11.972
13,0.980,Great Horned Owl,16-23,0,0,0,0,NaN,NaN
13,0.980,Great Horned Owl,23-5,0,1,0,1,0.000,0.000
13,0.980,Freshwater Lagoon,16-23,0,0,0,0,NaN,NaN
13,0.980,Freshwater Lagoon,23-5,0,0,0,0,NaN,NaN
13,0.980,Unknown Avian,16-23,0,0,0,0,NaN,NaN
13,0.980,Unknown Avian,23-5,0,0,0,0,NaN,NaN
13,0.980,Human UTI,16-23,77,70,0,147,52.381,52.381
13,0.980,Human UTI,23-5,100,114,0,214,46.729,46.729
13,0.980,unknown,16-23,0,0,0,0,NaN,NaN
13,0.980,unknown,23-5,0,3,0,3,0.000,0.000
13,0.980,SLO Creek Water,16-23,0,0,0,0,NaN,NaN
13,0.980,SLO Creek Water,23-5,0,0,0,0,NaN,NaN
13,0.980,Pig/Swine,16-23,3,5,0,8,37.500,37.500
13,0.980,Pig/Swine,23-5,9,10,0,19,47.368,47.368
13,0.980,Klebsiella,16-23,0,0,0,0,NaN,NaN
13,0.980,Klebsiella,23-5,0,0,0,0,NaN,NaN
13,0.980,Hu Cw and Dg,16-23,5,8,0,13,38.462,38.462
13,0.980,Hu Cw and Dg,23-5,6,9,0,15,40.000,40.000
13,0.980,Ground Squirrel,16-23,78,45,0,123,63.415,63.415
13,0.980,Ground Squirrel,23-5,82,64,0,146,56.164,56.164
13,0.980,Opossum,16-23,0,0,0,0,NaN,NaN
13,0.980,Opossum,23-5,0,0,0,0,NaN,NaN
13,0.980,Cow,16-23,1550,1165,0,2715,57.090,57.090
13,0.980,Cow,23-5,1535,1497,0,3032,50.627,50.627
13,0.980,Deer Mouse,16-23,0,0,0,0,NaN,NaN
13,0.980,Deer Mouse,23-5,0,0,0,0,NaN,NaN
13,0.980,OVERALL,16-23,3757,2521,0,6278,59.844,59.844
13,0.980,OVERALL,23-5,4428,3094,0,7522,58.867,58.867
13,0.990,Chicken,16-23,2,5,0,7,28.571,28.571
13,0.990,Chicken,23-5,6,6,0,12,50.000,50.000
13,0.990,Sea Lion,16-23,0,0,0,0,NaN,NaN
13,0.990,Sea Lion,23-5,4,6,0,10,40.000,40.000
13,0.990,Hu and Cw,16-23,2,5,0,7,28.571,28.571
13,0.990,Hu and Cw,23-5,10,25,0,35,28.571,28.571
13,0.990,Sheep,16-23,47,51,0,98,47.959,47.959
13,0.990,Sheep,23-5,55,32,0,87,63.218,63.218
13,0.990,Hu and Dg,16-23,6,11,0,17,35.294,35.294
13,0.990,Hu and Dg,23-5,20,20,0,40,50.000,50.000
13,0.990,Common Loon,16-23,0,0,0,0,NaN,NaN
13,0.990,Common Loon,23-5,0,2,0,2,0.000,0.000
13,0.990,Red-Winged Blackbird,16-23,0,2,0,2,0.000,0.000
13,0.990,Red-Winged Blackbird,23-5,0,0,0,0,NaN,NaN
13,0.990,Cw,16-23,7,10,0,17,41.176,41.176
13,0.990,Cw,23-5,13,23,0,36,36.111,36.111
13,0.990,Cliff Sparrow,16-23,1,9,0,10,10.000,10.000
13,0.990,Cliff Sparrow,23-5,0,4,0,4,0.000,0.000
13,0.990,Pig,16-23,6,5,0,11,54.545,54.545
13,0.990,Pig,23-5,7,6,0,13,53.846,53.846
13,0.990,Barn Owl,16-23,0,0,0,0,NaN,NaN
13,0.990,Barn Owl,23-5,0,0,0,0,NaN,NaN
13,0.990,Wild Pig,16-23,0,1,0,1,0.000,0.000
13,0.990,Wild Pig,23-5,0,1,0,1,0.000,0.000
13,0.990,Pennington Creek Water,16-23,0,0,0,0,NaN,NaN
13,0.990,Pennington Creek Water,23-5,0,0,0,0,NaN,NaN
13,0.990,Guinni,16-23,0,0,0,0,NaN,NaN
13,0.990,Guinni,23-5,0,0,0,0,NaN,NaN
13,0.990,Racoon,16-23,0,0,0,0,NaN,NaN
13,0.990,Racoon,23-5,0,1,0,1,0.000,0.000
13,0.990,Hu,16-23,11,10,0,21,52.381,52.381
13,0.990,Hu,23-5,23,14,0,37,62.162,62.162
13,0.990,Cw and Dg,16-23,8,15,0,23,34.783,34.783
13,0.990,Cw and Dg,23-5,13,10,0,23,56.522,56.522
13,0.990,Red Wind Blackbird,16-23,0,0,0,0,NaN,NaN
13,0.990,Red Wind Blackbird,23-5,0,0,0,0,NaN,NaN
13,0.990,Tree Swallow,16-23,0,0,0,0,NaN,NaN
13,0.990,Tree Swallow,23-5,0,0,0,0,NaN,NaN
13,0.990,Turkey Vulture,16-23,0,0,0,0,NaN,NaN
13,0.990,Turkey Vulture,23-5,0,0,0,0,NaN,NaN
13,0.990,Dg,16-23,6,10,0,16,37.500,37.500
13,0.990,Dg,23-5,31,19,0,50,62.000,62.000
13,0.990,Western Kingbird,16-23,0,0,0,0,NaN,NaN
13,0.990,Western Kingbird,23-5,0,0,0,0,NaN,NaN
13,0.990,White Crowned Sparrow,16-23,0,0,0,0,NaN,NaN
13,0.990,White Crowned Sparrow,23-5,0,4,0,4,0.000,0.000
13,0.990,Eared Grebe,16-23,0,0,0,0,NaN,NaN
13,0.990,Eared Grebe,23-5,0,6,0,6,0.000,0.000
13,0.990,cougar,16-23,0,1,0,1,0.000,0.000
13,0.990,cougar,23-5,0,0,0,0,NaN,NaN
13,0.990,Ocean Water,16-23,0,0,0,0,NaN,NaN
13,0.990,Ocean Water,23-5,0,0,0,0,NaN,NaN
13,0.990,Red Tailed Hawk,16-23,0,0,0,0,NaN,NaN
13,0.990,Red Tailed Hawk,23-5,0,2,0,2,0.000,0.000
13,0.990,Dog,16-23,55,71,0,126,43.651,43.651
13,0.990,Dog,23-5,94,110,0,204,46.078,46.078
13,0.990,Human,16-23,1755,766,0,2521,69.615,69.615
13,0.990,Human,23-5,2175,586,0,2761,78.776,78.776
13,0.990,Wild Turkey,16-23,3,9,0,12,25.000,25.000
13,0.990,Wild Turkey,23-5,4,20,0,24,16.667,16.667
13,0.990,Clark Grebe,16-23,0,0,0,0,NaN,NaN
13,0.990,Clark Grebe,23-5,2,3,0,5,40.000,40.000
13,0.990,Seagull,16-23,0,0,0,0,NaN,NaN
13,0.990,Seagull,23-5,48,7,0,55,87.273,87.273
13,0.990,Surf Scoter,16-23,0,0,0,0,NaN,NaN
13,0.990,Surf Scoter,23-5,2,0,0,2,100.000,100.000
13,0.990,Pigeon,16-23,70,122,0,192,36.458,36.458
13,0.990,Pigeon,23-5,122,193,0,315,38.730,38.730
13,0.990,Pacific Ocean Water,16-23,0,0,0,0,NaN,NaN
13,0.990,Pacific Ocean Water,23-5,0,0,0,0,NaN,NaN
13,0.990,Cat,16-23,21,22,0,43,48.837,48.837
13,0.990,Cat,23-5,23,20,0,43,53.488,53.488
13,0.990,Horse,16-23,9,15,0,24,37.500,37.500
13,0.990,Horse,23-5,22,101,0,123,17.886,17.886
13,0.990,orangutan,16-23,0,0,0,0,NaN,NaN
13,0.990,orangutan,23-5,0,0,0,0,NaN,NaN
13,0.990,Bat,16-23,36,31,0,67,53.731,53.731
13,0.990,Bat,23-5,37,34,0,71,52.113,52.113
13,0.990,Deer,16-23,11,28,0,39,28.205,28.205
13,0.990,Deer,23-5,17,113,0,130,13.077,13.077
13,0.990,Great Horned Owl,16-23,0,0,0,0,NaN,NaN
13,0.990,Great Horned Owl,23-5,0,1,0,1,0.000,0.000
13,0.990,Freshwater Lagoon,16-23,0,0,0,0,NaN,NaN
13,0.990,Freshwater Lagoon,23-5,0,0,0,0,NaN,NaN
13,0.990,Unknown Avian,16-23,0,0,0,0,NaN,NaN
13,0.990,Unknown Avian,23-5,0,0,0,0,NaN,NaN
13,0.990,Human UTI,16-23,81,61,0,142,57.042,57.042
13,0.990,Human UTI,23-5,99,89,0,188,52.660,52.660
13,0.990,unknown,16-23,0,0,0,0,NaN,NaN
13,0.990,unknown,23-5,0,5,0,5,0.000,0.000
13,0.990,SLO Creek Water,16-23,0,0,0,0,NaN,NaN
13,0.990,SLO Creek Water,23-5,0,0,0,0,NaN,NaN
13,0.990,Pig/Swine,16-23,4,6,0,10,40.000,40.000
13,0.990,Pig/Swine,23-5,9,9,0,18,50.000,50.000
13,0.990,Klebsiella,16-23,0,0,0,0,NaN,NaN
13,0.990,Klebsiella,23-5,0,0,0,0,NaN,NaN
13,0.990,Hu Cw and Dg,16-23,5,8,0,13,38.462,38.462
13,0.990,Hu Cw and Dg,23-5,6,10,0,16,37.500,37.500
13,0.990,Ground Squirrel,16-23,81,46,0,127,63.780,63.780
13,0.990,Ground Squirrel,23-5,84,67,0,151,55.629,55.629
13,0.990,Opossum,16-23,1,0,0,1,100.000,100.000
13,0.990,Opossum,23-5,2,0,0,2,100.000,100.000
13,0.990,Cow,16-23,1520,1057,0,2577,58.983,58.983
13,0.990,Cow,23-5,1495,1354,0,2849,52.475,52.475
13,0.990,Deer Mouse,16-23,0,0,0,0,NaN,NaN
13,0.990,Deer Mouse,23-5,0,0,0,0,NaN,NaN
13,0.990,OVERALL,16-23,3748,2377,0,6125,61.192,61.192
13,0.990,OVERALL,23-5,4423,2903,0,7326,60.374,60.374
13,1.000,Chicken,16-23,0,0,0,0,NaN,NaN
13,1.000,Chicken,23-5,0,0,0,0,NaN,NaN
13,1.000,Sea Lion,16-23,0,0,0,0,NaN,NaN
13,1.000,Sea Lion,23-5,0,0,0,0,NaN,NaN
13,1.000,Hu and Cw,16-23,0,0,0,0,NaN,NaN
13,1.000,Hu and Cw,23-5,0,0,0,0,NaN,NaN
13,1.000,Sheep,16-23,0,0,0,0,NaN,NaN
13,1.000,Sheep,23-5,0,0,0,0,NaN,NaN
13,1.000,Hu and Dg,16-23,0,0,0,0,NaN,NaN
13,1.000,Hu and Dg,23-5,0,0,0,0,NaN,NaN
13,1.000,Common Loon,16-23,0,0,0,0,NaN,NaN
13,1.000,Common Loon,23-5,0,0,0,0,NaN,NaN
13,1.000,Red-Winged Blackbird,16-23,0,0,0,0,NaN,NaN
13,1.000,Red-Winged Blackbird,23-5,0,0,0,0,NaN,NaN
13,1.000,Cw,16-23,0,0,0,0,NaN,NaN
13,1.000,Cw,23-5,0,0,0,0,NaN,NaN
13,1.000,Cliff Sparrow,16-23,0,0,0,0,NaN,NaN
13,1.000,Cliff Sparrow,23-5,0,0,0,0,NaN,NaN
13,1.000,Pig,16-23,0,0,0,0,NaN,NaN
13,1.000,Pig,23-5,0,0,0,0,NaN,NaN
13,1.000,Barn Owl,16-23,0,0,0,0,NaN,NaN
13,1.000,Barn Owl,23-5,0,0,0,0,NaN,NaN
13,1.000,Wild Pig,16-23,0,0,0,0,NaN,NaN
13,1.000,Wild Pig,23-5,0,0,0,0,NaN,NaN
13,1.000,Pennington Creek Water,16-23,0,0,0,0,NaN,NaN
13,1.000,Pennington Creek Water,23-5,0,0,0,0,NaN,NaN
13,1.000,Guinni,16-23,0,0,0,0,NaN,NaN
13,1.000,Guinni,23-5,0,0,0,0,NaN,NaN
13,1.000,Racoon,16-23,0,0,0,0,NaN,NaN
13,1.000,Racoon,23-5,0,0,0,0,NaN,NaN
13,1.000,Hu,16-23,0,0,0,0,NaN,NaN
13,1.000,Hu,23-5,0,0,0,0,NaN,NaN
13,1.000,Cw and Dg,16-23,0,0,0,0,NaN,NaN
13,1.000,Cw and Dg,23-5,0,0,0,0,NaN,NaN
13,1.000,Red Wind Blackbird,16-23,0,0,0,0,NaN,NaN
13,1.000,Red Wind Blackbird,23-5,0,0,0,0,NaN,NaN
13,1.000,Tree Swallow,16-23,0,0,0,0,NaN,NaN
13,1.000,Tree Swallow,23-5,0,0,0,0,NaN,NaN
13,1.000,Turkey Vulture,16-23,0,0,0,0,NaN,NaN
13,1.000,Turkey Vulture,23-5,0,0,0,0,NaN,NaN
13,1.000,Dg,16-23,0,0,0,0,NaN,NaN
13,1.000,Dg,23-5,0,0,0,0,NaN,NaN
13,1.000,Western Kingbird,16-23,0,0,0,0,NaN,NaN
13,1.000,Western Kingbird,23-5,0,0,0,0,NaN,NaN
13,1.000,White Crowned Sparrow,16-23,0,0,0,0,NaN,NaN
13,1.000,White Crowned Sparrow,23-5,0,0,0,0,NaN,NaN
13,1.000,Eared Grebe,16-23,0,0,0,0,NaN,NaN
13,1.000,Eared Grebe,23-5,0,0,0,0,NaN,NaN
13,1.000,cougar,16-23,0,0,0,0,NaN,NaN
13,1.000,cougar,23-5,0,0,0,0,NaN,NaN
13,1.000,Ocean Water,16-23,0,0,0,0,NaN,NaN
13,1.000,Ocean Water,23-5,0,0,0,0,NaN,NaN
13,1.000,Red Tailed Hawk,16-23,0,0,0,0,NaN,NaN
13,1.000,Red Tailed Hawk,23-5,0,0,0,0,NaN,NaN
13,1.000,Dog,16-23,0,0,0,0,NaN,NaN
13,1.000,Dog,23-5,0,0,0,0,NaN,NaN
13,1.000,Human,16-23,68,0,0,68,100.000,100.000
13,1.000,Human,23-5,90,0,0,90,100.000,100.000
13,1.000,Wild Turkey,16-23,0,0,0,0,NaN,NaN
13,1.000,Wild Turkey,23-5,0,0,0,0,NaN,NaN
13,1.000,Clark Grebe,16-23,0,0,0,0,NaN,NaN
13,1.000,Clark Grebe,23-5,0,0,0,0,NaN,NaN
13,1.000,Seagull,16-23,0,0,0,0,NaN,NaN
13,1.000,Seagull,23-5,0,0,0,0,NaN,NaN
13,1.000,Surf Scoter,16-23,0,0,0,0,NaN,NaN
13,1.000,Surf Scoter,23-5,0,0,0,0,NaN,NaN
13,1.000,Pigeon,16-23,0,0,0,0,NaN,NaN
13,1.000,Pigeon,23-5,0,0,0,0,NaN,NaN
13,1.000,Pacific Ocean Water,16-23,0,0,0,0,NaN,NaN
13,1.000,Pacific Ocean Water,23-5,0,0,0,0,NaN,NaN
13,1.000,Cat,16-23,0,0,0,0,NaN,NaN
13,1.000,Cat,23-5,0,0,0,0,NaN,NaN
13,1.000,Horse,16-23,0,0,0,0,NaN,NaN
13,1.000,Horse,23-5,0,0,0,0,NaN,NaN
13,1.000,orangutan,16-23,0,0,0,0,NaN,NaN
13,1.000,orangutan,23-5,0,0,0,0,NaN,NaN
13,1.000,Bat,16-23,0,0,0,0,NaN,NaN
13,1.000,Bat,23-5,0,0,0,0,NaN,NaN
13,1.000,Deer,16-23,0,0,0,0,NaN,NaN
13,1.000,Deer,23-5,0,0,0,0,NaN,NaN
13,1.000,Great Horned Owl,16-23,0,0,0,0,NaN,NaN
13,1.000,Great Horned Owl,23-5,0,0,0,0,NaN,NaN
13,1.000,Freshwater Lagoon,16-23,0,0,0,0,NaN,NaN
13,1.000,Freshwater Lagoon,23-5,0,0,0,0,NaN,NaN
13,1.000,Unknown Avian,16-23,0,0,0,0,NaN,NaN
13,1.000,Unknown Avian,23-5,0,0,0,0,NaN,NaN
13,1.000,Human UTI,16-23,0,0,0,0,NaN,NaN
13,1.000,Human UTI,23-5,0,0,0,0,NaN,NaN
13,1.000,unknown,16-23,0,0,0,0,NaN,NaN
13,1.000,unknown,23-5,0,0,0,0,NaN,NaN
13,1.000,SLO Creek Water,16-23,0,0,0,0,NaN,NaN
13,1.000,SLO Creek Water,23-5,0,0,0,0,NaN,NaN
13,1.000,Pig/Swine,16-23,0,0,0,0,NaN,NaN
13,1.000,Pig/Swine,23-5,0,0,0,0,NaN,NaN
13,1.000,Klebsiella,16-23,0,0,0,0,NaN,NaN
13,1.000,Klebsiella,23-5,0,0,0,0,NaN,NaN
13,1.000,Hu Cw and Dg,16-23,0,0,0,0,NaN,NaN
13,1.000,Hu Cw and Dg,23-5,0,0,0,0,NaN,NaN
13,1.000,Ground Squirrel,16-23,0,0,0,0,NaN,NaN
13,1.000,Ground Squirrel,23-5,0,0,0,0,NaN,NaN
13,1.000,Opossum,16-23,0,0,0,0,NaN,NaN
13,1.000,Opossum,23-5,0,0,0,0,NaN,NaN
13,1.000,Cow,16-23,0,0,0,0,NaN,NaN
13,1.000,Cow,23-5,0,0,0,0,NaN,NaN
13,1.000,Deer Mouse,16-23,0,0,0,0,NaN,NaN
13,1.000,Deer Mouse,23-5,0,0,0,0,NaN,NaN
13,1.000,OVERALL,16-23,68,0,0,68,100.000,100.000
13,1.000,OVERALL,23-5,90,0,0,90,100.000,100.000
14,0.000,Chicken,16-23,0,0,0,0,NaN,NaN
14,0.000,Chicken,23-5,5,2,0,7,71.429,71.429
14,0.000,Sea Lion,16-23,0,0,0,0,NaN,NaN
14,0.000,Sea Lion,23-5,0,11,0,11,0.000,0.000
14,0.000,Hu and Cw,16-23,1,5,0,6,16.667,16.667
14,0.000,Hu and Cw,23-5,9,7,0,16,56.250,56.250
14,0.000,Sheep,16-23,44,51,0,95,46.316,46.316
14,0.000,Sheep,23-5,54,35,0,89,60.674,60.674
14,0.000,Hu and Dg,16-23,7,8,0,15,46.667,46.667
14,0.000,Hu and Dg,23-5,20,25,0,45,44.444,44.444
14,0.000,Common Loon,16-23,0,0,0,0,NaN,NaN
14,0.000,Common Loon,23-5,0,0,0,0,NaN,NaN
14,0.000,Red-Winged Blackbird,16-23,0,0,0,0,NaN,NaN
14,0.000,Red-Winged Blackbird,23-5,0,0,0,0,NaN,NaN
14,0.000,Cw,16-23,6,8,0,14,42.857,42.857
14,0.000,Cw,23-5,5,21,0,26,19.231,19.231
14,0.000,Cliff Sparrow,16-23,0,4,0,4,0.000,0.000
14,0.000,Cliff Sparrow,23-5,0,0,0,0,NaN,NaN
14,0.000,Pig,16-23,6,4,0,10,60.000,60.000
14,0.000,Pig,23-5,0,1,0,1,0.000,0.000
14,0.000,Barn Owl,16-23,0,0,0,0,NaN,NaN
14,0.000,Barn Owl,23-5,0,0,0,0,NaN,NaN
14,0.000,Wild Pig,16-23,0,0,0,0,NaN,NaN
14,0.000,Wild Pig,23-5,0,0,0,0,NaN,NaN
14,0.000,Pennington Creek Water,16-23,0,0,0,0,NaN,NaN
14,0.000,Pennington Creek Water,23-5,0,0,0,0,NaN,NaN
14,0.000,Guinni,16-23,0,0,0,0,NaN,NaN
14,0.000,Guinni,23-5,0,0,0,0,NaN,NaN
14,0.000,Racoon,16-23,0,0,0,0,NaN,NaN
14,0.000,Racoon,23-5,0,0,0,0,NaN,NaN
14,0.000,Hu,16-23,12,8,0,20,60.000,60.000
14,0.000,Hu,23-5,22,18,0,40,55.000,55.000
14,0.000,Cw and Dg,16-23,7,12,0,19,36.842,36.842
14,0.000,Cw and Dg,23-5,13,16,0,29,44.828,44.828
14,0.000,Red Wind Blackbird,16-23,0,0,0,0,NaN,NaN
14,0.000,Red Wind Blackbird,23-5,0,0,0,0,NaN,NaN
14,0.000,Tree Swallow,16-23,0,0,0,0,NaN,NaN
14,0.000,Tree Swallow,23-5,0,0,0,0,NaN,NaN
14,0.000,Turkey Vulture,16-23,0,0,0,0,NaN,NaN
14,0.000,Turkey Vulture,23-5,0,0,0,0,NaN,NaN
14,0.000,Dg,16-23,7,9,0,16,43.750,43.750
14,0.000,Dg,23-5,31,35,0,66,46.970,46.970
14,0.000,Western Kingbird,16-23,0,0,0,0,NaN,NaN
14,0.000,Western Kingbird,23-5,0,0,0,0,NaN,NaN
14,0.000,White Crowned Sparrow,16-23,0,0,0,0,NaN,NaN
14,0.000,White Crowned Sparrow,23-5,0,1,0,1,0.000,0.000
14,0.000,Eared Grebe,16-23,0,0,0,0,NaN,NaN
14,0.000,Eared Grebe,23-5,0,5,0,5,0.000,0.000
14,0.000,cougar,16-23,0,0,0,0,NaN,NaN
14,0.000,cougar,23-5,0,0,0,0,NaN,NaN
14,0.000,Ocean Water,16-23,0,0,0,0,NaN,NaN
14,0.000,Ocean Water,23-5,0,0,0,0,NaN,NaN
14,0.000,Red Tailed Hawk,16-23,0,0,0,0,NaN,NaN
14,0.000,Red Tailed Hawk,23-5,0,1,0,1,0.000,0.000
14,0.000,Dog,16-23,51,72,0,123,41.463,41.463
14,0.000,Dog,23-5,88,142,0,230,38.261,38.261
14,0.000,Human,16-23,1762,837,0,2599,67.795,67.795
14,0.000,Human,23-5,2175,719,0,2894,75.155,75.155
14,0.000,Wild Turkey,16-23,1,2,0,3,33.333,33.333
14,0.000,Wild Turkey,23-5,0,6,0,6,0.000,0.000
14,0.000,Clark Grebe,16-23,0,0,0,0,NaN,NaN
14,0.000,Clark Grebe,23-5,0,0,0,0,NaN,NaN
14,0.000,Seagull,16-23,0,0,0,0,NaN,NaN
14,0.000,Seagull,23-5,44,8,0,52,84.615,84.615
14,0.000,Surf Scoter,16-23,0,0,0,0,NaN,NaN
14,0.000,Surf Scoter,23-5,0,0,0,0,NaN,NaN
14,0.000,Pigeon,16-23,54,122,0,176,30.682,30.682
14,0.000,Pigeon,23-5,116,128,0,244,47.541,47.541
14,0.000,Pacific Ocean Water,16-23,0,0,0,0,NaN,NaN
14,0.000,Pacific Ocean Water,23-5,0,0,0,0,NaN,NaN
14,0.000,Cat,16-23,17,19,0,36,47.222,47.222
14,0.000,Cat,23-5,18,16,0,34,52.941,52.941
14,0.000,Horse,16-23,5,9,0,14,35.714,35.714
14,0.000,Horse,23-5,20,67,0,87,22.989,22.989
14,0.000,orangutan,16-23,0,0,0,0,NaN,NaN
14,0.000,orangutan,23-5,0,0,0,0,NaN,NaN
14,0.000,Bat,16-23,36,36,0,72,50.000,50.000
14,0.000,Bat,23-5,37,36,0,73,50.685,50.685
14,0.000,Deer,16-23,11,27,0,38,28.947,28.947
14,0.000,Deer,23-5,16,123,0,139,11.511,11.511
14,0.000,Great Horned Owl,16-23,0,0,0,0,NaN,NaN
14,0.000,Great Horned Owl,23-5,0,0,0,0,NaN,NaN
14,0.000,Freshwater Lagoon,16-23,0,0,0,0,NaN,NaN
14,0.000,Freshwater Lagoon,23-5,0,0,0,0,NaN,NaN
14,0.000,Unknown Avian,16-23,0,0,0,0,NaN,NaN
14,0.000,Unknown Avian,23-5,0,0,0,0,NaN,NaN
14,0.000,Human UTI,16-23,73,71,0,144,50.694,50.694
14,0.000,Human UTI,23-5,95,115,0,210,45.238,45.238
14,0.000,unknown,16-23,0,0,0,0,NaN,NaN
14,0.000,unknown,23-5,0,2,0,2,0.000,0.000
14,0.000,SLO Creek Water,16-23,0,0,0,0,NaN,NaN
14,0.000,SLO Creek Water,23-5,0,0,0,0,NaN,NaN
14,0.000,Pig/Swine,16-23,4,5,0,9,44.444,44.444
14,0.000,Pig/Swine,23-5,9,9,0,18,50.000,50.000
14,0.000,Klebsiella,16-23,0,0,0,0,NaN,NaN
14,0.000,Klebsiella,23-5,0,0,0,0,NaN,NaN
14,0.000,Hu Cw and Dg,16-23,5,10,0,15,33.333,33.333
14,0.000,Hu Cw and Dg,23-5,5,5,0,10,50.000,50.000
14,0.000,Ground Squirrel,16-23,75,45,0,120,62.500,62.500
14,0.000,Ground Squirrel,23-5,79,65,0,144,54.861,54.861
14,0.000,Opossum,16-23,0,0,0,0,NaN,NaN
14,0.000,Opossum,23-5,0,0,0,0,NaN,NaN
14,0.000,Cow,16-23,1564,1236,0,2800,55.857,55.857
14,0.000,Cow,23-5,1538,1592,0,3130,49.137,49.137
14,0.000,Deer Mouse,16-23,0,0,0,0,NaN,NaN
14,0.000,Deer Mouse,23-5,0,0,0,0,NaN,NaN
14,0.000,OVERALL,16-23,3748,2600,0,6348,59.042,59.042
14,0.000,OVERALL,23-5,4399,3211,0,7610,57.806,57.806
14,0.500,Chicken,16-23,0,0,0,0,NaN,NaN
14,0.500,Chicken,23-5,5,2,0,7,71.429,71.429
14,0.500,Sea Lion,16-23,0,0,0,0,NaN,NaN
14,0.500,Sea Lion,23-5,0,11,0,11,0.000,0.000
14,0.500,Hu and Cw,16-23,1,5,0,6,16.667,16.667
14,0.500,Hu and Cw,23-5,9,7,0,16,56.250,56.250
14,0.500,Sheep,16-23,44,51,0,95,46.316,46.316
14,0.500,Sheep,23-5,54,35,0,89,60.674,60.674
14,0.500,Hu and Dg,16-23,7,8,0,15,46.667,46.667
14,0.500,Hu and Dg,23-5,20,25,0,45,44.444,44.444
14,0.500,Common Loon,16-23,0,0,0,0,NaN,NaN
14,0.500,Common Loon,23-5,0,0,0,0,NaN,NaN
14,0.500,Red-Winged Blackbird,16-23,0,0,0,0,NaN,NaN
14,0.500,Red-Winged Blackbird,23-5,0,0,0,0,NaN,NaN
14,0.500,Cw,16-23,6,8,0,14,42.857,42.857
14,0.500,Cw,23-5,5,21,0,26,19.231,19.231
14,0.500,Cliff Sparrow,16-23,0,4,0,4,0.000,0.000
14,0.500,Cliff Sparrow,23-5,0,0,0,0,NaN,NaN
14,0.500,Pig,16-23,6,4,0,10,60.000,60.000
14,0.500,Pig,23-5,0,1,0,1,0.000,0.000
14,0.500,Barn Owl,16-23,0,0,0,0,NaN,NaN
14,0.500,Barn Owl,23-5,0,0,0,0,NaN,NaN
14,0.500,Wild Pig,16-23,0,0,0,0,NaN,NaN
14,0.500,Wild Pig,23-5,0,0,0,0,NaN,NaN
14,0.500,Pennington Creek Water,16-23,0,0,0,0,NaN,NaN
14,0.500,Pennington Creek Water,23-5,0,0,0,0,NaN,NaN
14,0.500,Guinni,16-23,0,0,0,0,NaN,NaN
14,0.500,Guinni,23-5,0,0,0,0,NaN,NaN
14,0.500,Racoon,16-23,0,0,0,0,NaN,NaN
14,0.500,Racoon,23-5,0,0,0,0,NaN,NaN
14,0.500,Hu,16-23,12,8,0,20,60.000,60.000
14,0.500,Hu,23-5,22,18,0,40,55.000,55.000
14,0.500,Cw and Dg,16-23,7,12,0,19,36.842,36.842
14,0.500,Cw and Dg,23-5,13,16,0,29,44.828,44.828
14,0.500,Red Wind Blackbird,16-23,0,0,0,0,NaN,NaN
14,0.500,Red Wind Blackbird,23-5,0,0,0,0,NaN,NaN
14,0.500,Tree Swallow,16-23,0,0,0,0,NaN,NaN
14,0.500,Tree Swallow,23-5,0,0,0,0,NaN,NaN
14,0.500,Turkey Vulture,16-23,0,0,0,0,NaN,NaN
14,0.500,Turkey Vulture,23-5,0,0,0,0,NaN,NaN
14,0.500,Dg,16-23,7,9,0,16,43.750,43.750
14,0.500,Dg,23-5,31,35,0,66,46.970,46.970
14,0.500,Western Kingbird,16-23,0,0,0,0,NaN,NaN
14,0.500,Western Kingbird,23-5,0,0,0,0,NaN,NaN
14,0.500,White Crowned Sparrow,16-23,0,0,0,0,NaN,NaN
14,0.500,White Crowned Sparrow,23-5,0,1,0,1,0.000,0.000
14,0.500,Eared Grebe,16-23,0,0,0,0,NaN,NaN
14,0.500,Eared Grebe,23-5,0,5,0,5,0.000,0.000
14,0.500,cougar,16-23,0,0,0,0,NaN,NaN
14,0.500,cougar,23-5,0,0,0,0,NaN,NaN
14,0.500,Ocean Water,16-23,0,0,0,0,NaN,NaN
14,0.500,Ocean Water,23-5,0,0,0,0,NaN,NaN
14,0.500,Red Tailed Hawk,16-23,0,0,0,0,NaN,NaN
14,0.500,Red Tailed Hawk,23-5,0,1,0,1,0.000,0.000
14,0.500,Dog,16-23,51,72,0,123,41.463,41.463
14,0.500,Dog,23-5,88,142,0,230,38.261,38.261
14,0.500,Human,16-23,1762,837,0,2599,67.795,67.795
14,0.500,Human,23-5,2175,719,0,2894,75.155,75.155
14,0.500,Wild Turkey,16-23,1,2,0,3,33.333,33.333
14,0.500,Wild Turkey,23-5,0,6,0,6,0.000,0.000
14,0.500,Clark Grebe,16-23,0,0,0,0,NaN,NaN
14,0.500,Clark Grebe,23-5,0,0,0,0,NaN,NaN
14,0.500,Seagull,16-23,0,0,0,0,NaN,NaN
14,0.500,Seagull,23-5,44,8,0,52,84.615,84.615
14,0.500,Surf Scoter,16-23,0,0,0,0,NaN,NaN
14,0.500,Surf Scoter,23-5,0,0,0,0,NaN,NaN
14,0.500,Pigeon,16-23,54,122,0,176,30.682,30.682
14,0.500,Pigeon,23-5,116,128,0,244,47.541,47.541
14,0.500,Pacific Ocean Water,16-23,0,0,0,0,NaN,NaN
14,0.500,Pacific Ocean Water,23-5,0,0,0,0,NaN,NaN
14,0.500,Cat,16-23,17,19,0,36,47.222,47.222
14,0.500,Cat,23-5,18,16,0,34,52.941,52.941
14,0.500,Horse,16-23,5,9,0,14,35.714,35.714
14,0.500,Horse,23-5,20,67,0,87,22.989,22.989
14,0.500,orangutan,16-23,0,0,0,0,NaN,NaN
14,0.500,orangutan,23-5,0,0,0,0,NaN,NaN
14,0.500,Bat,16-23,36,36,0,72,50.000,50.000
14,0.500,Bat,23-5,37,36,0,73,50.685,50.685
14,0.500,Deer,16-23,11,27,0,38,28.947,28.947
14,0.500,Deer,23-5,16,123,0,139,11.511,11.511
14,0.500,Great Horned Owl,16-23,0,0,0,0,NaN,NaN
14,0.500,Great Horned Owl,23-5,0,0,0,0,NaN,NaN
14,0.500,Freshwater Lagoon,16-23,0,0,0,0,NaN,NaN
14,0.500,Freshwater Lagoon,23-5,0,0,0,0,NaN,NaN
14,0.500,Unknown Avian,16-23,0,0,0,0,NaN,NaN
14,0.500,Unknown Avian,23-5,0,0,0,0,NaN,NaN
14,0.500,Human UTI,16-23,73,71,0,144,50.694,50.694
14,0.500,Human UTI,23-5,95,115,0,210,45.238,45.238
14,0.500,unknown,16-23,0,0,0,0,NaN,NaN
14,0.500,unknown,23-5,0,2,0,2,0.000,0.000
14,0.500,SLO Creek Water,16-23,0,0,0,0,NaN,NaN
14,0.500,SLO Creek Water,23-5,0,0,0,0,NaN,NaN
14,0.500,Pig/Swine,16-23,4,5,0,9,44.444,44.444
14,0.500,Pig/Swine,23-5,9,9,0,18,50.000,50.000
14,0.500,Klebsiella,16-23,0,0,0,0,NaN,NaN
14,0.500,Klebsiella,23-5,0,0,0,0,NaN,NaN
14,0.500,Hu Cw and Dg,16-23,5,10,0,15,33.333,33.333
14,0.500,Hu Cw and Dg,23-5,5,5,0,10,50.000,50.000
14,0.500,Ground Squirrel,16-23,75,45,0,120,62.500,62.500
14,0.500,Ground Squirrel,23-5,79,65,0,144,54.861,54.861
14,0.500,Opossum,16-23,0,0,0,0,NaN,NaN
14,0.500,Opossum,23-5,0,0,0,0,NaN,NaN
14,0.500,Cow,16-23,1564,1236,0,2800,55.857,55.857
14,0.500,Cow,23-5,1538,1592,0,3130,49.137,49.137
14,0.500,Deer Mouse,16-23,0,0,0,0,NaN,NaN
14,0.500,Deer Mouse,23-5,0,0,0,0,NaN,NaN
14,0.500,OVERALL,16-23,3748,2600,0,6348,59.042,59.042
14,0.500,OVERALL,23-5,4399,3211,0,7610,57.806,57.806
14,0.900,Chicken,16-23,0,0,0,0,NaN,NaN
14,0.900,Chicken,23-5,5,2,0,7,71.429,71.429
14,0.900,Sea Lion,16-23,0,0,0,0,NaN,NaN
14,0.900,Sea Lion,23-5,0,11,0,11,0.000,0.000
14,0.900,Hu and Cw,16-23,1,5,0,6,16.667,16.667
14,0.900,Hu and Cw,23-5,9,7,0,16,56.250,56.250
14,0.900,Sheep,16-23,44,51,0,95,46.316,46.316
14,0.900,Sheep,23-5,54,35,0,89,60.674,60.674
14,0.900,Hu and Dg,16-23,7,8,0,15,46.667,46.667
14,0.900,Hu and Dg,23-5,20,25,0,45,44.444,44.444
14,0.900,Common Loon,16-23,0,0,0,0,NaN,NaN
14,0.900,Common Loon,23-5,0,0,0,0,NaN,NaN
14,0.900,Red-Winged Blackbird,16-23,0,0,0,0,NaN,NaN
14,0.900,Red-Winged Blackbird,23-5,0,0,0,0,NaN,NaN
14,0.900,Cw,16-23,6,8,0,14,42.857,42.857
14,0.900,Cw,23-5,5,21,0,26,19.231,19.231
14,0.900,Cliff Sparrow,16-23,0,4,0,4,0.000,0.000
14,0.900,Cliff Sparrow,23-5,0,0,0,0,NaN,NaN
14,0.900,Pig,16-23,6,4,0,10,60.000,60.000
14,0.900,Pig,23-5,0,1,0,1,0.000,0.000
14,0.900,Barn Owl,16-23,0,0,0,0,NaN,NaN
14,0.900,Barn Owl,23-5,0,0,0,0,NaN,NaN
14,0.900,Wild Pig,16-23,0,0,0,0,NaN,NaN
14,0.900,Wild Pig,23-5,0,0,0,0,NaN,NaN
14,0.900,Pennington Creek Water,16-23,0,0,0,0,NaN,NaN
14,0.900,Pennington Creek Water,23-5,0,0,0,0,NaN,NaN
14,0.900,Guinni,16-23,0,0,0,0,NaN,NaN
14,0.900,Guinni,23-5,0,0,0,0,NaN,NaN
14,0.900,Racoon,16-23,0,0,0,0,NaN,NaN
14,0.900,Racoon,23-5,0,0,0,0,NaN,NaN
14,0.900,Hu,16-23,12,8,0,20,60.000,60.000
14,0.900,Hu,23-5,22,18,0,40,55.000,55.000
14,0.900,Cw and Dg,16-23,7,12,0,19,36.842,36.842
14,0.900,Cw and Dg,23-5,13,16,0,29,44.828,44.828
14,0.900,Red Wind Blackbird,16-23,0,0,0,0,NaN,NaN
14,0.900,Red Wind Blackbird,23-5,0,0,0,0,NaN,NaN
14,0.900,Tree Swallow,16-23,0,0,0,0,NaN,NaN
14,0.900,Tree Swallow,23-5,0,0,0,0,NaN,NaN
14,0.900,Turkey Vulture,16-23,0,0,0,0,NaN,NaN
14,0.900,Turkey Vulture,23-5,0,0,0,0,NaN,NaN
14,0.900,Dg,16-23,7,9,0,16,43.750,43.750
14,0.900,Dg,23-5,31,35,0,66,46.970,46.970
14,0.900,Western Kingbird,16-23,0,0,0,0,NaN,NaN
14,0.900,Western Kingbird,23-5,0,0,0,0,NaN,NaN
14,0.900,White Crowned Sparrow,16-23,0,0,0,0,NaN,NaN
14,0.900,White Crowned Sparrow,23-5,0,1,0,1,0.000,0.000
14,0.900,Eared Grebe,16-23,0,0,0,0,NaN,NaN
14,0.900,Eared Grebe,23-5,0,5,0,5,0.000,0.000
14,0.900,cougar,16-23,0,0,0,0,NaN,NaN
14,0.900,cougar,23-5,0,0,0,0,NaN,NaN
14,0.900,Ocean Water,16-23,0,0,0,0,NaN,NaN
14,0.900,Ocean Water,23-5,0,0,0,0,NaN,NaN
14,0.900,Red Tailed Hawk,16-23,0,0,0,0,NaN,NaN
14,0.900,Red Tailed Hawk,23-5,0,1,0,1,0.000,0.000
14,0.900,Dog,16-23,51,72,0,123,41.463,41.463
14,0.900,Dog,23-5,88,137,0,225,39.111,39.111
14,0.900,Human,16-23,1762,834,0,2596,67.874,67.874
14,0.900,Human,23-5,2175,715,0,2890,75.260,75.260
14,0.900,Wild Turkey,16-23,1,2,0,3,33.333,33.333
14,0.900,Wild Turkey,23-5,0,6,0,6,0.000,0.000
14,0.900,Clark Grebe,16-23,0,0,0,0,NaN,NaN
14,0.900,Clark Grebe,23-5,0,0,0,0,NaN,NaN
14,0.900,Seagull,16-23,0,0,0,0,NaN,NaN
14,0.900,Seagull,23-5,44,9,0,53,83.019,83.019
14,0.900,Surf Scoter,16-23,0,0,0,0,NaN,NaN
14,0.900,Surf Scoter,23-5,0,0,0,0,NaN,NaN
14,0.900,Pigeon,16-23,54,123,0,177,30.508,30.508
14,0.900,Pigeon,23-5,116,128,0,244,47.541,47.541
14,0.900,Pacific Ocean Water,16-23,0,0,0,0,NaN,NaN
14,0.900,Pacific Ocean Water,23-5,0,0,0,0,NaN,NaN
14,0.900,Cat,16-23,17,19,0,36,47.222,47.222
14,0.900,Cat,23-5,18,16,0,34,52.941,52.941
14,0.900,Horse,16-23,5,9,0,14,35.714,35.714
14,0.900,Horse,23-5,20,67,0,87,22.989,22.989
14,0.900,orangutan,16-23,0,0,0,0,NaN,NaN
14,0.900,orangutan,23-5,0,0,0,0,NaN,NaN
14,0.900,Bat,16-23,36,36,0,72,50.000,50.000
14,0.900,Bat,23-5,37,36,0,73,50.685,50.685
14,0.900,Deer,16-23,11,27,0,38,28.947,28.947
14,0.900,Deer,23-5,16,123,0,139,11.511,11.511
14,0.900,Great Horned Owl,16-23,0,0,0,0,NaN,NaN
14,0.900,Great Horned Owl,23-5,0,0,0,0,NaN,NaN
14,0.900,Freshwater Lagoon,16-23,0,0,0,0,NaN,NaN
14,0.900,Freshwater Lagoon,23-5,0,0,0,0,NaN,NaN
14,0.900,Unknown Avian,16-23,0,0,0,0,NaN,NaN
14,0.900,Unknown Avian,23-5,0,0,0,0,NaN,NaN
14,0.900,Human UTI,16-23,73,71,0,144,50.694,50.694
14,0.900,Human UTI,23-5,98,115,0,213,46.009,46.009
14,0.900,unknown,16-23,0,0,0,0,NaN,NaN
14,0.900,unknown,23-5,0,2,0,2,0.000,0.000
14,0.900,SLO Creek Water,16-23,0,0,0,0,NaN,NaN
14,0.900,SLO Creek Water,23-5,0,0,0,0,NaN,NaN
14,0.900,Pig/Swine,16-23,4,5,0,9,44.444,44.444
14,0.900,Pig/Swine,23-5,9,9,0,18,50.000,50.000
14,0.900,Klebsiella,16-23,0,0,0,0,NaN,NaN
14,0.900,Klebsiella,23-5,0,0,0,0,NaN,NaN
14,0.900,Hu Cw and Dg,16-23,5,10,0,15,33.333,33.333
14,0.900,Hu Cw and Dg,23-5,5,5,0,10,50.000,50.000
14,0.900,Ground Squirrel,16-23,75,45,0,120,62.500,62.500
14,0.900,Ground Squirrel,23-5,79,65,0,144,54.861,54.861
14,0.900,Opossum,16-23,0,0,0,0,NaN,NaN
14,0.900,Opossum,23-5,0,0,0,0,NaN,NaN
14,0.900,Cow,16-23,1566,1232,0,2798,55.969,55.969
14,0.900,Cow,23-5,1538,1589,0,3127,49.185,49.185
14,0.900,Deer Mouse,16-23,0,0,0,0,NaN,NaN
14,0.900,Deer Mouse,23-5,0,0,0,0,NaN,NaN
14,0.900,OVERALL,16-23,3750,2594,0,6344,59.111,59.111
14,0.900,OVERALL,23-5,4402,3200,0,7602,57.906,57.906
14,0.950,Chicken,16-23,0,0,0,0,NaN,NaN
14,0.950,Chicken,23-5,5,2,0,7,71.429,71.429
14,0.950,Sea Lion,16-23,0,0,0,0,NaN,NaN
14,0.950,Sea Lion,23-5,0,11,0,11,0.000,0.000
14,0.950,Hu and Cw,16-23,1,5,0,6,16.667,16.667
14,0.950,Hu and Cw,23-5,9,7,0,16,56.250,56.250
14,0.950,Sheep,16-23,44,51,0,95,46.316,46.316
14,0.950,Sheep,23-5,54,35,0,89,60.674,60.674
14,0.950,Hu and Dg,16-23,7,8,0,15,46.667,46.667
14,0.950,Hu and Dg,23-5,20,25,0,45,44.444,44.444
14,0.950,Common Loon,16-23,0,0,0,0,NaN,NaN
14,0.950,Common Loon,23-5,0,0,0,0,NaN,NaN
14,0.950,Red-Winged Blackbird,16-23,0,0,0,0,NaN,NaN
14,0.950,Red-Winged Blackbird,23-5,0,0,0,0,NaN,NaN
14,0.950,Cw,16-23,6,8,0,14,42.857,42.857
14,0.950,Cw,23-5,5,21,0,26,19.231,19.231
14,0.950,Cliff Sparrow,16-23,0,4,0,4,0.000,0.000
14,0.950,Cliff Sparrow,23-5,0,0,0,0,NaN,NaN
14,0.950,Pig,16-23,6,4,0,10,60.000,60.000
14,0.950,Pig,23-5,0,1,0,1,0.000,0.000
14,0.950,Barn Owl,16-23,0,0,0,0,NaN,NaN
14,0.950,Barn Owl,23-5,0,0,0,0,NaN,NaN
14,0.950,Wild Pig,16-23,0,0,0,0,NaN,NaN
14,0.950,Wild Pig,23-5,0,0,0,0,NaN,NaN
14,0.950,Pennington Creek Water,16-23,0,0,0,0,NaN,NaN
14,0.950,Pennington Creek Water,23-5,0,0,0,0,NaN,NaN
14,0.950,Guinni,16-23,0,0,0,0,NaN,NaN
14,0.950,Guinni,23-5,0,0,0,0,NaN,NaN
14,0.950,Racoon,16-23,0,0,0,0,NaN,NaN
14,0.950,Racoon,23-5,0,0,0,0,NaN,NaN
14,0.950,Hu,16-23,12,8,0,20,60.000,60.000
14,0.950,Hu,23-5,22,18,0,40,55.000,55.000
14,0.950,Cw and Dg,16-23,7,12,0,19,36.842,36.842
14,0.950,Cw and Dg,23-5,13,16,0,29,44.828,44.828
14,0.950,Red Wind Blackbird,16-23,0,0,0,0,NaN,NaN
14,0.950,Red Wind Blackbird,23-5,0,0,0,0,NaN,NaN
14,0.950,Tree Swallow,16-23,0,0,0,0,NaN,NaN
14,0.950,Tree Swallow,23-5,0,0,0,0,NaN,NaN
14,0.950,Turkey Vulture,16-23,0,0,0,0,NaN,NaN
14,0.950,Turkey Vulture,23-5,0,0,0,0,NaN,NaN
14,0.950,Dg,16-23,7,9,0,16,43.750,43.750
14,0.950,Dg,23-5,31,35,0,66,46.970,46.970
14,0.950,Western Kingbird,16-23,0,0,0,0,NaN,NaN
14,0.950,Western Kingbird,23-5,0,0,0,0,NaN,NaN
14,0.950,White Crowned Sparrow,16-23,0,0,0,0,NaN,NaN
14,0.950,White Crowned Sparrow,23-5,0,1,0,1,0.000,0.000
14,0.950,Eared Grebe,16-23,0,0,0,0,NaN,NaN
14,0.950,Eared Grebe,23-5,0,5,0,5,0.000,0.000
14,0.950,cougar,16-23,0,0,0,0,NaN,NaN
14,0.950,cougar,23-5,0,0,0,0,NaN,NaN
14,0.950,Ocean Water,16-23,0,0,0,0,NaN,NaN
14,0.950,Ocean Water,23-5,0,0,0,0,NaN,NaN
14,0.950,Red Tailed Hawk,16-23,0,0,0,0,NaN,NaN
14,0.950,Red Tailed Hawk,23-5,0,1,0,1,0.000,0.000
14,0.950,Dog,16-23,51,72,0,123,41.463,41.463
14,0.950,Dog,23-5,88,135,0,223,39.462,39.462
14,0.950,Human,16-23,1762,831,0,2593,67.952,67.952
14,0.950,Human,23-5,2176,707,0,2883,75.477,75.477
14,0.950,Wild Turkey,16-23,1,2,0,3,33.333,33.333
14,0.950,Wild Turkey,23-5,0,5,0,5,0.000,0.000
14,0.950,Clark Grebe,16-23,0,0,0,0,NaN,NaN
14,0.950,Clark Grebe,23-5,0,0,0,0,NaN,NaN
14,0.950,Seagull,16-23,0,0,0,0,NaN,NaN
14,0.950,Seagull,23-5,44,8,0,52,84.615,84.615
14,0.950,Surf Scoter,16-23,0,0,0,0,NaN,NaN
14,0.950,Surf Scoter,23-5,0,0,0,0,NaN,NaN
14,0.950,Pigeon,16-23,55,122,0,177,31.073,31.073
14,0.950,Pigeon,23-5,116,129,0,245,47.347,47.347
14,0.950,Pacific Ocean Water,16-23,0,0,0,0,NaN,NaN
14,0.950,Pacific Ocean Water,23-5,0,0,0,0,NaN,NaN
14,0.950,Cat,16-23,17,19,0,36,47.222,47.222
14,0.950,Cat,23-5,18,17,0,35,51.429,51.429
14,0.950,Horse,16-23,5,9,0,14,35.714,35.714
14,0.950,Horse,23-5,20,67,0,87,22.989,22.989
14,0.950,orangutan,16-23,0,0,0,0,NaN,NaN
14,0.950,orangutan,23-5,0,0,0,0,NaN,NaN
14,0.950,Bat,16-23,36,36,0,72,50.000,50.000
14,0.950,Bat,23-5,37,35,0,72,51.389,51.389
14,0.950,Deer,16-23,11,27,0,38,28.947,28.947
14,0.950,Deer,23-5,16,123,0,139,11.511,11.511
14,0.950,Great Horned Owl,16-23,0,0,0,0,NaN,NaN
14,0.950,Great Horned Owl,23-5,0,0,0,0,NaN,NaN
14,0.950,Freshwater Lagoon,16-23,0,0,0,0,NaN,NaN
14,0.950,Freshwater Lagoon,23-5,0,0,0,0,NaN,NaN
14,0.950,Unknown Avian,16-23,0,0,0,0,NaN,NaN
14,0.950,Unknown Avian,23-5,0,0,0,0,NaN,NaN
14,0.950,Human UTI,16-23,76,72,0,148,51.351,51.351
14,0.950,Human UTI,23-5,97,118,0,215,45.116,45.116
14,0.950,unknown,16-23,0,0,0,0,NaN,NaN
14,0.950,unknown,23-5,0,2,0,2,0.000,0.000
14,0.950,SLO Creek Water,16-23,0,0,0,0,NaN,NaN
14,0.950,SLO Creek Water,23-5,0,0,0,0,NaN,NaN
14,0.950,Pig/Swine,16-23,4,5,0,9,44.444,44.444
14,0.950,Pig/Swine,23-5,9,9,0,18,50.000,50.000
14,0.950,Klebsiella,16-23,0,0,0,0,NaN,NaN
14,0.950,Klebsiella,23-5,0,0,0,0,NaN,NaN
14,0.950,Hu Cw and Dg,16-23,5,10,0,15,33.333,33.333
14,0.950,Hu Cw and Dg,23-5,5,5,0,10,50.000,50.000
14,0.950,Ground Squirrel,16-23,75,45,0,120,62.500,62.500
14,0.950,Ground Squirrel,23-5,79,64,0,143,55.245,55.245
14,0.950,Opossum,16-23,0,0,0,0,NaN,NaN
14,0.950,Opossum,23-5,0,0,0,0,NaN,NaN
14,0.950,Cow,16-23,1569,1211,0,2780,56.439,56.439
14,0.950,Cow,23-5,1537,1587,0,3124,49.200,49.200
14,0.950,Deer Mouse,16-23,0,0,0,0,NaN,NaN
14,0.950,Deer Mouse,23-5,0,0,0,0,NaN,NaN
14,0.950,OVERALL,16-23,3757,2570,0,6327,59.380,59.380
14,0.950,OVERALL,23-5,4401,3189,0,7590,57.984,57.984
14,0.960,Chicken,16-23,0,0,0,0,NaN,NaN
14,0.960,Chicken,23-5,5,2,0,7,71.429,71.429
14,0.960,Sea Lion,16-23,0,0,0,0,NaN,NaN
14,0.960,Sea Lion,23-5,0,11,0,11,0.000,0.000
14,0.960,Hu and Cw,16-23,1,5,0,6,16.667,16.667
14,0.960,Hu and Cw,23-5,9,7,0,16,56.250,56.250
14,0.960,Sheep,16-23,44,51,0,95,46.316,46.316
14,0.960,Sheep,23-5,54,36,0,90,60.000,60.000
14,0.960,Hu and Dg,16-23,7,8,0,15,46.667,46.667
14,0.960,Hu and Dg,23-5,20,25,0,45,44.444,44.444
14,0.960,Common Loon,16-23,0,0,0,0,NaN,NaN
14,0.960,Common Loon,23-5,0,0,0,0,NaN,NaN
14,0.960,Red-Winged Blackbird,16-23,0,0,0,0,NaN,NaN
14,0.960,Red-Winged Blackbird,23-5,0,0,0,0,NaN,NaN
14,0.960,Cw,16-23,6,8,0,14,42.857,42.857
14,0.960,Cw,23-5,5,21,0,26,19.231,19.231
14,0.960,Cliff Sparrow,16-23,0,4,0,4,0.000,0.000
14,0.960,Cliff Sparrow,23-5,0,0,0,0,NaN,NaN
14,0.960,Pig,16-23,6,4,0,10,60.000,60.000
14,0.960,Pig,23-5,0,1,0,1,0.000,0.000
14,0.960,Barn Owl,16-23,0,0,0,0,NaN,NaN
14,0.960,Barn Owl,23-5,0,0,0,0,NaN,NaN
14,0.960,Wild Pig,16-23,0,0,0,0,NaN,NaN
14,0.960,Wild Pig,23-5,1,0,0,1,100.000,100.000
14,0.960,Pennington Creek Water,16-23,0,0,0,0,NaN,NaN
14,0.960,Pennington Creek Water,23-5,0,0,0,0,NaN,NaN
14,0.960,Guinni,16-23,0,0,0,0,NaN,NaN
14,0.960,Guinni,23-5,0,0,0,0,NaN,NaN
14,0.960,Racoon,16-23,0,0,0,0,NaN,NaN
14,0.960,Racoon,23-5,0,0,0,0,NaN,NaN
14,0.960,Hu,16-23,12,8,0,20,60.000,60.000
14,0.960,Hu,23-5,22,18,0,40,55.000,55.000
14,0.960,Cw and Dg,16-23,7,12,0,19,36.842,36.842
14,0.960,Cw and Dg,23-5,13,16,0,29,44.828,44.828
14,0.960,Red Wind Blackbird,16-23,0,0,0,0,NaN,NaN
14,0.960,Red Wind Blackbird,23-5,0,0,0,0,NaN,NaN
14,0.960,Tree Swallow,16-23,0,0,0,0,NaN,NaN
14,0.960,Tree Swallow,23-5,0,0,0,0,NaN,NaN
14,0.960,Turkey Vulture,16-23,0,0,0,0,NaN,NaN
14,0.960,Turkey Vulture,23-5,0,0,0,0,NaN,NaN
14,0.960,Dg,16-23,7,9,0,16,43.750,43.750
14,0.960,Dg,23-5,31,35,0,66,46.970,46.970
14,0.960,Western Kingbird,16-23,0,0,0,0,NaN,NaN
14,0.960,Western Kingbird,23-5,0,0,0,0,NaN,NaN
14,0.960,White Crowned Sparrow,16-23,0,0,0,0,NaN,NaN
14,0.960,White Crowned Sparrow,23-5,0,1,0,1,0.000,0.000
14,0.960,Eared Grebe,16-23,0,0,0,0,NaN,NaN
14,0.960,Eared Grebe,23-5,0,5,0,5,0.000,0.000
14,0.960,cougar,16-23,0,0,0,0,NaN,NaN
14,0.960,cougar,23-5,0,0,0,0,NaN,NaN
14,0.960,Ocean Water,16-23,0,0,0,0,NaN,NaN
14,0.960,Ocean Water,23-5,0,0,0,0,NaN,NaN
14,0.960,Red Tailed Hawk,16-23,0,0,0,0,NaN,NaN
14,0.960,Red Tailed Hawk,23-5,0,1,0,1,0.000,0.000
14,0.960,Dog,16-23,51,72,0,123,41.463,41.463
14,0.960,Dog,23-5,88,130,0,218,40.367,40.367
14,0.960,Human,16-23,1764,830,0,2594,68.003,68.003
14,0.960,Human,23-5,2176,692,0,2868,75.872,75.872
14,0.960,Wild Turkey,16-23,1,2,0,3,33.333,33.333
14,0.960,Wild Turkey,23-5,0,10,0,10,0.000,0.000
14,0.960,Clark Grebe,16-23,0,0,0,0,NaN,NaN
14,0.960,Clark Grebe,23-5,0,0,0,0,NaN,NaN
14,0.960,Seagull,16-23,0,0,0,0,NaN,NaN
14,0.960,Seagull,23-5,44,9,0,53,83.019,83.019
14,0.960,Surf Scoter,16-23,0,0,0,0,NaN,NaN
14,0.960,Surf Scoter,23-5,0,2,0,2,0.000,0.000
14,0.960,Pigeon,16-23,55,122,0,177,31.073,31.073
14,0.960,Pigeon,23-5,117,145,0,262,44.656,44.656
14,0.960,Pacific Ocean Water,16-23,0,0,0,0,NaN,NaN
14,0.960,Pacific Ocean Water,23-5,0,0,0,0,NaN,NaN
14,0.960,Cat,16-23,17,19,0,36,47.222,47.222
14,0.960,Cat,23-5,18,17,0,35,51.429,51.429
14,0.960,Horse,16-23,5,9,0,14,35.714,35.714
14,0.960,Horse,23-5,20,67,0,87,22.989,22.989
14,0.960,orangutan,16-23,0,0,0,0,NaN,NaN
14,0.960,orangutan,23-5,0,0,0,0,NaN,NaN
14,0.960,Bat,16-23,36,36,0,72,50.000,50.000
14,0.960,Bat,23-5,37,35,0,72,51.389,51.389
14,0.960,Deer,16-23,11,27,0,38,28.947,28.947
14,0.960,Deer,23-5,16,123,0,139,11.511,11.511
14,0.960,Great Horned Owl,16-23,0,0,0,0,NaN,NaN
14,0.960,Great Horned Owl,23-5,0,0,0,0,NaN,NaN
14,0.960,Freshwater Lagoon,16-23,0,0,0,0,NaN,NaN
14,0.960,Freshwater Lagoon,23-5,0,0,0,0,NaN,NaN
14,0.960,Unknown Avian,16-23,0,0,0,0,NaN,NaN
14,0.960,Unknown Avian,23-5,0,0,0,0,NaN,NaN
14,0.960,Human UTI,16-23,76,73,0,149,51.007,51.007
14,0.960,Human UTI,23-5,97,117,0,214,45.327,45.327
14,0.960,unknown,16-23,0,0,0,0,NaN,NaN
14,0.960,unknown,23-5,0,2,0,2,0.000,0.000
14,0.960,SLO Creek Water,16-23,0,0,0,0,NaN,NaN
14,0.960,SLO Creek Water,23-5,0,0,0,0,NaN,NaN
14,0.960,Pig/Swine,16-23,4,5,0,9,44.444,44.444
14,0.960,Pig/Swine,23-5,9,9,0,18,50.000,50.000
14,0.960,Klebsiella,16-23,0,0,0,0,NaN,NaN
14,0.960,Klebsiella,23-5,0,0,0,0,NaN,NaN
14,0.960,Hu Cw and Dg,16-23,5,10,0,15,33.333,33.333
14,0.960,Hu Cw and Dg,23-5,5,5,0,10,50.000,50.000
14,0.960,Ground Squirrel,16-23,75,45,0,120,62.500,62.500
14,0.960,Ground Squirrel,23-5,79,66,0,145,54.483,54.483
14,0.960,Opossum,16-23,0,0,0,0,NaN,NaN
14,0.960,Opossum,23-5,0,0,0,0,NaN,NaN
14,0.960,Cow,16-23,1567,1200,0,2767,56.632,56.632
14,0.960,Cow,23-5,1537,1569,0,3106,49.485,49.485
14,0.960,Deer Mouse,16-23,0,0,0,0,NaN,NaN
14,0.960,Deer Mouse,23-5,0,0,0,0,NaN,NaN
14,0.960,OVERALL,16-23,3757,2559,0,6316,59.484,59.484
14,0.960,OVERALL,23-5,4403,3177,0,7580,58.087,58.087
14,0.970,Chicken,16-23,0,0,0,0,NaN,NaN
14,0.970,Chicken,23-5,5,2,0,7,71.429,71.429
14,0.970,Sea Lion,16-23,0,0,0,0,NaN,NaN
14,0.970,Sea Lion,23-5,0,11,0,11,0.000,0.000
14,0.970,Hu and Cw,16-23,1,5,0,6,16.667,16.667
14,0.970,Hu and Cw,23-5,9,7,0,16,56.250,56.250
14,0.970,Sheep,16-23,45,52,0,97,46.392,46.392
14,0.970,Sheep,23-5,54,35,0,89,60.674,60.674
14,0.970,Hu and Dg,16-23,7,8,0,15,46.667,46.667
14,0.970,Hu and Dg,23-5,20,25,0,45,44.444,44.444
14,0.970,Common Loon,16-23,0,0,0,0,NaN,NaN
14,0.970,Common Loon,23-5,0,0,0,0,NaN,NaN
14,0.970,Red-Winged Blackbird,16-23,0,0,0,0,NaN,NaN
14,0.970,Red-Winged Blackbird,23-5,0,0,0,0,NaN,NaN
14,0.970,Cw,16-23,6,9,0,15,40.000,40.000
14,0.970,Cw,23-5,5,21,0,26,19.231,19.231
14,0.970,Cliff Sparrow,16-23,0,4,0,4,0.000,0.000
14,0.970,Cliff Sparrow,23-5,0,0,0,0,NaN,NaN
14,0.970,Pig,16-23,6,4,0,10,60.000,60.000
14,0.970,Pig,23-5,0,1,0,1,0.000,0.000
14,0.970,Barn Owl,16-23,0,0,0,0,NaN,NaN
14,0.970,Barn Owl,23-5,0,0,0,0,NaN,NaN
14,0.970,Wild Pig,16-23,0,0,0,0,NaN,NaN
14,0.970,Wild Pig,23-5,0,0,0,0,NaN,NaN
14,0.970,Pennington Creek Water,16-23,0,0,0,0,NaN,NaN
14,0.970,Pennington Creek Water,23-5,0,0,0,0,NaN,NaN
14,0.970,Guinni,16-23,0,0,0,0,NaN,NaN
14,0.970,Guinni,23-5,0,0,0,0,NaN,NaN
14,0.970,Racoon,16-23,0,0,0,0,NaN,NaN
14,0.970,Racoon,23-5,0,0,0,0,NaN,NaN
14,0.970,Hu,16-23,12,8,0,20,60.000,60.000
14,0.970,Hu,23-5,22,18,0,40,55.000,55.000
14,0.970,Cw and Dg,16-23,7,12,0,19,36.842,36.842
14,0.970,Cw and Dg,23-5,13,16,0,29,44.828,44.828
14,0.970,Red Wind Blackbird,16-23,0,0,0,0,NaN,NaN
14,0.970,Red Wind Blackbird,23-5,0,0,0,0,NaN,NaN
14,0.970,Tree Swallow,16-23,0,0,0,0,NaN,NaN
14,0.970,Tree Swallow,23-5,0,0,0,0,NaN,NaN
14,0.970,Turkey Vulture,16-23,0,0,0,0,NaN,NaN
14,0.970,Turkey Vulture,23-5,0,0,0,0,NaN,NaN
14,0.970,Dg,16-23,7,9,0,16,43.750,43.750
14,0.970,Dg,23-5,31,34,0,65,47.692,47.692
14,0.970,Western Kingbird,16-23,0,0,0,0,NaN,NaN
14,0.970,Western Kingbird,23-5,0,0,0,0,NaN,NaN
14,0.970,White Crowned Sparrow,16-23,0,0,0,0,NaN,NaN
14,0.970,White Crowned Sparrow,23-5,0,1,0,1,0.000,0.000
14,0.970,Eared Grebe,16-23,0,0,0,0,NaN,NaN
14,0.970,Eared Grebe,23-5,0,5,0,5,0.000,0.000
14,0.970,cougar,16-23,0,0,0,0,NaN,NaN
14,0.970,cougar,23-5,0,0,0,0,NaN,NaN
14,0.970,Ocean Water,16-23,0,0,0,0,NaN,NaN
14,0.970,Ocean Water,23-5,0,0,0,0,NaN,NaN
14,0.970,Red Tailed Hawk,16-23,0,0,0,0,NaN,NaN
14,0.970,Red Tailed Hawk,23-5,0,1,0,1,0.000,0.000
14,0.970,Dog,16-23,52,72,0,124,41.935,41.935
14,0.970,Dog,23-5,89,129,0,218,40.826,40.826
14,0.970,Human,16-23,1763,827,0,2590,68.069,68.069
14,0.970,Human,23-5,2175,690,0,2865,75.916,75.916
14,0.970,Wild Turkey,16-23,1,4,0,5,20.000,20.000
14,0.970,Wild Turkey,23-5,2,9,0,11,18.182,18.182
14,0.970,Clark Grebe,16-23,0,0,0,0,NaN,NaN
14,0.970,Clark Grebe,23-5,0,0,0,0,NaN,NaN
14,0.970,Seagull,16-23,0,0,0,0,NaN,NaN
14,0.970,Seagull,23-5,44,10,0,54,81.481,81.481
14,0.970,Surf Scoter,16-23,0,0,0,0,NaN,NaN
14,0.970,Surf Scoter,23-5,0,2,0,2,0.000,0.000
14,0.970,Pigeon,16-23,54,121,0,175,30.857,30.857
14,0.970,Pigeon,23-5,117,161,0,278,42.086,42.086
14,0.970,Pacific Ocean Water,16-23,0,0,0,0,NaN,NaN
14,0.970,Pacific Ocean Water,23-5,0,0,0,0,NaN,NaN
14,0.970,Cat,16-23,17,19,0,36,47.222,47.222
14,0.970,Cat,23-5,18,17,0,35,51.429,51.429
14,0.970,Horse,16-23,5,9,0,14,35.714,35.714
14,0.970,Horse,23-5,20,68,0,88,22.727,22.727
14,0.970,orangutan,16-23,0,0,0,0,NaN,NaN
14,0.970,orangutan,23-5,0,0,0,0,NaN,NaN
14,0.970,Bat,16-23,36,36,0,72,50.000,50.000
14,0.970,Bat,23-5,37,35,0,72,51.389,51.389
14,0.970,Deer,16-23,11,27,0,38,28.947,28.947
14,0.970,Deer,23-5,16,123,0,139,11.511,11.511
14,0.970,Great Horned Owl,16-23,0,0,0,0,NaN,NaN
14,0.970,Great Horned Owl,23-5,0,0,0,0,NaN,NaN
14,0.970,Freshwater Lagoon,16-23,0,0,0,0,NaN,NaN
14,0.970,Freshwater Lagoon,23-5,0,0,0,0,NaN,NaN
14,0.970,Unknown Avian,16-23,0,0,0,0,NaN,NaN
14,0.970,Unknown Avian,23-5,0,0,0,0,NaN,NaN
14,0.970,Human UTI,16-23,76,74,0,150,50.667,50.667
14,0.970,Human UTI,23-5,96,117,0,213,45.070,45.070
14,0.970,unknown,16-23,0,0,0,0,NaN,NaN
14,0.970,unknown,23-5,0,2,0,2,0.000,0.000
14,0.970,SLO Creek Water,16-23,0,0,0,0,NaN,NaN
14,0.970,SLO Creek Water,23-5,0,0,0,0,NaN,NaN
14,0.970,Pig/Swine,16-23,4,5,0,9,44.444,44.444
14,0.970,Pig/Swine,23-5,9,9,0,18,50.000,50.000
14,0.970,Klebsiella,16-23,0,0,0,0,NaN,NaN
14,0.970,Klebsiella,23-5,0,0,0,0,NaN,NaN
14,0.970,Hu Cw and Dg,16-23,5,10,0,15,33.333,33.333
14,0.970,Hu Cw and Dg,23-5,5,5,0,10,50.000,50.000
14,0.970,Ground Squirrel,16-23,75,44,0,119,63.025,63.025
14,0.970,Ground Squirrel,23-5,79,64,0,143,55.245,55.245
14,0.970,Opossum,16-23,0,0,0,0,NaN,NaN
14,0.970,Opossum,23-5,0,0,0,0,NaN,NaN
14,0.970,Cow,16-23,1561,1196,0,2757,56.620,56.620
14,0.970,Cow,23-5,1534,1543,0,3077,49.854,49.854
14,0.970,Deer Mouse,16-23,0,0,0,0,NaN,NaN
14,0.970,Deer Mouse,23-5,0,0,0,0,NaN,NaN
14,0.970,OVERALL,16-23,3751,2555,0,6306,59.483,59.483
14,0.970,OVERALL,23-5,4400,3161,0,7561,58.193,58.193
14,0.980,Chicken,16-23,0,0,0,0,NaN,NaN
14,0.980,Chicken,23-5,6,2,0,8,75.000,75.000
14,0.980,Sea Lion,16-23,0,0,0,0,NaN,NaN
14,0.980,Sea Lion,23-5,0,10,0,10,0.000,0.000
14,0.980,Hu and Cw,16-23,1,5,0,6,16.667,16.667
14,0.980,Hu and Cw,23-5,9,17,0,26,34.615,34.615
14,0.980,Sheep,16-23,48,50,0,98,48.980,48.980
14,0.980,Sheep,23-5,53,34,0,87,60.920,60.920
14,0.980,Hu and Dg,16-23,7,8,0,15,46.667,46.667
14,0.980,Hu and Dg,23-5,20,22,0,42,47.619,47.619
14,0.980,Common Loon,16-23,0,0,0,0,NaN,NaN
14,0.980,Common Loon,23-5,0,0,0,0,NaN,NaN
14,0.980,Red-Winged Blackbird,16-23,0,0,0,0,NaN,NaN
14,0.980,Red-Winged Blackbird,23-5,0,0,0,0,NaN,NaN
14,0.980,Cw,16-23,6,8,0,14,42.857,42.857
14,0.980,Cw,23-5,5,23,0,28,17.857,17.857
14,0.980,Cliff Sparrow,16-23,0,4,0,4,0.000,0.000
14,0.980,Cliff Sparrow,23-5,0,0,0,0,NaN,NaN
14,0.980,Pig,16-23,6,4,0,10,60.000,60.000
14,0.980,Pig,23-5,0,1,0,1,0.000,0.000
14,0.980,Barn Owl,16-23,0,0,0,0,NaN,NaN
14,0.980,Barn Owl,23-5,0,0,0,0,NaN,NaN
14,0.980,Wild Pig,16-23,0,0,0,0,NaN,NaN
14,0.980,Wild Pig,23-5,0,0,0,0,NaN,NaN
14,0.980,Pennington Creek Water,16-23,0,0,0,0,NaN,NaN
14,0.980,Pennington Creek Water,23-5,0,0,0,0,NaN,NaN
14,0.980,Guinni,16-23,0,0,0,0,NaN,NaN
14,0.980,Guinni,23-5,0,0,0,0,NaN,NaN
14,0.980,Racoon,16-23,0,0,0,0,NaN,NaN
14,0.980,Racoon,23-5,0,0,0,0,NaN,NaN
14,0.980,Hu,16-23,12,8,0,20,60.000,60.000
14,0.980,Hu,23-5,22,19,0,41,53.659,53.659
14,0.980,Cw and Dg,16-23,7,12,0,19,36.842,36.842
14,0.980,Cw and Dg,23-5,13,18,0,31,41.935,41.935
14,0.980,Red Wind Blackbird,16-23,0,0,0,0,NaN,NaN
14,0.980,Red Wind Blackbird,23-5,0,0,0,0,NaN,NaN
14,0.980,Tree Swallow,16-23,0,0,0,0,NaN,NaN
14,0.980,Tree Swallow,23-5,0,0,0,0,NaN,NaN
14,0.980,Turkey Vulture,16-23,0,0,0,0,NaN,NaN
14,0.980,Turkey Vulture,23-5,0,0,0,0,NaN,NaN
14,0.980,Dg,16-23,7,9,0,16,43.750,43.750
14,0.980,Dg,23-5,31,27,0,58,53.448,53.448
14,0.980,Western Kingbird,16-23,0,0,0,0,NaN,NaN
14,0.980,Western Kingbird,23-5,0,0,0,0,NaN,NaN
14,0.980,White Crowned Sparrow,16-23,0,0,0,0,NaN,NaN
14,0.980,White Crowned Sparrow,23-5,0,3,0,3,0.000,0.000
14,0.980,Eared Grebe,16-23,0,0,0,0,NaN,NaN
14,0.980,Eared Grebe,23-5,0,5,0,5,0.000,0.000
14,0.980,cougar,16-23,0,0,0,0,NaN,NaN
14,0.980,cougar,23-5,0,0,0,0,NaN,NaN
14,0.980,Ocean Water,16-23,0,0,0,0,NaN,NaN
14,0.980,Ocean Water,23-5,0,0,0,0,NaN,NaN
14,0.980,Red Tailed Hawk,16-23,0,0,0,0,NaN,NaN
14,0.980,Red Tailed Hawk,23-5,0,1,0,1,0.000,0.000
14,0.980,Dog,16-23,51,77,0,128,39.844,39.844
14,0.980,Dog,23-5,89,124,0,213,41.784,41.784
14,0.980,Human,16-23,1766,813,0,2579,68.476,68.476
14,0.980,Human,23-5,2177,675,0,2852,76.332,76.332
14,0.980,Wild Turkey,16-23,1,4,0,5,20.000,20.000
14,0.980,Wild Turkey,23-5,4,19,0,23,17.391,17.391
14,0.980,Clark Grebe,16-23,0,0,0,0,NaN,NaN
14,0.980,Clark Grebe,23-5,0,0,0,0,NaN,NaN
14,0.980,Seagull,16-23,0,0,0,0,NaN,NaN
14,0.980,Seagull,23-5,46,8,0,54,85.185,85.185
14,0.980,Surf Scoter,16-23,0,0,0,0,NaN,NaN
14,0.980,Surf Scoter,23-5,2,0,0,2,100.000,100.000
14,0.980,Pigeon,16-23,54,121,0,175,30.857,30.857
14,0.980,Pigeon,23-5,116,169,0,285,40.702,40.702
14,0.980,Pacific Ocean Water,16-23,0,0,0,0,NaN,NaN
14,0.980,Pacific Ocean Water,23-5,0,0,0,0,NaN,NaN
14,0.980,Cat,16-23,17,19,0,36,47.222,47.222
14,0.980,Cat,23-5,20,16,0,36,55.556,55.556
14,0.980,Horse,16-23,5,9,0,14,35.714,35.714
14,0.980,Horse,23-5,20,66,0,86,23.256,23.256
14,0.980,orangutan,16-23,0,0,0,0,NaN,NaN
14,0.980,orangutan,23-5,0,0,0,0,NaN,NaN
14,0.980,Bat,16-23,36,36,0,72,50.000,50.000
14,0.980,Bat,23-5,37,35,0,72,51.389,51.389
14,0.980,Deer,16-23,11,27,0,38,28.947,28.947
14,0.980,Deer,23-5,16,123,0,139,11.511,11.511
14,0.980,Great Horned Owl,16-23,0,0,0,0,NaN,NaN
14,0.980,Great Horned Owl,23-5,0,0,0,0,NaN,NaN
14,0.980,Freshwater Lagoon,16-23,0,0,0,0,NaN,NaN
14,0.980,Freshwater Lagoon,23-5,0,0,0,0,NaN,NaN
14,0.980,Unknown Avian,16-23,0,0,0,0,NaN,NaN
14,0.980,Unknown Avian,23-5,0,0,0,0,NaN,NaN
14,0.980,Human UTI,16-23,76,76,0,152,50.000,50.000
14,0.980,Human UTI,23-5,97,116,0,213,45.540,45.540
14,0.980,unknown,16-23,0,0,0,0,NaN,NaN
14,0.980,unknown,23-5,0,3,0,3,0.000,0.000
14,0.980,SLO Creek Water,16-23,0,0,0,0,NaN,NaN
14,0.980,SLO Creek Water,23-5,0,0,0,0,NaN,NaN
14,0.980,Pig/Swine,16-23,4,5,0,9,44.444,44.444
14,0.980,Pig/Swine,23-5,9,9,0,18,50.000,50.000
14,0.980,Klebsiella,16-23,0,0,0,0,NaN,NaN
14,0.980,Klebsiella,23-5,0,0,0,0,NaN,NaN
14,0.980,Hu Cw and Dg,16-23,5,10,0,15,33.333,33.333
14,0.980,Hu Cw and Dg,23-5,5,4,0,9,55.556,55.556
14,0.980,Ground Squirrel,16-23,77,45,0,122,63.115,63.115
14,0.980,Ground Squirrel,23-5,80,63,0,143,55.944,55.944
14,0.980,Opossum,16-23,0,0,0,0,NaN,NaN
14,0.980,Opossum,23-5,0,0,0,0,NaN,NaN
14,0.980,Cow,16-23,1554,1177,0,2731,56.902,56.902
14,0.980,Cow,23-5,1527,1506,0,3033,50.346,50.346
14,0.980,Deer Mouse,16-23,0,0,0,0,NaN,NaN
14,0.980,Deer Mouse,23-5,0,0,0,0,NaN,NaN
14,0.980,OVERALL,16-23,3751,2527,0,6278,59.748,59.748
14,0.980,OVERALL,23-5,4404,3118,0,7522,58.548,58.548
14,0.990,Chicken,16-23,2,5,0,7,28.571,28.571
14,0.990,Chicken,23-5,7,2,0,9,77.778,77.778
14,0.990,Sea Lion,16-23,0,0,0,0,NaN,NaN
14,0.990,Sea Lion,23-5,4,6,0,10,40.000,40.000
14,0.990,Hu and Cw,16-23,2,5,0,7,28.571,28.571
14,0.990,Hu and Cw,23-5,10,24,0,34,29.412,29.412
14,0.990,Sheep,16-23,47,51,0,98,47.959,47.959
14,0.990,Sheep,23-5,54,34,0,88,61.364,61.364
14,0.990,Hu and Dg,16-23,7,10,0,17,41.176,41.176
14,0.990,Hu and Dg,23-5,20,19,0,39,51.282,51.282
14,0.990,Common Loon,16-23,0,0,0,0,NaN,NaN
14,0.990,Common Loon,23-5,0,2,0,2,0.000,0.000
14,0.990,Red-Winged Blackbird,16-23,0,2,0,2,0.000,0.000
14,0.990,Red-Winged Blackbird,23-5,0,0,0,0,NaN,NaN
14,0.990,Cw,16-23,7,8,0,15,46.667,46.667
14,0.990,Cw,23-5,11,25,0,36,30.556,30.556
14,0.990,Cliff Sparrow,16-23,0,6,0,6,0.000,0.000
14,0.990,Cliff Sparrow,23-5,0,4,0,4,0.000,0.000
14,0.990,Pig,16-23,6,5,0,11,54.545,54.545
14,0.990,Pig,23-5,7,6,0,13,53.846,53.846
14,0.990,Barn Owl,16-23,0,0,0,0,NaN,NaN
14,0.990,Barn Owl,23-5,0,0,0,0,NaN,NaN
14,0.990,Wild Pig,16-23,0,1,0,1,0.000,0.000
14,0.990,Wild Pig,23-5,0,1,0,1,0.000,0.000
14,0.990,Pennington Creek Water,16-23,0,0,0,0,NaN,NaN
14,0.990,Pennington Creek Water,23-5,0,0,0,0,NaN,NaN
14,0.990,Guinni,16-23,0,0,0,0,NaN,NaN
14,0.990,Guinni,23-5,0,0,0,0,NaN,NaN
14,0.990,Racoon,16-23,0,0,0,0,NaN,NaN
14,0.990,Racoon,23-5,0,1,0,1,0.000,0.000
14,0.990,Hu,16-23,12,8,0,20,60.000,60.000
14,0.990,Hu,23-5,22,14,0,36,61.111,61.111
14,0.990,Cw and Dg,16-23,7,12,0,19,36.842,36.842
14,0.990,Cw and Dg,23-5,14,12,0,26,53.846,53.846
14,0.990,Red Wind Blackbird,16-23,0,0,0,0,NaN,NaN
14,0.990,Red Wind Blackbird,23-5,0,0,0,0,NaN,NaN
14,0.990,Tree Swallow,16-23,0,0,0,0,NaN,NaN
14,0.990,Tree Swallow,23-5,0,0,0,0,NaN,NaN
14,0.990,Turkey Vulture,16-23,0,0,0,0,NaN,NaN
14,0.990,Turkey Vulture,23-5,0,0,0,0,NaN,NaN
14,0.990,Dg,16-23,7,9,0,16,43.750,43.750
14,0.990,Dg,23-5,31,21,0,52,59.615,59.615
14,0.990,Western Kingbird,16-23,0,0,0,0,NaN,NaN
14,0.990,Western Kingbird,23-5,0,0,0,0,NaN,NaN
14,0.990,White Crowned Sparrow,16-23,0,0,0,0,NaN,NaN
14,0.990,White Crowned Sparrow,23-5,0,4,0,4,0.000,0.000
14,0.990,Eared Grebe,16-23,0,0,0,0,NaN,NaN
14,0.990,Eared Grebe,23-5,0,7,0,7,0.000,0.000
14,0.990,cougar,16-23,0,1,0,1,0.000,0.000
14,0.990,cougar,23-5,0,0,0,0,NaN,NaN
14,0.990,Ocean Water,16-23,0,0,0,0,NaN,NaN
14,0.990,Ocean Water,23-5,0,0,0,0,NaN,NaN
14,0.990,Red Tailed Hawk,16-23,0,0,0,0,NaN,NaN
14,0.990,Red Tailed Hawk,23-5,0,2,0,2,0.000,0.000
14,0.990,Dog,16-23,54,76,0,130,41.538,41.538
14,0.990,Dog,23-5,95,115,0,210,45.238,45.238
14,0.990,Human,16-23,1755,773,0,2528,69.422,69.422
14,0.990,Human,23-5,2172,613,0,2785,77.989,77.989
14,0.990,Wild Turkey,16-23,3,9,0,12,25.000,25.000
14,0.990,Wild Turkey,23-5,4,20,0,24,16.667,16.667
14,0.990,Clark Grebe,16-23,0,0,0,0,NaN,NaN
14,0.990,Clark Grebe,23-5,2,3,0,5,40.000,40.000
14,0.990,Seagull,16-23,0,0,0,0,NaN,NaN
14,0.990,Seagull,23-5,48,7,0,55,87.273,87.273
14,0.990,Surf Scoter,16-23,0,0,0,0,NaN,NaN
14,0.990,Surf Scoter,23-5,2,0,0,2,100.000,100.000
14,0.990,Pigeon,16-23,64,119,0,183,34.973,34.973
14,0.990,Pigeon,23-5,123,190,0,313,39.297,39.297
14,0.990,Pacific Ocean Water,16-23,0,0,0,0,NaN,NaN
14,0.990,Pacific Ocean Water,23-5,0,0,0,0,NaN,NaN
14,0.990,Cat,16-23,20,22,0,42,47.619,47.619
14,0.990,Cat,23-5,21,20,0,41,51.220,51.220
14,0.990,Horse,16-23,8,10,0,18,44.444,44.444
14,0.990,Horse,23-5,20,87,0,107,18.692,18.692
14,0.990,orangutan,16-23,0,0,0,0,NaN,NaN
14,0.990,orangutan,23-5,0,0,0,0,NaN,NaN
14,0.990,Bat,16-23,36,32,0,68,52.941,52.941
14,0.990,Bat,23-5,37,34,0,71,52.113,52.113
14,0.990,Deer,16-23,11,28,0,39,28.205,28.205
14,0.990,Deer,23-5,16,113,0,129,12.403,12.403
14,0.990,Great Horned Owl,16-23,0,0,0,0,NaN,NaN
14,0.990,Great Horned Owl,23-5,0,0,0,0,NaN,NaN
14,0.990,Freshwater Lagoon,16-23,0,0,0,0,NaN,NaN
14,0.990,Freshwater Lagoon,23-5,0,0,0,0,NaN,NaN
14,0.990,Unknown Avian,16-23,0,0,0,0,NaN,NaN
14,0.990,Unknown Avian,23-5,0,0,0,0,NaN,NaN
14,0.990,Human UTI,16-23,79,66,0,145,54.483,54.483
14,0.990,Human UTI,23-5,97,91,0,188,51.596,51.596
14,0.990,unknown,16-23,0,0,0,0,NaN,NaN
14,0.990,unknown,23-5,0,5,0,5,0.000,0.000
14,0.990,SLO Creek Water,16-23,0,0,0,0,NaN,NaN
14,0.990,SLO Creek Water,23-5,0,0,0,0,NaN,NaN
14,0.990,Pig/Swine,16-23,5,6,0,11,45.455,45.455
14,0.990,Pig/Swine,23-5,9,8,0,17,52.941,52.941
14,0.990,Klebsiella,16-23,0,0,0,0,NaN,NaN
14,0.990,Klebsiella,23-5,0,0,0,0,NaN,NaN
14,0.990,Hu Cw and Dg,16-23,5,10,0,15,33.333,33.333
14,0.990,Hu Cw and Dg,23-5,5,6,0,11,45.455,45.455
14,0.990,Ground Squirrel,16-23,80,46,0,126,63.492,63.492
14,0.990,Ground Squirrel,23-5,83,66,0,149,55.705,55.705
14,0.990,Opossum,16-23,1,0,0,1,100.000,100.000
14,0.990,Opossum,23-5,2,0,0,2,100.000,100.000
14,0.990,Cow,16-23,1521,1066,0,2587,58.794,58.794
14,0.990,Cow,23-5,1487,1361,0,2848,52.212,52.212
14,0.990,Deer Mouse,16-23,0,0,0,0,NaN,NaN
14,0.990,Deer Mouse,23-5,0,0,0,0,NaN,NaN
14,0.990,OVERALL,16-23,3739,2386,0,6125,61.045,61.045
14,0.990,OVERALL,23-5,4403,2923,0,7326,60.101,60.101
14,1.000,Chicken,16-23,0,0,0,0,NaN,NaN
14,1.000,Chicken,23-5,0,0,0,0,NaN,NaN
14,1.000,Sea Lion,16-23,0,0,0,0,NaN,NaN
14,1.000,Sea Lion,23-5,0,0,0,0,NaN,NaN
14,1.000,Hu and Cw,16-23,0,0,0,0,NaN,NaN
14,1.000,Hu and Cw,23-5,0,0,0,0,NaN,NaN
14,1.000,Sheep,16-23,0,0,0,0,NaN,NaN
14,1.000,Sheep,23-5,0,0,0,0,NaN,NaN
14,1.000,Hu and Dg,16-23,0,0,0,0,NaN,NaN
14,1.000,Hu and Dg,23-5,0,0,0,0,NaN,NaN
14,1.000,Common Loon,16-23,0,0,0,0,NaN,NaN
14,1.000,Common Loon,23-5,0,0,0,0,NaN,NaN
14,1.000,Red-Winged Blackbird,16-23,0,0,0,0,NaN,NaN
14,1.000,Red-Winged Blackbird,23-5,0,0,0,0,NaN,NaN
14,1.000,Cw,16-23,0,0,0,0,NaN,NaN
14,1.000,Cw,23-5,0,0,0,0,NaN,NaN
14,1.000,Cliff Sparrow,16-23,0,0,0,0,NaN,NaN
14,1.000,Cliff Sparrow,23-5,0,0,0,0,NaN,NaN
14,1.000,Pig,16-23,0,0,0,0,NaN,NaN
14,1.000,Pig,23-5,0,0,0,0,NaN,NaN
14,1.000,Barn Owl,16-23,0,0,0,0,NaN,NaN
14,1.000,Barn Owl,23-5,0,0,0,0,NaN,NaN
14,1.000,Wild Pig,16-23,0,0,0,0,NaN,NaN
14,1.000,Wild Pig,23-5,0,0,0,0,NaN,NaN
14,1.000,Pennington Creek Water,16-23,0,0,0,0,NaN,NaN
14,1.000,Pennington Creek Water,23-5,0,0,0,0,NaN,NaN
14,1.000,Guinni,16-23,0,0,0,0,NaN,NaN
14,1.000,Guinni,23-5,0,0,0,0,NaN,NaN
14,1.000,Racoon,16-23,0,0,0,0,NaN,NaN
14,1.000,Racoon,23-5,0,0,0,0,NaN,NaN
14,1.000,Hu,16-23,0,0,0,0,NaN,NaN
14,1.000,Hu,23-5,0,0,0,0,NaN,NaN
14,1.000,Cw and Dg,16-23,0,0,0,0,NaN,NaN
14,1.000,Cw and Dg,23-5,0,0,0,0,NaN,NaN
14,1.000,Red Wind Blackbird,16-23,0,0,0,0,NaN,NaN
14,1.000,Red Wind Blackbird,23-5,0,0,0,0,NaN,NaN
14,1.000,Tree Swallow,16-23,0,0,0,0,NaN,NaN
14,1.000,Tree Swallow,23-5,0,0,0,0,NaN,NaN
14,1.000,Turkey Vulture,16-23,0,0,0,0,NaN,NaN
14,1.000,Turkey Vulture,23-5,0,0,0,0,NaN,NaN
14,1.000,Dg,16-23,0,0,0,0,NaN,NaN
14,1.000,Dg,23-5,0,0,0,0,NaN,NaN
14,1.000,Western Kingbird,16-23,0,0,0,0,NaN,NaN
14,1.000,Western Kingbird,23-5,0,0,0,0,NaN,NaN
14,1.000,White Crowned Sparrow,16-23,0,0,0,0,NaN,NaN
14,1.000,White Crowned Sparrow,23-5,0,0,0,0,NaN,NaN
14,1.000,Eared Grebe,16-23,0,0,0,0,NaN,NaN
14,1.000,Eared Grebe,23-5,0,0,0,0,NaN,NaN
14,1.000,cougar,16-23,0,0,0,0,NaN,NaN
14,1.000,cougar,23-5,0,0,0,0,NaN,NaN
14,1.000,Ocean Water,16-23,0,0,0,0,NaN,NaN
14,1.000,Ocean Water,23-5,0,0,0,0,NaN,NaN
14,1.000,Red Tailed Hawk,16-23,0,0,0,0,NaN,NaN
14,1.000,Red Tailed Hawk,23-5,0,0,0,0,NaN,NaN
14,1.000,Dog,16-23,0,0,0,0,NaN,NaN
14,1.000,Dog,23-5,0,0,0,0,NaN,NaN
14,1.000,Human,16-23,68,0,0,68,100.000,100.000
14,1.000,Human,23-5,90,0,0,90,100.000,100.000
14,1.000,Wild Turkey,16-23,0,0,0,0,NaN,NaN
14,1.000,Wild Turkey,23-5,0,0,0,0,NaN,NaN
14,1.000,Clark Grebe,16-23,0,0,0,0,NaN,NaN
14,1.000,Clark Grebe,23-5,0,0,0,0,NaN,NaN
14,1.000,Seagull,16-23,0,0,0,0,NaN,NaN
14,1.000,Seagull,23-5,0,0,0,0,NaN,NaN
14,1.000,Surf Scoter,16-23,0,0,0,0,NaN,NaN
14,1.000,Surf Scoter,23-5,0,0,0,0,NaN,NaN
14,1.000,Pigeon,16-23,0,0,0,0,NaN,NaN
14,1.000,Pigeon,23-5,0,0,0,0,NaN,NaN
14,1.000,Pacific Ocean Water,16-23,0,0,0,0,NaN,NaN
14,1.000,Pacific Ocean Water,23-5,0,0,0,0,NaN,NaN
14,1.000,Cat,16-23,0,0,0,0,NaN,NaN
14,1.000,Cat,23-5,0,0,0,0,NaN,NaN
14,1.000,Horse,16-23,0,0,0,0,NaN,NaN
14,1.000,Horse,23-5,0,0,0,0,NaN,NaN
14,1.000,orangutan,16-23,0,0,0,0,NaN,NaN
14,1.000,orangutan,23-5,0,0,0,0,NaN,NaN
14,1.000,Bat,16-23,0,0,0,0,NaN,NaN
14,1.000,Bat,23-5,0,0,0,0,NaN,NaN
14,1.000,Deer,16-23,0,0,0,0,NaN,NaN
14,1.000,Deer,23-5,0,0,0,0,NaN,NaN
14,1.000,Great Horned Owl,16-23,0,0,0,0,NaN,NaN
14,1.000,Great Horned Owl,23-5,0,0,0,0,NaN,NaN
14,1.000,Freshwater Lagoon,16-23,0,0,0,0,NaN,NaN
14,1.000,Freshwater Lagoon,23-5,0,0,0,0,NaN,NaN
14,1.000,Unknown Avian,16-23,0,0,0,0,NaN,NaN
14,1.000,Unknown Avian,23-5,0,0,0,0,NaN,NaN
14,1.000,Human UTI,16-23,0,0,0,0,NaN,NaN
14,1.000,Human UTI,23-5,0,0,0,0,NaN,NaN
14,1.000,unknown,16-23,0,0,0,0,NaN,NaN
14,1.000,unknown,23-5,0,0,0,0,NaN,NaN
14,1.000,SLO Creek Water,16-23,0,0,0,0,NaN,NaN
14,1.000,SLO Creek Water,23-5,0,0,0,0,NaN,NaN
14,1.000,Pig/Swine,16-23,0,0,0,0,NaN,NaN
14,1.000,Pig/Swine,23-5,0,0,0,0,NaN,NaN
14,1.000,Klebsiella,16-23,0,0,0,0,NaN,NaN
14,1.000,Klebsiella,23-5,0,0,0,0,NaN,NaN
14,1.000,Hu Cw and Dg,16-23,0,0,0,0,NaN,NaN
14,1.000,Hu Cw and Dg,23-5,0,0,0,0,NaN,NaN
14,1.000,Ground Squirrel,16-23,0,0,0,0,NaN,NaN
14,1.000,Ground Squirrel,23-5,0,0,0,0,NaN,NaN
14,1.000,Opossum,16-23,0,0,0,0,NaN,NaN
14,1.000,Opossum,23-5,0,0,0,0,NaN,NaN
14,1.000,Cow,16-23,0,0,0,0,NaN,NaN
14,1.000,Cow,23-5,0,0,0,0,NaN,NaN
14,1.000,Deer Mouse,16-23,0,0,0,0,NaN,NaN
14,1.000,Deer Mouse,23-5,0,0,0,0,NaN,NaN
14,1.000,OVERALL,16-23,68,0,0,68,100.000,100.000
14,1.000,OVERALL,23-5,90,0,0,90,100.000,100.000
15,0.000,Chicken,16-23,0,0,0,0,NaN,NaN
15,0.000,Chicken,23-5,5,2,0,7,71.429,71.429
15,0.000,Sea Lion,16-23,0,0,0,0,NaN,NaN
15,0.000,Sea Lion,23-5,0,8,0,8,0.000,0.000
15,0.000,Hu and Cw,16-23,1,3,0,4,25.000,25.000
15,0.000,Hu and Cw,23-5,9,7,0,16,56.250,56.250
15,0.000,Sheep,16-23,44,53,0,97,45.361,45.361
15,0.000,Sheep,23-5,52,39,0,91,57.143,57.143
15,0.000,Hu and Dg,16-23,7,7,0,14,50.000,50.000
15,0.000,Hu and Dg,23-5,20,24,0,44,45.455,45.455
15,0.000,Common Loon,16-23,0,0,0,0,NaN,NaN
15,0.000,Common Loon,23-5,0,0,0,0,NaN,NaN
15,0.000,Red-Winged Blackbird,16-23,0,0,0,0,NaN,NaN
15,0.000,Red-Winged Blackbird,23-5,0,0,0,0,NaN,NaN
15,0.000,Cw,16-23,5,7,0,12,41.667,41.667
15,0.000,Cw,23-5,6,16,0,22,27.273,27.273
15,0.000,Cliff Sparrow,16-23,0,6,0,6,0.000,0.000
15,0.000,Cliff Sparrow,23-5,0,0,0,0,NaN,NaN
15,0.000,Pig,16-23,5,3,0,8,62.500,62.500
15,0.000,Pig,23-5,0,0,0,0,NaN,NaN
15,0.000,Barn Owl,16-23,0,0,0,0,NaN,NaN
15,0.000,Barn Owl,23-5,0,0,0,0,NaN,NaN
15,0.000,Wild Pig,16-23,0,0,0,0,NaN,NaN
15,0.000,Wild Pig,23-5,0,0,0,0,NaN,NaN
15,0.000,Pennington Creek Water,16-23,0,0,0,0,NaN,NaN
15,0.000,Pennington Creek Water,23-5,0,0,0,0,NaN,NaN
15,0.000,Guinni,16-23,0,0,0,0,NaN,NaN
15,0.000,Guinni,23-5,0,0,0,0,NaN,NaN
15,0.000,Racoon,16-23,0,0,0,0,NaN,NaN
15,0.000,Racoon,23-5,0,0,0,0,NaN,NaN
15,0.000,Hu,16-23,10,7,0,17,58.824,58.824
15,0.000,Hu,23-5,22,19,0,41,53.659,53.659
15,0.000,Cw and Dg,16-23,6,14,0,20,30.000,30.000
15,0.000,Cw and Dg,23-5,13,18,0,31,41.935,41.935
15,0.000,Red Wind Blackbird,16-23,0,0,0,0,NaN,NaN
15,0.000,Red Wind Blackbird,23-5,0,0,0,0,NaN,NaN
15,0.000,Tree Swallow,16-23,0,0,0,0,NaN,NaN
15,0.000,Tree Swallow,23-5,0,0,0,0,NaN,NaN
15,0.000,Turkey Vulture,16-23,0,0,0,0,NaN,NaN
15,0.000,Turkey Vulture,23-5,0,0,0,0,NaN,NaN
15,0.000,Dg,16-23,6,11,0,17,35.294,35.294
15,0.000,Dg,23-5,31,35,0,66,46.970,46.970
15,0.000,Western Kingbird,16-23,0,0,0,0,NaN,NaN
15,0.000,Western Kingbird,23-5,0,0,0,0,NaN,NaN
15,0.000,White Crowned Sparrow,16-23,0,0,0,0,NaN,NaN
15,0.000,White Crowned Sparrow,23-5,0,1,0,1,0.000,0.000
15,0.000,Eared Grebe,16-23,0,0,0,0,NaN,NaN
15,0.000,Eared Grebe,23-5,0,5,0,5,0.000,0.000
15,0.000,cougar,16-23,0,0,0,0,NaN,NaN
15,0.000,cougar,23-5,0,0,0,0,NaN,NaN
15,0.000,Ocean Water,16-23,0,0,0,0,NaN,NaN
15,0.000,Ocean Water,23-5,0,0,0,0,NaN,NaN
15,0.000,Red Tailed Hawk,16-23,0,0,0,0,NaN,NaN
15,0.000,Red Tailed Hawk,23-5,0,0,0,0,NaN,NaN
15,0.000,Dog,16-23,52,70,0,122,42.623,42.623
15,0.000,Dog,23-5,87,144,0,231,37.662,37.662
15,0.000,Human,16-23,1760,857,0,2617,67.253,67.253
15,0.000,Human,23-5,2173,739,0,2912,74.622,74.622
15,0.000,Wild Turkey,16-23,0,1,0,1,0.000,0.000
15,0.000,Wild Turkey,23-5,1,5,0,6,16.667,16.667
15,0.000,Clark Grebe,16-23,0,0,0,0,NaN,NaN
15,0.000,Clark Grebe,23-5,0,0,0,0,NaN,NaN
15,0.000,Seagull,16-23,0,0,0,0,NaN,NaN
15,0.000,Seagull,23-5,44,7,0,51,86.275,86.275
15,0.000,Surf Scoter,16-23,0,0,0,0,NaN,NaN
15,0.000,Surf Scoter,23-5,0,0,0,0,NaN,NaN
15,0.000,Pigeon,16-23,55,121,0,176,31.250,31.250
15,0.000,Pigeon,23-5,112,116,0,228,49.123,49.123
15,0.000,Pacific Ocean Water,16-23,0,0,0,0,NaN,NaN
15,0.000,Pacific Ocean Water,23-5,0,0,0,0,NaN,NaN
15,0.000,Cat,16-23,16,21,0,37,43.243,43.243
15,0.000,Cat,23-5,10,14,0,24,41.667,41.667
15,0.000,Horse,16-23,6,10,0,16,37.500,37.500
15,0.000,Horse,23-5,17,49,0,66,25.758,25.758
15,0.000,orangutan,16-23,0,0,0,0,NaN,NaN
15,0.000,orangutan,23-5,0,0,0,0,NaN,NaN
15,0.000,Bat,16-23,36,38,0,74,48.649,48.649
15,0.000,Bat,23-5,37,38,0,75,49.333,49.333
15,0.000,Deer,16-23,11,25,0,36,30.556,30.556
15,0.000,Deer,23-5,14,127,0,141,9.929,9.929
15,0.000,Great Horned Owl,16-23,0,0,0,0,NaN,NaN
15,0.000,Great Horned Owl,23-5,0,0,0,0,NaN,NaN
15,0.000,Freshwater Lagoon,16-23,0,0,0,0,NaN,NaN
15,0.000,Freshwater Lagoon,23-5,0,0,0,0,NaN,NaN
15,0.000,Unknown Avian,16-23,0,0,0,0,NaN,NaN
15,0.000,Unknown Avian,23-5,0,0,0,0,NaN,NaN
15,0.000,Human UTI,16-23,73,70,0,143,51.049,51.049
15,0.000,Human UTI,23-5,92,121,0,213,43.192,43.192
15,0.000,unknown,16-23,0,0,0,0,NaN,NaN
15,0.000,unknown,23-5,0,2,0,2,0.000,0.000
15,0.000,SLO Creek Water,16-23,0,0,0,0,NaN,NaN
15,0.000,SLO Creek Water,23-5,0,0,0,0,NaN,NaN
15,0.000,Pig/Swine,16-23,2,3,0,5,40.000,40.000
15,0.000,Pig/Swine,23-5,8,7,0,15,53.333,53.333
15,0.000,Klebsiella,16-23,0,0,0,0,NaN,NaN
15,0.000,Klebsiella,23-5,0,0,0,0,NaN,NaN
15,0.000,Hu Cw and Dg,16-23,3,7,0,10,30.000,30.000
15,0.000,Hu Cw and Dg,23-5,5,6,0,11,45.455,45.455
15,0.000,Ground Squirrel,16-23,74,42,0,116,63.793,63.793
15,0.000,Ground Squirrel,23-5,80,63,0,143,55.944,55.944
15,0.000,Opossum,16-23,0,0,0,0,NaN,NaN
15,0.000,Opossum,23-5,0,0,0,0,NaN,NaN
15,0.000,Cow,16-23,1571,1229,0,2800,56.107,56.107
15,0.000,Cow,23-5,1538,1622,0,3160,48.671,48.671
15,0.000,Deer Mouse,16-23,0,0,0,0,NaN,NaN
15,0.000,Deer Mouse,23-5,0,0,0,0,NaN,NaN
15,0.000,OVERALL,16-23,3743,2605,0,6348,58.963,58.963
15,0.000,OVERALL,23-5,4376,3234,0,7610,57.503,57.503
15,0.500,Chicken,16-23,0,0,0,0,NaN,NaN
15,0.500,Chicken,23-5,5,2,0,7,71.429,71.429
15,0.500,Sea Lion,16-23,0,0,0,0,NaN,NaN
15,0.500,Sea Lion,23-5,0,8,0,8,0.000,0.000
15,0.500,Hu and Cw,16-23,1,3,0,4,25.000,25.000
15,0.500,Hu and Cw,23-5,9,7,0,16,56.250,56.250
15,0.500,Sheep,16-23,44,53,0,97,45.361,45.361
15,0.500,Sheep,23-5,52,39,0,91,57.143,57.143
15,0.500,Hu and Dg,16-23,7,7,0,14,50.000,50.000
15,0.500,Hu and Dg,23-5,20,24,0,44,45.455,45.455
15,0.500,Common Loon,16-23,0,0,0,0,NaN,NaN
15,0.500,Common Loon,23-5,0,0,0,0,NaN,NaN
15,0.500,Red-Winged Blackbird,16-23,0,0,0,0,NaN,NaN
15,0.500,Red-Winged Blackbird,23-5,0,0,0,0,NaN,NaN
15,0.500,Cw,16-23,5,7,0,12,41.667,41.667
15,0.500,Cw,23-5,6,16,0,22,27.273,27.273
15,0.500,Cliff Sparrow,16-23,0,6,0,6,0.000,0.000
15,0.500,Cliff Sparrow,23-5,0,0,0,0,NaN,NaN
15,0.500,Pig,16-23,5,3,0,8,62.500,62.500
15,0.500,Pig,23-5,0,0,0,0,NaN,NaN
15,0.500,Barn Owl,16-23,0,0,0,0,NaN,NaN
15,0.500,Barn Owl,23-5,0,0,0,0,NaN,NaN
15,0.500,Wild Pig,16-23,0,0,0,0,NaN,NaN
15,0.500,Wild Pig,23-5,0,0,0,0,NaN,NaN
15,0.500,Pennington Creek Water,16-23,0,0,0,0,NaN,NaN
15,0.500,Pennington Creek Water,23-5,0,0,0,0,NaN,NaN
15,0.500,Guinni,16-23,0,0,0,0,NaN,NaN
15,0.500,Guinni,23-5,0,0,0,0,NaN,NaN
15,0.500,Racoon,16-23,0,0,0,0,NaN,NaN
15,0.500,Racoon,23-5,0,0,0,0,NaN,NaN
15,0.500,Hu,16-23,10,7,0,17,58.824,58.824
15,0.500,Hu,23-5,22,19,0,41,53.659,53.659
15,0.500,Cw and Dg,16-23,6,14,0,20,30.000,30.000
15,0.500,Cw and Dg,23-5,13,18,0,31,41.935,41.935
15,0.500,Red Wind Blackbird,16-23,0,0,0,0,NaN,NaN
15,0.500,Red Wind Blackbird,23-5,0,0,0,0,NaN,NaN
15,0.500,Tree Swallow,16-23,0,0,0,0,NaN,NaN
15,0.500,Tree Swallow,23-5,0,0,0,0,NaN,NaN
15,0.500,Turkey Vulture,16-23,0,0,0,0,NaN,NaN
15,0.500,Turkey Vulture,23-5,0,0,0,0,NaN,NaN
15,0.500,Dg,16-23,6,11,0,17,35.294,35.294
15,0.500,Dg,23-5,31,35,0,66,46.970,46.970
15,0.500,Western Kingbird,16-23,0,0,0,0,NaN,NaN
15,0.500,Western Kingbird,23-5,0,0,0,0,NaN,NaN
15,0.500,White Crowned Sparrow,16-23,0,0,0,0,NaN,NaN
15,0.500,White Crowned Sparrow,23-5,0,1,0,1,0.000,0.000
15,0.500,Eared Grebe,16-23,0,0,0,0,NaN,NaN
15,0.500,Eared Grebe,23-5,0,5,0,5,0.000,0.000
15,0.500,cougar,16-23,0,0,0,0,NaN,NaN
15,0.500,cougar,23-5,0,0,0,0,NaN,NaN
15,0.500,Ocean Water,16-23,0,0,0,0,NaN,NaN
15,0.500,Ocean Water,23-5,0,0,0,0,NaN,NaN
15,0.500,Red Tailed Hawk,16-23,0,0,0,0,NaN,NaN
15,0.500,Red Tailed Hawk,23-5,0,0,0,0,NaN,NaN
15,0.500,Dog,16-23,52,70,0,122,42.623,42.623
15,0.500,Dog,23-5,87,144,0,231,37.662,37.662
15,0.500,Human,16-23,1760,857,0,2617,67.253,67.253
15,0.500,Human,23-5,2173,739,0,2912,74.622,74.622
15,0.500,Wild Turkey,16-23,0,1,0,1,0.000,0.000
15,0.500,Wild Turkey,23-5,1,5,0,6,16.667,16.667
15,0.500,Clark Grebe,16-23,0,0,0,0,NaN,NaN
15,0.500,Clark Grebe,23-5,0,0,0,0,NaN,NaN
15,0.500,Seagull,16-23,0,0,0,0,NaN,NaN
15,0.500,Seagull,23-5,44,7,0,51,86.275,86.275
15,0.500,Surf Scoter,16-23,0,0,0,0,NaN,NaN
15,0.500,Surf Scoter,23-5,0,0,0,0,NaN,NaN
15,0.500,Pigeon,16-23,55,121,0,176,31.250,31.250
15,0.500,Pigeon,23-5,112,116,0,228,49.123,49.123
15,0.500,Pacific Ocean Water,16-23,0,0,0,0,NaN,NaN
15,0.500,Pacific Ocean Water,23-5,0,0,0,0,NaN,NaN
15,0.500,Cat,16-23,16,21,0,37,43.243,43.243
15,0.500,Cat,23-5,10,14,0,24,41.667,41.667
15,0.500,Horse,16-23,6,10,0,16,37.500,37.500
15,0.500,Horse,23-5,17,49,0,66,25.758,25.758
15,0.500,orangutan,16-23,0,0,0,0,NaN,NaN
15,0.500,orangutan,23-5,0,0,0,0,NaN,NaN
15,0.500,Bat,16-23,36,38,0,74,48.649,48.649
15,0.500,Bat,23-5,37,38,0,75,49.333,49.333
15,0.500,Deer,16-23,11,25,0,36,30.556,30.556
15,0.500,Deer,23-5,14,127,0,141,9.929,9.929
15,0.500,Great Horned Owl,16-23,0,0,0,0,NaN,NaN
15,0.500,Great Horned Owl,23-5,0,0,0,0,NaN,NaN
15,0.500,Freshwater Lagoon,16-23,0,0,0,0,NaN,NaN
15,0.500,Freshwater Lagoon,23-5,0,0,0,0,NaN,NaN
15,0.500,Unknown Avian,16-23,0,0,0,0,NaN,NaN
15,0.500,Unknown Avian,23-5,0,0,0,0,NaN,NaN
15,0.500,Human UTI,16-23,73,70,0,143,51.049,51.049
15,0.500,Human UTI,23-5,92,121,0,213,43.192,43.192
15,0.500,unknown,16-23,0,0,0,0,NaN,NaN
15,0.500,unknown,23-5,0,2,0,2,0.000,0.000
15,0.500,SLO Creek Water,16-23,0,0,0,0,NaN,NaN
15,0.500,SLO Creek Water,23-5,0,0,0,0,NaN,NaN
15,0.500,Pig/Swine,16-23,2,3,0,5,40.000,40.000
15,0.500,Pig/Swine,23-5,8,7,0,15,53.333,53.333
15,0.500,Klebsiella,16-23,0,0,0,0,NaN,NaN
15,0.500,Klebsiella,23-5,0,0,0,0,NaN,NaN
15,0.500,Hu Cw and Dg,16-23,3,7,0,10,30.000,30.000
15,0.500,Hu Cw and Dg,23-5,5,6,0,11,45.455,45.455
15,0.500,Ground Squirrel,16-23,74,42,0,116,63.793,63.793
15,0.500,Ground Squirrel,23-5,80,63,0,143,55.944,55.944
15,0.500,Opossum,16-23,0,0,0,0,NaN,NaN
15,0.500,Opossum,23-5,0,0,0,0,NaN,NaN
15,0.500,Cow,16-23,1571,1229,0,2800,56.107,56.107
15,0.500,Cow,23-5,1538,1622,0,3160,48.671,48.671
15,0.500,Deer Mouse,16-23,0,0,0,0,NaN,NaN
15,0.500,Deer Mouse,23-5,0,0,0,0,NaN,NaN
15,0.500,OVERALL,16-23,3743,2605,0,6348,58.963,58.963
15,0.500,OVERALL,23-5,4376,3234,0,7610,57.503,57.503
15,0.900,Chicken,16-23,0,0,0,0,NaN,NaN
15,0.900,Chicken,23-5,5,2,0,7,71.429,71.429
15,0.900,Sea Lion,16-23,0,0,0,0,NaN,NaN
15,0.900,Sea Lion,23-5,0,8,0,8,0.000,0.000
15,0.900,Hu and Cw,16-23,1,3,0,4,25.000,25.000
15,0.900,Hu and Cw,23-5,9,7,0,16,56.250,56.250
15,0.900,Sheep,16-23,44,53,0,97,45.361,45.361
15,0.900,Sheep,23-5,52,39,0,91,57.143,57.143
15,0.900,Hu and Dg,16-23,7,7,0,14,50.000,50.000
15,0.900,Hu and Dg,23-5,20,24,0,44,45.455,45.455
15,0.900,Common Loon,16-23,0,0,0,0,NaN,NaN
15,0.900,Common Loon,23-5,0,0,0,0,NaN,NaN
15,0.900,Red-Winged Blackbird,16-23,0,0,0,0,NaN,NaN
15,0.900,Red-Winged Blackbird,23-5,0,0,0,0,NaN,NaN
15,0.900,Cw,16-23,5,7,0,12,41.667,41.667
15,0.900,Cw,23-5,6,16,0,22,27.273,27.273
15,0.900,Cliff Sparrow,16-23,0,6,0,6,0.000,0.000
15,0.900,Cliff Sparrow,23-5,0,0,0,0,NaN,NaN
15,0.900,Pig,16-23,5,3,0,8,62.500,62.500
15,0.900,Pig,23-5,0,0,0,0,NaN,NaN
15,0.900,Barn Owl,16-23,0,0,0,0,NaN,NaN
15,0.900,Barn Owl,23-5,0,0,0,0,NaN,NaN
15,0.900,Wild Pig,16-23,0,0,0,0,NaN,NaN
15,0.900,Wild Pig,23-5,0,0,0,0,NaN,NaN
15,0.900,Pennington Creek Water,16-23,0,0,0,0,NaN,NaN
15,0.900,Pennington Creek Water,23-5,0,0,0,0,NaN,NaN
15,0.900,Guinni,16-23,0,0,0,0,NaN,NaN
15,0.900,Guinni,23-5,0,0,0,0,NaN,NaN
15,0.900,Racoon,16-23,0,0,0,0,NaN,NaN
15,0.900,Racoon,23-5,0,0,0,0,NaN,NaN
15,0.900,Hu,16-23,10,7,0,17,58.824,58.824
15,0.900,Hu,23-5,22,19,0,41,53.659,53.659
15,0.900,Cw and Dg,16-23,6,14,0,20,30.000,30.000
15,0.900,Cw and Dg,23-5,13,18,0,31,41.935,41.935
15,0.900,Red Wind Blackbird,16-23,0,0,0,0,NaN,NaN
15,0.900,Red Wind Blackbird,23-5,0,0,0,0,NaN,NaN
15,0.900,Tree Swallow,16-23,0,0,0,0,NaN,NaN
15,0.900,Tree Swallow,23-5,0,0,0,0,NaN,NaN
15,0.900,Turkey Vulture,16-23,0,0,0,0,NaN,NaN
15,0.900,Turkey Vulture,23-5,0,0,0,0,NaN,NaN
15,0.900,Dg,16-23,6,11,0,17,35.294,35.294
15,0.900,Dg,23-5,31,35,0,66,46.970,46.970
15,0.900,Western Kingbird,16-23,0,0,0,0,NaN,NaN
15,0.900,Western Kingbird,23-5,0,0,0,0,NaN,NaN
15,0.900,White Crowned Sparrow,16-23,0,0,0,0,NaN,NaN
15,0.900,White Crowned Sparrow,23-5,0,1,0,1,0.000,0.000
15,0.900,Eared Grebe,16-23,0,0,0,0,NaN,NaN
15,0.900,Eared Grebe,23-5,0,5,0,5,0.000,0.000
15,0.900,cougar,16-23,0,0,0,0,NaN,NaN
15,0.900,cougar,23-5,0,0,0,0,NaN,NaN
15,0.900,Ocean Water,16-23,0,0,0,0,NaN,NaN
15,0.900,Ocean Water,23-5,0,0,0,0,NaN,NaN
15,0.900,Red Tailed Hawk,16-23,0,0,0,0,NaN,NaN
15,0.900,Red Tailed Hawk,23-5,0,0,0,0,NaN,NaN
15,0.900,Dog,16-23,52,70,0,122,42.623,42.623
15,0.900,Dog,23-5,87,140,0,227,38.326,38.326
15,0.900,Human,16-23,1760,853,0,2613,67.356,67.356
15,0.900,Human,23-5,2173,735,0,2908,74.725,74.725
15,0.900,Wild Turkey,16-23,0,1,0,1,0.000,0.000
15,0.900,Wild Turkey,23-5,1,5,0,6,16.667,16.667
15,0.900,Clark Grebe,16-23,0,0,0,0,NaN,NaN
15,0.900,Clark Grebe,23-5,0,0,0,0,NaN,NaN
15,0.900,Seagull,16-23,0,0,0,0,NaN,NaN
15,0.900,Seagull,23-5,44,8,0,52,84.615,84.615
15,0.900,Surf Scoter,16-23,0,0,0,0,NaN,NaN
15,0.900,Surf Scoter,23-5,0,0,0,0,NaN,NaN
15,0.900,Pigeon,16-23,55,122,0,177,31.073,31.073
15,0.900,Pigeon,23-5,112,116,0,228,49.123,49.123
15,0.900,Pacific Ocean Water,16-23,0,0,0,0,NaN,NaN
15,0.900,Pacific Ocean Water,23-5,0,0,0,0,NaN,NaN
15,0.900,Cat,16-23,16,21,0,37,43.243,43.243
15,0.900,Cat,23-5,10,14,0,24,41.667,41.667
15,0.900,Horse,16-23,6,10,0,16,37.500,37.500
15,0.900,Horse,23-5,17,49,0,66,25.758,25.758
15,0.900,orangutan,16-23,0,0,0,0,NaN,NaN
15,0.900,orangutan,23-5,0,0,0,0,NaN,NaN
15,0.900,Bat,16-23,36,38,0,74,48.649,48.649
15,0.900,Bat,23-5,37,38,0,75,49.333,49.333
15,0.900,Deer,16-23,11,25,0,36,30.556,30.556
15,0.900,Deer,23-5,14,127,0,141,9.929,9.929
15,0.900,Great Horned Owl,16-23,0,0,0,0,NaN,NaN
15,0.900,Great Horned Owl,23-5,0,0,0,0,NaN,NaN
15,0.900,Freshwater Lagoon,16-23,0,0,0,0,NaN,NaN
15,0.900,Freshwater Lagoon,23-5,0,0,0,0,NaN,NaN
15,0.900,Unknown Avian,16-23,0,0,0,0,NaN,NaN
15,0.900,Unknown Avian,23-5,0,0,0,0,NaN,NaN
15,0.900,Human UTI,16-23,73,70,0,143,51.049,51.049
15,0.900,Human UTI,23-5,95,121,0,216,43.981,43.981
15,0.900,unknown,16-23,0,0,0,0,NaN,NaN
15,0.900,unknown,23-5,0,2,0,2,0.000,0.000
15,0.900,SLO Creek Water,16-23,0,0,0,0,NaN,NaN
15,0.900,SLO Creek Water,23-5,0,0,0,0,NaN,NaN
15,0.900,Pig/Swine,16-23,2,3,0,5,40.000,40.000
15,0.900,Pig/Swine,23-5,8,7,0,15,53.333,53.333
15,0.900,Klebsiella,16-23,0,0,0,0,NaN,NaN
15,0.900,Klebsiella,23-5,0,0,0,0,NaN,NaN
15,0.900,Hu Cw and Dg,16-23,3,7,0,10,30.000,30.000
15,0.900,Hu Cw and Dg,23-5,5,6,0,11,45.455,45.455
15,0.900,Ground Squirrel,16-23,74,42,0,116,63.793,63.793
15,0.900,Ground Squirrel,23-5,80,63,0,143,55.944,55.944
15,0.900,Opossum,16-23,0,0,0,0,NaN,NaN
15,0.900,Opossum,23-5,0,0,0,0,NaN,NaN
15,0.900,Cow,16-23,1573,1226,0,2799,56.199,56.199
15,0.900,Cow,23-5,1538,1618,0,3156,48.733,48.733
15,0.900,Deer Mouse,16-23,0,0,0,0,NaN,NaN
15,0.900,Deer Mouse,23-5,0,0,0,0,NaN,NaN
15,0.900,OVERALL,16-23,3745,2599,0,6344,59.032,59.032
15,0.900,OVERALL,23-5,4379,3223,0,7602,57.603,57.603
15,0.950,Chicken,16-23,0,0,0,0,NaN,NaN
15,0.950,Chicken,23-5,5,2,0,7,71.429,71.429
15,0.950,Sea Lion,16-23,0,0,0,0,NaN,NaN
15,0.950,Sea Lion,23-5,0,8,0,8,0.000,0.000
15,0.950,Hu and Cw,16-23,1,3,0,4,25.000,25.000
15,0.950,Hu and Cw,23-5,9,7,0,16,56.250,56.250
15,0.950,Sheep,16-23,44,53,0,97,45.361,45.361
15,0.950,Sheep,23-5,52,39,0,91,57.143,57.143
15,0.950,Hu and Dg,16-23,7,7,0,14,50.000,50.000
15,0.950,Hu and Dg,23-5,20,24,0,44,45.455,45.455
15,0.950,Common Loon,16-23,0,0,0,0,NaN,NaN
15,0.950,Common Loon,23-5,0,0,0,0,NaN,NaN
15,0.950,Red-Winged Blackbird,16-23,0,0,0,0,NaN,NaN
15,0.950,Red-Winged Blackbird,23-5,0,0,0,0,NaN,NaN
15,0.950,Cw,16-23,5,7,0,12,41.667,41.667
15,0.950,Cw,23-5,6,16,0,22,27.273,27.273
15,0.950,Cliff Sparrow,16-23,0,6,0,6,0.000,0.000
15,0.950,Cliff Sparrow,23-5,0,0,0,0,NaN,NaN
15,0.950,Pig,16-23,5,3,0,8,62.500,62.500
15,0.950,Pig,23-5,0,0,0,0,NaN,NaN
15,0.950,Barn Owl,16-23,0,0,0,0,NaN,NaN
15,0.950,Barn Owl,23-5,0,0,0,0,NaN,NaN
15,0.950,Wild Pig,16-23,0,0,0,0,NaN,NaN
15,0.950,Wild Pig,23-5,0,0,0,0,NaN,NaN
15,0.950,Pennington Creek Water,16-23,0,0,0,0,NaN,NaN
15,0.950,Pennington Creek Water,23-5,0,0,0,0,NaN,NaN
15,0.950,Guinni,16-23,0,0,0,0,NaN,NaN
15,0.950,Guinni,23-5,0,0,0,0,NaN,NaN
15,0.950,Racoon,16-23,0,0,0,0,NaN,NaN
15,0.950,Racoon,23-5,0,0,0,0,NaN,NaN
15,0.950,Hu,16-23,10,7,0,17,58.824,58.824
15,0.950,Hu,23-5,22,19,0,41,53.659,53.659
15,0.950,Cw and Dg,16-23,6,14,0,20,30.000,30.000
15,0.950,Cw and Dg,23-5,13,18,0,31,41.935,41.935
15,0.950,Red Wind Blackbird,16-23,0,0,0,0,NaN,NaN
15,0.950,Red Wind Blackbird,23-5,0,0,0,0,NaN,NaN
15,0.950,Tree Swallow,16-23,0,0,0,0,NaN,NaN
15,0.950,Tree Swallow,23-5,0,0,0,0,NaN,NaN
15,0.950,Turkey Vulture,16-23,0,0,0,0,NaN,NaN
15,0.950,Turkey Vulture,23-5,0,0,0,0,NaN,NaN
15,0.950,Dg,16-23,6,11,0,17,35.294,35.294
15,0.950,Dg,23-5,31,35,0,66,46.970,46.970
15,0.950,Western Kingbird,16-23,0,0,0,0,NaN,NaN
15,0.950,Western Kingbird,23-5,0,0,0,0,NaN,NaN
15,0.950,White Crowned Sparrow,16-23,0,0,0,0,NaN,NaN
15,0.950,White Crowned Sparrow,23-5,0,1,0,1,0.000,0.000
15,0.950,Eared Grebe,16-23,0,0,0,0,NaN,NaN
15,0.950,Eared Grebe,23-5,0,5,0,5,0.000,0.000
15,0.950,cougar,16-23,0,0,0,0,NaN,NaN
15,0.950,cougar,23-5,0,0,0,0,NaN,NaN
15,0.950,Ocean Water,16-23,0,0,0,0,NaN,NaN
15,0.950,Ocean Water,23-5,0,0,0,0,NaN,NaN
15,0.950,Red Tailed Hawk,16-23,0,0,0,0,NaN,NaN
15,0.950,Red Tailed Hawk,23-5,0,0,0,0,NaN,NaN
15,0.950,Dog,16-23,52,70,0,122,42.623,42.623
15,0.950,Dog,23-5,87,138,0,225,38.667,38.667
15,0.950,Human,16-23,1760,850,0,2610,67.433,67.433
15,0.950,Human,23-5,2176,727,0,2903,74.957,74.957
15,0.950,Wild Turkey,16-23,0,1,0,1,0.000,0.000
15,0.950,Wild Turkey,23-5,1,4,0,5,20.000,20.000
15,0.950,Clark Grebe,16-23,0,0,0,0,NaN,NaN
15,0.950,Clark Grebe,23-5,0,0,0,0,NaN,NaN
15,0.950,Seagull,16-23,0,0,0,0,NaN,NaN
15,0.950,Seagull,23-5,44,7,0,51,86.275,86.275
15,0.950,Surf Scoter,16-23,0,0,0,0,NaN,NaN
15,0.950,Surf Scoter,23-5,0,0,0,0,NaN,NaN
15,0.950,Pigeon,16-23,56,121,0,177,31.638,31.638
15,0.950,Pigeon,23-5,112,117,0,229,48.908,48.908
15,0.950,Pacific Ocean Water,16-23,0,0,0,0,NaN,NaN
15,0.950,Pacific Ocean Water,23-5,0,0,0,0,NaN,NaN
15,0.950,Cat,16-23,16,21,0,37,43.243,43.243
15,0.950,Cat,23-5,10,15,0,25,40.000,40.000
15,0.950,Horse,16-23,6,10,0,16,37.500,37.500
15,0.950,Horse,23-5,17,49,0,66,25.758,25.758
15,0.950,orangutan,16-23,0,0,0,0,NaN,NaN
15,0.950,orangutan,23-5,0,0,0,0,NaN,NaN
15,0.950,Bat,16-23,36,38,0,74,48.649,48.649
15,0.950,Bat,23-5,37,37,0,74,50.000,50.000
15,0.950,Deer,16-23,11,25,0,36,30.556,30.556
15,0.950,Deer,23-5,14,127,0,141,9.929,9.929
15,0.950,Great Horned Owl,16-23,0,0,0,0,NaN,NaN
15,0.950,Great Horned Owl,23-5,0,0,0,0,NaN,NaN
15,0.950,Freshwater Lagoon,16-23,0,0,0,0,NaN,NaN
15,0.950,Freshwater Lagoon,23-5,0,0,0,0,NaN,NaN
15,0.950,Unknown Avian,16-23,0,0,0,0,NaN,NaN
15,0.950,Unknown Avian,23-5,0,0,0,0,NaN,NaN
15,0.950,Human UTI,16-23,76,71,0,147,51.701,51.701
15,0.950,Human UTI,23-5,94,124,0,218,43.119,43.119
15,0.950,unknown,16-23,0,0,0,0,NaN,NaN
15,0.950,unknown,23-5,0,2,0,2,0.000,0.000
15,0.950,SLO Creek Water,16-23,0,0,0,0,NaN,NaN
15,0.950,SLO Creek Water,23-5,0,0,0,0,NaN,NaN
15,0.950,Pig/Swine,16-23,2,3,0,5,40.000,40.000
15,0.950,Pig/Swine,23-5,8,7,0,15,53.333,53.333
15,0.950,Klebsiella,16-23,0,0,0,0,NaN,NaN
15,0.950,Klebsiella,23-5,0,0,0,0,NaN,NaN
15,0.950,Hu Cw and Dg,16-23,3,7,0,10,30.000,30.000
15,0.950,Hu Cw and Dg,23-5,5,6,0,11,45.455,45.455
15,0.950,Ground Squirrel,16-23,74,42,0,116,63.793,63.793
15,0.950,Ground Squirrel,23-5,80,62,0,142,56.338,56.338
15,0.950,Opossum,16-23,0,0,0,0,NaN,NaN
15,0.950,Opossum,23-5,0,0,0,0,NaN,NaN
15,0.950,Cow,16-23,1576,1205,0,2781,56.670,56.670
15,0.950,Cow,23-5,1537,1614,0,3151,48.778,48.778
15,0.950,Deer Mouse,16-23,0,0,0,0,NaN,NaN
15,0.950,Deer Mouse,23-5,0,0,0,0,NaN,NaN
15,0.950,OVERALL,16-23,3752,2575,0,6327,59.301,59.301
15,0.950,OVERALL,23-5,4380,3210,0,7590,57.708,57.708
15,0.960,Chicken,16-23,0,0,0,0,NaN,NaN
15,0.960,Chicken,23-5,5,2,0,7,71.429,71.429
15,0.960,Sea Lion,16-23,0,0,0,0,NaN,NaN
15,0.960,Sea Lion,23-5,0,8,0,8,0.000,0.000
15,0.960,Hu and Cw,16-23,1,3,0,4,25.000,25.000
15,0.960,Hu and Cw,23-5,9,7,0,16,56.250,56.250
15,0.960,Sheep,16-23,44,53,0,97,45.361,45.361
15,0.960,Sheep,23-5,52,40,0,92,56.522,56.522
15,0.960,Hu and Dg,16-23,7,7,0,14,50.000,50.000
15,0.960,Hu and Dg,23-5,20,24,0,44,45.455,45.455
15,0.960,Common Loon,16-23,0,0,0,0,NaN,NaN
15,0.960,Common Loon,23-5,0,0,0,0,NaN,NaN
15,0.960,Red-Winged Blackbird,16-23,0,0,0,0,NaN,NaN
15,0.960,Red-Winged Blackbird,23-5,0,0,0,0,NaN,NaN
15,0.960,Cw,16-23,5,7,0,12,41.667,41.667
15,0.960,Cw,23-5,6,16,0,22,27.273,27.273
15,0.960,Cliff Sparrow,16-23,0,6,0,6,0.000,0.000
15,0.960,Cliff Sparrow,23-5,0,0,0,0,NaN,NaN
15,0.960,Pig,16-23,5,3,0,8,62.500,62.500
15,0.960,Pig,23-5,0,0,0,0,NaN,NaN
15,0.960,Barn Owl,16-23,0,0,0,0,NaN,NaN
15,0.960,Barn Owl,23-5,0,0,0,0,NaN,NaN
15,0.960,Wild Pig,16-23,0,0,0,0,NaN,NaN
15,0.960,Wild Pig,23-5,1,0,0,1,100.000,100.000
15,0.960,Pennington Creek Water,16-23,0,0,0,0,NaN,NaN
15,0.960,Pennington Creek Water,23-5,0,0,0,0,NaN,NaN
15,0.960,Guinni,16-23,0,0,0,0,NaN,NaN
15,0.960,Guinni,23-5,0,0,0,0,NaN,NaN
15,0.960,Racoon,16-23,0,0,0,0,NaN,NaN
15,0.960,Racoon,23-5,0,0,0,0,NaN,NaN
15,0.960,Hu,16-23,10,7,0,17,58.824,58.824
15,0.960,Hu,23-5,22,19,0,41,53.659,53.659
15,0.960,Cw and Dg,16-23,6,14,0,20,30.000,30.000
15,0.960,Cw and Dg,23-5,13,17,0,30,43.333,43.333
15,0.960,Red Wind Blackbird,16-23,0,0,0,0,NaN,NaN
15,0.960,Red Wind Blackbird,23-5,0,0,0,0,NaN,NaN
15,0.960,Tree Swallow,16-23,0,0,0,0,NaN,NaN
15,0.960,Tree Swallow,23-5,0,0,0,0,NaN,NaN
15,0.960,Turkey Vulture,16-23,0,0,0,0,NaN,NaN
15,0.960,Turkey Vulture,23-5,0,0,0,0,NaN,NaN
15,0.960,Dg,16-23,6,11,0,17,35.294,35.294
15,0.960,Dg,23-5,31,35,0,66,46.970,46.970
15,0.960,Western Kingbird,16-23,0,0,0,0,NaN,NaN
15,0.960,Western Kingbird,23-5,0,0,0,0,NaN,NaN
15,0.960,White Crowned Sparrow,16-23,0,0,0,0,NaN,NaN
15,0.960,White Crowned Sparrow,23-5,0,1,0,1,0.000,0.000
15,0.960,Eared Grebe,16-23,0,0,0,0,NaN,NaN
15,0.960,Eared Grebe,23-5,0,5,0,5,0.000,0.000
15,0.960,cougar,16-23,0,0,0,0,NaN,NaN
15,0.960,cougar,23-5,0,0,0,0,NaN,NaN
15,0.960,Ocean Water,16-23,0,0,0,0,NaN,NaN
15,0.960,Ocean Water,23-5,0,0,0,0,NaN,NaN
15,0.960,Red Tailed Hawk,16-23,0,0,0,0,NaN,NaN
15,0.960,Red Tailed Hawk,23-5,0,0,0,0,NaN,NaN
15,0.960,Dog,16-23,52,70,0,122,42.623,42.623
15,0.960,Dog,23-5,87,134,0,221,39.367,39.367
15,0.960,Human,16-23,1762,849,0,2611,67.484,67.484
15,0.960,Human,23-5,2178,712,0,2890,75.363,75.363
15,0.960,Wild Turkey,16-23,0,1,0,1,0.000,0.000
15,0.960,Wild Turkey,23-5,1,9,0,10,10.000,10.000
15,0.960,Clark Grebe,16-23,0,0,0,0,NaN,NaN
15,0.960,Clark Grebe,23-5,0,0,0,0,NaN,NaN
15,0.960,Seagull,16-23,0,0,0,0,NaN,NaN
15,0.960,Seagull,23-5,44,8,0,52,84.615,84.615
15,0.960,Surf Scoter,16-23,0,0,0,0,NaN,NaN
15,0.960,Surf Scoter,23-5,0,2,0,2,0.000,0.000
15,0.960,Pigeon,16-23,56,121,0,177,31.638,31.638
15,0.960,Pigeon,23-5,113,133,0,246,45.935,45.935
15,0.960,Pacific Ocean Water,16-23,0,0,0,0,NaN,NaN
15,0.960,Pacific Ocean Water,23-5,0,0,0,0,NaN,NaN
15,0.960,Cat,16-23,16,21,0,37,43.243,43.243
15,0.960,Cat,23-5,10,16,0,26,38.462,38.462
15,0.960,Horse,16-23,6,10,0,16,37.500,37.500
15,0.960,Horse,23-5,17,49,0,66,25.758,25.758
15,0.960,orangutan,16-23,0,0,0,0,NaN,NaN
15,0.960,orangutan,23-5,0,0,0,0,NaN,NaN
15,0.960,Bat,16-23,36,38,0,74,48.649,48.649
15,0.960,Bat,23-5,37,37,0,74,50.000,50.000
15,0.960,Deer,16-23,11,25,0,36,30.556,30.556
15,0.960,Deer,23-5,14,127,0,141,9.929,9.929
15,0.960,Great Horned Owl,16-23,0,0,0,0,NaN,NaN
15,0.960,Great Horned Owl,23-5,0,0,0,0,NaN,NaN
15,0.960,Freshwater Lagoon,16-23,0,0,0,0,NaN,NaN
15,0.960,Freshwater Lagoon,23-5,0,0,0,0,NaN,NaN
15,0.960,Unknown Avian,16-23,0,0,0,0,NaN,NaN
15,0.960,Unknown Avian,23-5,0,0,0,0,NaN,NaN
15,0.960,Human UTI,16-23,76,72,0,148,51.351,51.351
15,0.960,Human UTI,23-5,94,123,0,217,43.318,43.318
15,0.960,unknown,16-23,0,0,0,0,NaN,NaN
15,0.960,unknown,23-5,0,2,0,2,0.000,0.000
15,0.960,SLO Creek Water,16-23,0,0,0,0,NaN,NaN
15,0.960,SLO Creek Water,23-5,0,0,0,0,NaN,NaN
15,0.960,Pig/Swine,16-23,2,3,0,5,40.000,40.000
15,0.960,Pig/Swine,23-5,8,7,0,15,53.333,53.333
15,0.960,Klebsiella,16-23,0,0,0,0,NaN,NaN
15,0.960,Klebsiella,23-5,0,0,0,0,NaN,NaN
15,0.960,Hu Cw and Dg,16-23,3,7,0,10,30.000,30.000
15,0.960,Hu Cw and Dg,23-5,5,6,0,11,45.455,45.455
15,0.960,Ground Squirrel,16-23,74,42,0,116,63.793,63.793
15,0.960,Ground Squirrel,23-5,80,64,0,144,55.556,55.556
15,0.960,Opossum,16-23,0,0,0,0,NaN,NaN
15,0.960,Opossum,23-5,0,0,0,0,NaN,NaN
15,0.960,Cow,16-23,1574,1194,0,2768,56.864,56.864
15,0.960,Cow,23-5,1537,1593,0,3130,49.105,49.105
15,0.960,Deer Mouse,16-23,0,0,0,0,NaN,NaN
15,0.960,Deer Mouse,23-5,0,0,0,0,NaN,NaN
15,0.960,OVERALL,16-23,3752,2564,0,6316,59.405,59.405
15,0.960,OVERALL,23-5,4384,3196,0,7580,57.836,57.836
15,0.970,Chicken,16-23,0,0,0,0,NaN,NaN
15,0.970,Chicken,23-5,5,2,0,7,71.429,71.429
15,0.970,Sea Lion,16-23,0,0,0,0,NaN,NaN
15,0.970,Sea Lion,23-5,0,10,0,10,0.000,0.000
15,0.970,Hu and Cw,16-23,1,3,0,4,25.000,25.000
15,0.970,Hu and Cw,23-5,9,7,0,16,56.250,56.250
15,0.970,Sheep,16-23,45,54,0,99,45.455,45.455
15,0.970,Sheep,23-5,52,39,0,91,57.143,57.143
15,0.970,Hu and Dg,16-23,7,7,0,14,50.000,50.000
15,0.970,Hu and Dg,23-5,20,24,0,44,45.455,45.455
15,0.970,Common Loon,16-23,0,0,0,0,NaN,NaN
15,0.970,Common Loon,23-5,0,0,0,0,NaN,NaN
15,0.970,Red-Winged Blackbird,16-23,0,0,0,0,NaN,NaN
15,0.970,Red-Winged Blackbird,23-5,0,0,0,0,NaN,NaN
15,0.970,Cw,16-23,5,8,0,13,38.462,38.462
15,0.970,Cw,23-5,6,16,0,22,27.273,27.273
15,0.970,Cliff Sparrow,16-23,0,6,0,6,0.000,0.000
15,0.970,Cliff Sparrow,23-5,0,0,0,0,NaN,NaN
15,0.970,Pig,16-23,5,3,0,8,62.500,62.500
15,0.970,Pig,23-5,0,0,0,0,NaN,NaN
15,0.970,Barn Owl,16-23,0,0,0,0,NaN,NaN
15,0.970,Barn Owl,23-5,0,0,0,0,NaN,NaN
15,0.970,Wild Pig,16-23,0,0,0,0,NaN,NaN
15,0.970,Wild Pig,23-5,0,0,0,0,NaN,NaN
15,0.970,Pennington Creek Water,16-23,0,0,0,0,NaN,NaN
15,0.970,Pennington Creek Water,23-5,0,0,0,0,NaN,NaN
15,0.970,Guinni,16-23,0,0,0,0,NaN,NaN
15,0.970,Guinni,23-5,0,0,0,0,NaN,NaN
15,0.970,Racoon,16-23,0,0,0,0,NaN,NaN
15,0.970,Racoon,23-5,0,0,0,0,NaN,NaN
15,0.970,Hu,16-23,10,7,0,17,58.824,58.824
15,0.970,Hu,23-5,22,19,0,41,53.659,53.659
15,0.970,Cw and Dg,16-23,6,14,0,20,30.000,30.000
15,0.970,Cw and Dg,23-5,13,17,0,30,43.333,43.333
15,0.970,Red Wind Blackbird,16-23,0,0,0,0,NaN,NaN
15,0.970,Red Wind Blackbird,23-5,0,0,0,0,NaN,NaN
15,0.970,Tree Swallow,16-23,0,0,0,0,NaN,NaN
15,0.970,Tree Swallow,23-5,0,0,0,0,NaN,NaN
15,0.970,Turkey Vulture,16-23,0,0,0,0,NaN,NaN
15,0.970,Turkey Vulture,23-5,0,0,0,0,NaN,NaN
15,0.970,Dg,16-23,6,11,0,17,35.294,35.294
15,0.970,Dg,23-5,31,34,0,65,47.692,47.692
15,0.970,Western Kingbird,16-23,0,0,0,0,NaN,NaN
15,0.970,Western Kingbird,23-5,0,0,0,0,NaN,NaN
15,0.970,White Crowned Sparrow,16-23,0,0,0,0,NaN,NaN
15,0.970,White Crowned Sparrow,23-5,0,1,0,1,0.000,0.000
15,0.970,Eared Grebe,16-23,0,0,0,0,NaN,NaN
15,0.970,Eared Grebe,23-5,0,5,0,5,0.000,0.000
15,0.970,cougar,16-23,0,0,0,0,NaN,NaN
15,0.970,cougar,23-5,0,0,0,0,NaN,NaN
15,0.970,Ocean Water,16-23,0,0,0,0,NaN,NaN
15,0.970,Ocean Water,23-5,0,0,0,0,NaN,NaN
15,0.970,Red Tailed Hawk,16-23,0,0,0,0,NaN,NaN
15,0.970,Red Tailed Hawk,23-5,0,0,0,0,NaN,NaN
15,0.970,Dog,16-23,52,70,0,122,42.623,42.623
15,0.970,Dog,23-5,87,133,0,220,39.545,39.545
15,0.970,Human,16-23,1761,845,0,2606,67.575,67.575
15,0.970,Human,23-5,2177,709,0,2886,75.433,75.433
15,0.970,Wild Turkey,16-23,0,3,0,3,0.000,0.000
15,0.970,Wild Turkey,23-5,3,8,0,11,27.273,27.273
15,0.970,Clark Grebe,16-23,0,0,0,0,NaN,NaN
15,0.970,Clark Grebe,23-5,0,0,0,0,NaN,NaN
15,0.970,Seagull,16-23,0,0,0,0,NaN,NaN
15,0.970,Seagull,23-5,44,9,0,53,83.019,83.019
15,0.970,Surf Scoter,16-23,0,0,0,0,NaN,NaN
15,0.970,Surf Scoter,23-5,0,2,0,2,0.000,0.000
15,0.970,Pigeon,16-23,55,120,0,175,31.429,31.429
15,0.970,Pigeon,23-5,113,149,0,262,43.130,43.130
15,0.970,Pacific Ocean Water,16-23,0,0,0,0,NaN,NaN
15,0.970,Pacific Ocean Water,23-5,0,0,0,0,NaN,NaN
15,0.970,Cat,16-23,16,21,0,37,43.243,43.243
15,0.970,Cat,23-5,10,16,0,26,38.462,38.462
15,0.970,Horse,16-23,6,10,0,16,37.500,37.500
15,0.970,Horse,23-5,17,50,0,67,25.373,25.373
15,0.970,orangutan,16-23,0,0,0,0,NaN,NaN
15,0.970,orangutan,23-5,0,0,0,0,NaN,NaN
15,0.970,Bat,16-23,36,38,0,74,48.649,48.649
15,0.970,Bat,23-5,37,37,0,74,50.000,50.000
15,0.970,Deer,16-23,11,25,0,36,30.556,30.556
15,0.970,Deer,23-5,14,127,0,141,9.929,9.929
15,0.970,Great Horned Owl,16-23,0,0,0,0,NaN,NaN
15,0.970,Great Horned Owl,23-5,0,0,0,0,NaN,NaN
15,0.970,Freshwater Lagoon,16-23,0,0,0,0,NaN,NaN
15,0.970,Freshwater Lagoon,23-5,0,0,0,0,NaN,NaN
15,0.970,Unknown Avian,16-23,0,0,0,0,NaN,NaN
15,0.970,Unknown Avian,23-5,0,0,0,0,NaN,NaN
15,0.970,Human UTI,16-23,76,74,0,150,50.667,50.667
15,0.970,Human UTI,23-5,93,123,0,216,43.056,43.056
15,0.970,unknown,16-23,0,0,0,0,NaN,NaN
15,0.970,unknown,23-5,0,2,0,2,0.000,0.000
15,0.970,SLO Creek Water,16-23,0,0,0,0,NaN,NaN
15,0.970,SLO Creek Water,23-5,0,0,0,0,NaN,NaN
15,0.970,Pig/Swine,16-23,2,3,0,5,40.000,40.000
15,0.970,Pig/Swine,23-5,8,7,0,15,53.333,53.333
15,0.970,Klebsiella,16-23,0,0,0,0,NaN,NaN
15,0.970,Klebsiella,23-5,0,0,0,0,NaN,NaN
15,0.970,Hu Cw and Dg,16-23,3,7,0,10,30.000,30.000
15,0.970,Hu Cw and Dg,23-5,5,6,0,11,45.455,45.455
15,0.970,Ground Squirrel,16-23,74,41,0,115,64.348,64.348
15,0.970,Ground Squirrel,23-5,80,62,0,142,56.338,56.338
15,0.970,Opossum,16-23,0,0,0,0,NaN,NaN
15,0.970,Opossum,23-5,0,0,0,0,NaN,NaN
15,0.970,Cow,16-23,1568,1191,0,2759,56.832,56.832
15,0.970,Cow,23-5,1534,1567,0,3101,49.468,49.468
15,0.970,Deer Mouse,16-23,0,0,0,0,NaN,NaN
15,0.970,Deer Mouse,23-5,0,0,0,0,NaN,NaN
15,0.970,OVERALL,16-23,3745,2561,0,6306,59.388,59.388
15,0.970,OVERALL,23-5,4380,3181,0,7561,57.929,57.929
15,0.980,Chicken,16-23,0,0,0,0,NaN,NaN
15,0.980,Chicken,23-5,6,2,0,8,75.000,75.000
15,0.980,Sea Lion,16-23,0,0,0,0,NaN,NaN
15,0.980,Sea Lion,23-5,0,10,0,10,0.000,0.000
15,0.980,Hu and Cw,16-23,1,3,0,4,25.000,25.000
15,0.980,Hu and Cw,23-5,9,17,0,26,34.615,34.615
15,0.980,Sheep,16-23,48,51,0,99,48.485,48.485
15,0.980,Sheep,23-5,51,38,0,89,57.303,57.303
15,0.980,Hu and Dg,16-23,7,7,0,14,50.000,50.000
15,0.980,Hu and Dg,23-5,20,22,0,42,47.619,47.619
15,0.980,Common Loon,16-23,0,0,0,0,NaN,NaN
15,0.980,Common Loon,23-5,0,0,0,0,NaN,NaN
15,0.980,Red-Winged Blackbird,16-23,0,0,0,0,NaN,NaN
15,0.980,Red-Winged Blackbird,23-5,0,0,0,0,NaN,NaN
15,0.980,Cw,16-23,5,7,0,12,41.667,41.667
15,0.980,Cw,23-5,6,18,0,24,25.000,25.000
15,0.980,Cliff Sparrow,16-23,0,6,0,6,0.000,0.000
15,0.980,Cliff Sparrow,23-5,0,0,0,0,NaN,NaN
15,0.980,Pig,16-23,5,3,0,8,62.500,62.500
15,0.980,Pig,23-5,0,0,0,0,NaN,NaN
15,0.980,Barn Owl,16-23,0,0,0,0,NaN,NaN
15,0.980,Barn Owl,23-5,0,0,0,0,NaN,NaN
15,0.980,Wild Pig,16-23,0,0,0,0,NaN,NaN
15,0.980,Wild Pig,23-5,0,0,0,0,NaN,NaN
15,0.980,Pennington Creek Water,16-23,0,0,0,0,NaN,NaN
15,0.980,Pennington Creek Water,23-5,0,0,0,0,NaN,NaN
15,0.980,Guinni,16-23,0,0,0,0,NaN,NaN
15,0.980,Guinni,23-5,0,0,0,0,NaN,NaN
15,0.980,Racoon,16-23,0,0,0,0,NaN,NaN
15,0.980,Racoon,23-5,0,0,0,0,NaN,NaN
15,0.980,Hu,16-23,10,7,0,17,58.824,58.824
15,0.980,Hu,23-5,22,20,0,42,52.381,52.381
15,0.980,Cw and Dg,16-23,6,14,0,20,30.000,30.000
15,0.980,Cw and Dg,23-5,13,19,0,32,40.625,40.625
15,0.980,Red Wind Blackbird,16-23,0,0,0,0,NaN,NaN
15,0.980,Red Wind Blackbird,23-5,0,0,0,0,NaN,NaN
15,0.980,Tree Swallow,16-23,0,0,0,0,NaN,NaN
15,0.980,Tree Swallow,23-5,0,0,0,0,NaN,NaN
15,0.980,Turkey Vulture,16-23,0,0,0,0,NaN,NaN
15,0.980,Turkey Vulture,23-5,0,0,0,0,NaN,NaN
15,0.980,Dg,16-23,6,11,0,17,35.294,35.294
15,0.980,Dg,23-5,31,26,0,57,54.386,54.386
15,0.980,Western Kingbird,16-23,0,0,0,0,NaN,NaN
15,0.980,Western Kingbird,23-5,0,0,0,0,NaN,NaN
15,0.980,White Crowned Sparrow,16-23,0,0,0,0,NaN,NaN
15,0.980,White Crowned Sparrow,23-5,0,3,0,3,0.000,0.000
15,0.980,Eared Grebe,16-23,0,0,0,0,NaN,NaN
15,0.980,Eared Grebe,23-5,0,5,0,5,0.000,0.000
15,0.980,cougar,16-23,0,0,0,0,NaN,NaN
15,0.980,cougar,23-5,0,0,0,0,NaN,NaN
15,0.980,Ocean Water,16-23,0,0,0,0,NaN,NaN
15,0.980,Ocean Water,23-5,0,0,0,0,NaN,NaN
15,0.980,Red Tailed Hawk,16-23,0,0,0,0,NaN,NaN
15,0.980,Red Tailed Hawk,23-5,0,0,0,0,NaN,NaN
15,0.980,Dog,16-23,51,75,0,126,40.476,40.476
15,0.980,Dog,23-5,87,129,0,216,40.278,40.278
15,0.980,Human,16-23,1764,832,0,2596,67.951,67.951
15,0.980,Human,23-5,2179,693,0,2872,75.870,75.870
15,0.980,Wild Turkey,16-23,1,3,0,4,25.000,25.000
15,0.980,Wild Turkey,23-5,5,18,0,23,21.739,21.739
15,0.980,Clark Grebe,16-23,0,0,0,0,NaN,NaN
15,0.980,Clark Grebe,23-5,0,0,0,0,NaN,NaN
15,0.980,Seagull,16-23,0,0,0,0,NaN,NaN
15,0.980,Seagull,23-5,46,7,0,53,86.792,86.792
15,0.980,Surf Scoter,16-23,0,0,0,0,NaN,NaN
15,0.980,Surf Scoter,23-5,2,0,0,2,100.000,100.000
15,0.980,Pigeon,16-23,55,119,0,174,31.609,31.609
15,0.980,Pigeon,23-5,112,159,0,271,41.328,41.328
15,0.980,Pacific Ocean Water,16-23,0,0,0,0,NaN,NaN
15,0.980,Pacific Ocean Water,23-5,0,0,0,0,NaN,NaN
15,0.980,Cat,16-23,16,21,0,37,43.243,43.243
15,0.980,Cat,23-5,12,14,0,26,46.154,46.154
15,0.980,Horse,16-23,6,10,0,16,37.500,37.500
15,0.980,Horse,23-5,17,48,0,65,26.154,26.154
15,0.980,orangutan,16-23,0,0,0,0,NaN,NaN
15,0.980,orangutan,23-5,0,0,0,0,NaN,NaN
15,0.980,Bat,16-23,36,37,0,73,49.315,49.315
15,0.980,Bat,23-5,37,37,0,74,50.000,50.000
15,0.980,Deer,16-23,11,25,0,36,30.556,30.556
15,0.980,Deer,23-5,14,127,0,141,9.929,9.929
15,0.980,Great Horned Owl,16-23,0,0,0,0,NaN,NaN
15,0.980,Great Horned Owl,23-5,0,0,0,0,NaN,NaN
15,0.980,Freshwater Lagoon,16-23,0,0,0,0,NaN,NaN
15,0.980,Freshwater Lagoon,23-5,0,0,0,0,NaN,NaN
15,0.980,Unknown Avian,16-23,0,0,0,0,NaN,NaN
15,0.980,Unknown Avian,23-5,0,0,0,0,NaN,NaN
15,0.980,Human UTI,16-23,76,76,0,152,50.000,50.000
15,0.980,Human UTI,23-5,94,121,0,215,43.721,43.721
15,0.980,unknown,16-23,0,0,0,0,NaN,NaN
15,0.980,unknown,23-5,0,3,0,3,0.000,0.000
15,0.980,SLO Creek Water,16-23,0,0,0,0,NaN,NaN
15,0.980,SLO Creek Water,23-5,0,0,0,0,NaN,NaN
15,0.980,Pig/Swine,16-23,2,3,0,5,40.000,40.000
15,0.980,Pig/Swine,23-5,8,7,0,15,53.333,53.333
15,0.980,Klebsiella,16-23,0,0,0,0,NaN,NaN
15,0.980,Klebsiella,23-5,0,0,0,0,NaN,NaN
15,0.980,Hu Cw and Dg,16-23,3,7,0,10,30.000,30.000
15,0.980,Hu Cw and Dg,23-5,5,5,0,10,50.000,50.000
15,0.980,Ground Squirrel,16-23,77,42,0,119,64.706,64.706
15,0.980,Ground Squirrel,23-5,81,61,0,142,57.042,57.042
15,0.980,Opossum,16-23,0,0,0,0,NaN,NaN
15,0.980,Opossum,23-5,0,0,0,0,NaN,NaN
15,0.980,Cow,16-23,1560,1173,0,2733,57.080,57.080
15,0.980,Cow,23-5,1527,1529,0,3056,49.967,49.967
15,0.980,Deer Mouse,16-23,0,0,0,0,NaN,NaN
15,0.980,Deer Mouse,23-5,0,0,0,0,NaN,NaN
15,0.980,OVERALL,16-23,3746,2532,0,6278,59.669,59.669
15,0.980,OVERALL,23-5,4384,3138,0,7522,58.282,58.282
15,0.990,Chicken,16-23,2,5,0,7,28.571,28.571
15,0.990,Chicken,23-5,7,2,0,9,77.778,77.778
15,0.990,Sea Lion,16-23,0,0,0,0,NaN,NaN
15,0.990,Sea Lion,23-5,4,6,0,10,40.000,40.000
15,0.990,Hu and Cw,16-23,2,3,0,5,40.000,40.000
15,0.990,Hu and Cw,23-5,10,24,0,34,29.412,29.412
15,0.990,Sheep,16-23,47,52,0,99,47.475,47.475
15,0.990,Sheep,23-5,52,38,0,90,57.778,57.778
15,0.990,Hu and Dg,16-23,7,9,0,16,43.750,43.750
15,0.990,Hu and Dg,23-5,20,20,0,40,50.000,50.000
15,0.990,Common Loon,16-23,0,0,0,0,NaN,NaN
15,0.990,Common Loon,23-5,0,2,0,2,0.000,0.000
15,0.990,Red-Winged Blackbird,16-23,0,2,0,2,0.000,0.000
15,0.990,Red-Winged Blackbird,23-5,0,0,0,0,NaN,NaN
15,0.990,Cw,16-23,6,7,0,13,46.154,46.154
15,0.990,Cw,23-5,12,21,0,33,36.364,36.364
15,0.990,Cliff Sparrow,16-23,0,8,0,8,0.000,0.000
15,0.990,Cliff Sparrow,23-5,0,4,0,4,0.000,0.000
15,0.990,Pig,16-23,5,4,0,9,55.556,55.556
15,0.990,Pig,23-5,7,6,0,13,53.846,53.846
15,0.990,Barn Owl,16-23,0,0,0,0,NaN,NaN
15,0.990,Barn Owl,23-5,0,0,0,0,NaN,NaN
15,0.990,Wild Pig,16-23,0,1,0,1,0.000,0.000
15,0.990,Wild Pig,23-5,0,1,0,1,0.000,0.000
15,0.990,Pennington Creek Water,16-23,0,0,0,0,NaN,NaN
15,0.990,Pennington Creek Water,23-5,0,0,0,0,NaN,NaN
15,0.990,Guinni,16-23,0,0,0,0,NaN,NaN
15,0.990,Guinni,23-5,0,0,0,0,NaN,NaN
15,0.990,Racoon,16-23,0,0,0,0,NaN,NaN
15,0.990,Racoon,23-5,0,1,0,1,0.000,0.000
15,0.990,Hu,16-23,10,7,0,17,58.824,58.824
15,0.990,Hu,23-5,22,15,0,37,59.459,59.459
15,0.990,Cw and Dg,16-23,6,14,0,20,30.000,30.000
15,0.990,Cw and Dg,23-5,14,12,0,26,53.846,53.846
15,0.990,Red Wind Blackbird,16-23,0,0,0,0,NaN,NaN
15,0.990,Red Wind Blackbird,23-5,0,0,0,0,NaN,NaN
15,0.990,Tree Swallow,16-23,0,0,0,0,NaN,NaN
15,0.990,Tree Swallow,23-5,0,0,0,0,NaN,NaN
15,0.990,Turkey Vulture,16-23,0,0,0,0,NaN,NaN
15,0.990,Turkey Vulture,23-5,0,0,0,0,NaN,NaN
15,0.990,Dg,16-23,6,12,0,18,33.333,33.333
15,0.990,Dg,23-5,31,20,0,51,60.784,60.784
15,0.990,Western Kingbird,16-23,0,0,0,0,NaN,NaN
15,0.990,Western Kingbird,23-5,0,0,0,0,NaN,NaN
15,0.990,White Crowned Sparrow,16-23,0,0,0,0,NaN,NaN
15,0.990,White Crowned Sparrow,23-5,0,4,0,4,0.000,0.000
15,0.990,Eared Grebe,16-23,0,0,0,0,NaN,NaN
15,0.990,Eared Grebe,23-5,0,7,0,7,0.000,0.000
15,0.990,cougar,16-23,0,1,0,1,0.000,0.000
15,0.990,cougar,23-5,0,0,0,0,NaN,NaN
15,0.990,Ocean Water,16-23,0,0,0,0,NaN,NaN
15,0.990,Ocean Water,23-5,0,0,0,0,NaN,NaN
15,0.990,Red Tailed Hawk,16-23,0,0,0,0,NaN,NaN
15,0.990,Red Tailed Hawk,23-5,0,1,0,1,0.000,0.000
15,0.990,Dog,16-23,54,73,0,127,42.520,42.520
15,0.990,Dog,23-5,93,121,0,214,43.458,43.458
15,0.990,Human,16-23,1752,790,0,2542,68.922,68.922
15,0.990,Human,23-5,2176,629,0,2805,77.576,77.576
15,0.990,Wild Turkey,16-23,3,9,0,12,25.000,25.000
15,0.990,Wild Turkey,23-5,5,19,0,24,20.833,20.833
15,0.990,Clark Grebe,16-23,0,0,0,0,NaN,NaN
15,0.990,Clark Grebe,23-5,2,3,0,5,40.000,40.000
15,0.990,Seagull,16-23,0,0,0,0,NaN,NaN
15,0.990,Seagull,23-5,48,6,0,54,88.889,88.889
15,0.990,Surf Scoter,16-23,0,0,0,0,NaN,NaN
15,0.990,Surf Scoter,23-5,2,0,0,2,100.000,100.000
15,0.990,Pigeon,16-23,66,118,0,184,35.870,35.870
15,0.990,Pigeon,23-5,121,179,0,300,40.333,40.333
15,0.990,Pacific Ocean Water,16-23,0,0,0,0,NaN,NaN
15,0.990,Pacific Ocean Water,23-5,0,0,0,0,NaN,NaN
15,0.990,Cat,16-23,19,24,0,43,44.186,44.186
15,0.990,Cat,23-5,13,19,0,32,40.625,40.625
15,0.990,Horse,16-23,9,11,0,20,45.000,45.000
15,0.990,Horse,23-5,17,69,0,86,19.767,19.767
15,0.990,orangutan,16-23,0,0,0,0,NaN,NaN
15,0.990,orangutan,23-5,0,0,0,0,NaN,NaN
15,0.990,Bat,16-23,36,33,0,69,52.174,52.174
15,0.990,Bat,23-5,37,36,0,73,50.685,50.685
15,0.990,Deer,16-23,11,26,0,37,29.730,29.730
15,0.990,Deer,23-5,14,114,0,128,10.938,10.938
15,0.990,Great Horned Owl,16-23,0,0,0,0,NaN,NaN
15,0.990,Great Horned Owl,23-5,0,0,0,0,NaN,NaN
15,0.990,Freshwater Lagoon,16-23,0,0,0,0,NaN,NaN
15,0.990,Freshwater Lagoon,23-5,0,0,0,0,NaN,NaN
15,0.990,Unknown Avian,16-23,0,0,0,0,NaN,NaN
15,0.990,Unknown Avian,23-5,0,0,0,0,NaN,NaN
15,0.990,Human UTI,16-23,79,64,0,143,55.245,55.245
15,0.990,Human UTI,23-5,96,96,0,192,50.000,50.000
15,0.990,unknown,16-23,0,0,0,0,NaN,NaN
15,0.990,unknown,23-5,0,5,0,5,0.000,0.000
15,0.990,SLO Creek Water,16-23,0,0,0,0,NaN,NaN
15,0.990,SLO Creek Water,23-5,0,0,0,0,NaN,NaN
15,0.990,Pig/Swine,16-23,3,4,0,7,42.857,42.857
15,0.990,Pig/Swine,23-5,8,7,0,15,53.333,53.333
15,0.990,Klebsiella,16-23,0,0,0,0,NaN,NaN
15,0.990,Klebsiella,23-5,0,0,0,0,NaN,NaN
15,0.990,Hu Cw and Dg,16-23,3,7,0,10,30.000,30.000
15,0.990,Hu Cw and Dg,23-5,5,7,0,12,41.667,41.667
15,0.990,Ground Squirrel,16-23,80,43,0,123,65.041,65.041
15,0.990,Ground Squirrel,23-5,84,65,0,149,56.376,56.376
15,0.990,Opossum,16-23,1,0,0,1,100.000,100.000
15,0.990,Opossum,23-5,2,0,0,2,100.000,100.000
15,0.990,Cow,16-23,1527,1064,0,2591,58.935,58.935
15,0.990,Cow,23-5,1487,1378,0,2865,51.902,51.902
15,0.990,Deer Mouse,16-23,0,0,0,0,NaN,NaN
15,0.990,Deer Mouse,23-5,0,0,0,0,NaN,NaN
15,0.990,OVERALL,16-23,3734,2391,0,6125,60.963,60.963
15,0.990,OVERALL,23-5,4389,2937,0,7326,59.910,59.910
15,1.000,Chicken,16-23,0,0,0,0,NaN,NaN
15,1.000,Chicken,23-5,0,0,0,0,NaN,NaN
15,1.000,Sea Lion,16-23,0,0,0,0,NaN,NaN
15,1.000,Sea Lion,23-5,0,0,0,0,NaN,NaN
15,1.000,Hu and Cw,16-23,0,0,0,0,NaN,NaN
15,1.000,Hu and Cw,23-5,0,0,0,0,NaN,NaN
15,1.000,Sheep,16-23,0,0,0,0,NaN,NaN
15,1.000,Sheep,23-5,0,0,0,0,NaN,NaN
15,1.000,Hu and Dg,16-23,0,0,0,0,NaN,NaN
15,1.000,Hu and Dg,23-5,0,0,0,0,NaN,NaN
15,1.000,Common Loon,16-23,0,0,0,0,NaN,NaN
15,1.000,Common Loon,23-5,0,0,0,0,NaN,NaN
15,1.000,Red-Winged Blackbird,16-23,0,0,0,0,NaN,NaN
15,1.000,Red-Winged Blackbird,23-5,0,0,0,0,NaN,NaN
15,1.000,Cw,16-23,0,0,0,0,NaN,NaN
15,1.000,Cw,23-5,0,0,0,0,NaN,NaN
15,1.000,Cliff Sparrow,16-23,0,0,0,0,NaN,NaN
15,1.000,Cliff Sparrow,23-5,0,0,0,0,NaN,NaN
15,1.000,Pig,16-23,0,0,0,0,NaN,NaN
15,1.000,Pig,23-5,0,0,0,0,NaN,NaN
15,1.000,Barn Owl,16-23,0,0,0,0,NaN,NaN
15,1.000,Barn Owl,23-5,0,0,0,0,NaN,NaN
15,1.000,Wild Pig,16-23,0,0,0,0,NaN,NaN
15,1.000,Wild Pig,23-5,0,0,0,0,NaN,NaN
15,1.000,Pennington Creek Water,16-23,0,0,0,0,NaN,NaN
15,1.000,Pennington Creek Water,23-5,0,0,0,0,NaN,NaN
15,1.000,Guinni,16-23,0,0,0,0,NaN,NaN
15,1.000,Guinni,23-5,0,0,0,0,NaN,NaN
15,1.000,Racoon,16-23,0,0,0,0,NaN,NaN
15,1.000,Racoon,23-5,0,0,0,0,NaN,NaN
15,1.000,Hu,16-23,0,0,0,0,NaN,NaN
15,1.000,Hu,23-5,0,0,0,0,NaN,NaN
15,1.000,Cw and Dg,16-23,0,0,0,0,NaN,NaN
15,1.000,Cw and Dg,23-5,0,0,0,0,NaN,NaN
15,1.000,Red Wind Blackbird,16-23,0,0,0,0,NaN,NaN
15,1.000,Red Wind Blackbird,23-5,0,0,0,0,NaN,NaN
15,1.000,Tree Swallow,16-23,0,0,0,0,NaN,NaN
15,1.000,Tree Swallow,23-5,0,0,0,0,NaN,NaN
15,1.000,Turkey Vulture,16-23,0,0,0,0,NaN,NaN
15,1.000,Turkey Vulture,23-5,0,0,0,0,NaN,NaN
15,1.000,Dg,16-23,0,0,0,0,NaN,NaN
15,1.000,Dg,23-5,0,0,0,0,NaN,NaN
15,1.000,Western Kingbird,16-23,0,0,0,0,NaN,NaN
15,1.000,Western Kingbird,23-5,0,0,0,0,NaN,NaN
15,1.000,White Crowned Sparrow,16-23,0,0,0,0,NaN,NaN
15,1.000,White Crowned Sparrow,23-5,0,0,0,0,NaN,NaN
15,1.000,Eared Grebe,16-23,0,0,0,0,NaN,NaN
15,1.000,Eared Grebe,23-5,0,0,0,0,NaN,NaN
15,1.000,cougar,16-23,0,0,0,0,NaN,NaN
15,1.000,cougar,23-5,0,0,0,0,NaN,NaN
15,1.000,Ocean Water,16-23,0,0,0,0,NaN,NaN
15,1.000,Ocean Water,23-5,0,0,0,0,NaN,NaN
15,1.000,Red Tailed Hawk,16-23,0,0,0,0,NaN,NaN
15,1.000,Red Tailed Hawk,23-5,0,0,0,0,NaN,NaN
15,1.000,Dog,16-23,0,0,0,0,NaN,NaN
15,1.000,Dog,23-5,0,0,0,0,NaN,NaN
15,1.000,Human,16-23,68,0,0,68,100.000,100.000
15,1.000,Human,23-5,90,0,0,90,100.000,100.000
15,1.000,Wild Turkey,16-23,0,0,0,0,NaN,NaN
15,1.000,Wild Turkey,23-5,0,0,0,0,NaN,NaN
15,1.000,Clark Grebe,16-23,0,0,0,0,NaN,NaN
15,1.000,Clark Grebe,23-5,0,0,0,0,NaN,NaN
15,1.000,Seagull,16-23,0,0,0,0,NaN,NaN
15,1.000,Seagull,23-5,0,0,0,0,NaN,NaN
15,1.000,Surf Scoter,16-23,0,0,0,0,NaN,NaN
15,1.000,Surf Scoter,23-5,0,0,0,0,NaN,NaN
15,1.000,Pigeon,16-23,0,0,0,0,NaN,NaN
15,1.000,Pigeon,23-5,0,0,0,0,NaN,NaN
15,1.000,Pacific Ocean Water,16-23,0,0,0,0,NaN,NaN
15,1.000,Pacific Ocean Water,23-5,0,0,0,0,NaN,NaN
15,1.000,Cat,16-23,0,0,0,0,NaN,NaN
15,1.000,Cat,23-5,0,0,0,0,NaN,NaN
15,1.000,Horse,16-23,0,0,0,0,NaN,NaN
15,1.000,Horse,23-5,0,0,0,0,NaN,NaN
15,1.000,orangutan,16-23,0,0,0,0,NaN,NaN
15,1.000,orangutan,23-5,0,0,0,0,NaN,NaN
15,1.000,Bat,16-23,0,0,0,0,NaN,NaN
15,1.000,Bat,23-5,0,0,0,0,NaN,NaN
15,1.000,Deer,16-23,0,0,0,0,NaN,NaN
15,1.000,Deer,23-5,0,0,0,0,NaN,NaN
15,1.000,Great Horned Owl,16-23,0,0,0,0,NaN,NaN
15,1.000,Great Horned Owl,23-5,0,0,0,0,NaN,NaN
15,1.000,Freshwater Lagoon,16-23,0,0,0,0,NaN,NaN
15,1.000,Freshwater Lagoon,23-5,0,0,0,0,NaN,NaN
15,1.000,Unknown Avian,16-23,0,0,0,0,NaN,NaN
15,1.000,Unknown Avian,23-5,0,0,0,0,NaN,NaN
15,1.000,Human UTI,16-23,0,0,0,0,NaN,NaN
15,1.000,Human UTI,23-5,0,0,0,0,NaN,NaN
15,1.000,unknown,16-23,0,0,0,0,NaN,NaN
15,1.000,unknown,23-5,0,0,0,0,NaN,NaN
15,1.000,SLO Creek Water,16-23,0,0,0,0,NaN,NaN
15,1.000,SLO Creek Water,23-5,0,0,0,0,NaN,NaN
15,1.000,Pig/Swine,16-23,0,0,0,0,NaN,NaN
15,1.000,Pig/Swine,23-5,0,0,0,0,NaN,NaN
15,1.000,Klebsiella,16-23,0,0,0,0,NaN,NaN
15,1.000,Klebsiella,23-5,0,0,0,0,NaN,NaN
15,1.000,Hu Cw and Dg,16-23,0,0,0,0,NaN,NaN
15,1.000,Hu Cw and Dg,23-5,0,0,0,0,NaN,NaN
15,1.000,Ground Squirrel,16-23,0,0,0,0,NaN,NaN
15,1.000,Ground Squirrel,23-5,0,0,0,0,NaN,NaN
15,1.000,Opossum,16-23,0,0,0,0,NaN,NaN
15,1.000,Opossum,23-5,0,0,0,0,NaN,NaN
15,1.000,Cow,16-23,0,0,0,0,NaN,NaN
15,1.000,Cow,23-5,0,0,0,0,NaN,NaN
15,1.000,Deer Mouse,16-23,0,0,0,0,NaN,NaN
15,1.000,Deer Mouse,23-5,0,0,0,0,NaN,NaN
15,1.000,OVERALL,16-23,68,0,0,68,100.000,100.000
15,1.000,OVERALL,23-5,90,0,0,90,100.000,100.000
16,0.000,Chicken,16-23,0,0,0,0,NaN,NaN
16,0.000,Chicken,23-5,4,2,0,6,66.667,66.667
16,0.000,Sea Lion,16-23,0,0,0,0,NaN,NaN
16,0.000,Sea Lion,23-5,0,6,0,6,0.000,0.000
16,0.000,Hu and Cw,16-23,0,4,0,4,0.000,0.000
16,0.000,Hu and Cw,23-5,10,7,0,17,58.824,58.824
16,0.000,Sheep,16-23,44,48,0,92,47.826,47.826
16,0.000,Sheep,23-5,53,39,0,92,57.609,57.609
16,0.000,Hu and Dg,16-23,7,6,0,13,53.846,53.846
16,0.000,Hu and Dg,23-5,18,24,0,42,42.857,42.857
16,0.000,Common Loon,16-23,0,0,0,0,NaN,NaN
16,0.000,Common Loon,23-5,0,0,0,0,NaN,NaN
16,0.000,Red-Winged Blackbird,16-23,0,0,0,0,NaN,NaN
16,0.000,Red-Winged Blackbird,23-5,0,0,0,0,NaN,NaN
16,0.000,Cw,16-23,4,6,0,10,40.000,40.000
16,0.000,Cw,23-5,6,13,0,19,31.579,31.579
16,0.000,Cliff Sparrow,16-23,0,5,0,5,0.000,0.000
16,0.000,Cliff Sparrow,23-5,0,0,0,0,NaN,NaN
16,0.000,Pig,16-23,2,3,0,5,40.000,40.000
16,0.000,Pig,23-5,0,0,0,0,NaN,NaN
16,0.000,Barn Owl,16-23,0,0,0,0,NaN,NaN
16,0.000,Barn Owl,23-5,0,0,0,0,NaN,NaN
16,0.000,Wild Pig,16-23,0,0,0,0,NaN,NaN
16,0.000,Wild Pig,23-5,0,0,0,0,NaN,NaN
16,0.000,Pennington Creek Water,16-23,0,0,0,0,NaN,NaN
16,0.000,Pennington Creek Water,23-5,0,0,0,0,NaN,NaN
16,0.000,Guinni,16-23,0,0,0,0,NaN,NaN
16,0.000,Guinni,23-5,0,0,0,0,NaN,NaN
16,0.000,Racoon,16-23,0,0,0,0,NaN,NaN
16,0.000,Racoon,23-5,0,0,0,0,NaN,NaN
16,0.000,Hu,16-23,8,6,0,14,57.143,57.143
16,0.000,Hu,23-5,22,21,0,43,51.163,51.163
16,0.000,Cw and Dg,16-23,4,13,0,17,23.529,23.529
16,0.000,Cw and Dg,23-5,14,20,0,34,41.176,41.176
16,0.000,Red Wind Blackbird,16-23,0,0,0,0,NaN,NaN
16,0.000,Red Wind Blackbird,23-5,0,0,0,0,NaN,NaN
16,0.000,Tree Swallow,16-23,0,0,0,0,NaN,NaN
16,0.000,Tree Swallow,23-5,0,0,0,0,NaN,NaN
16,0.000,Turkey Vulture,16-23,0,0,0,0,NaN,NaN
16,0.000,Turkey Vulture,23-5,0,0,0,0,NaN,NaN
16,0.000,Dg,16-23,5,11,0,16,31.250,31.250
16,0.000,Dg,23-5,31,37,0,68,45.588,45.588
16,0.000,Western Kingbird,16-23,0,0,0,0,NaN,NaN
16,0.000,Western Kingbird,23-5,0,0,0,0,NaN,NaN
16,0.000,White Crowned Sparrow,16-23,0,0,0,0,NaN,NaN
16,0.000,White Crowned Sparrow,23-5,0,1,0,1,0.000,0.000
16,0.000,Eared Grebe,16-23,0,0,0,0,NaN,NaN
16,0.000,Eared Grebe,23-5,0,6,0,6,0.000,0.000
16,0.000,cougar,16-23,0,0,0,0,NaN,NaN
16,0.000,cougar,23-5,0,0,0,0,NaN,NaN
16,0.000,Ocean Water,16-23,0,0,0,0,NaN,NaN
16,0.000,Ocean Water,23-5,0,0,0,0,NaN,NaN
16,0.000,Red Tailed Hawk,16-23,0,0,0,0,NaN,NaN
16,0.000,Red Tailed Hawk,23-5,0,0,0,0,NaN,NaN
16,0.000,Dog,16-23,52,70,0,122,42.623,42.623
16,0.000,Dog,23-5,87,145,0,232,37.500,37.500
16,0.000,Human,16-23,1760,879,0,2639,66.692,66.692
16,0.000,Human,23-5,2173,759,0,2932,74.113,74.113
16,0.000,Wild Turkey,16-23,0,1,0,1,0.000,0.000
16,0.000,Wild Turkey,23-5,1,4,0,5,20.000,20.000
16,0.000,Clark Grebe,16-23,0,0,0,0,NaN,NaN
16,0.000,Clark Grebe,23-5,0,0,0,0,NaN,NaN
16,0.000,Seagull,16-23,0,0,0,0,NaN,NaN
16,0.000,Seagull,23-5,44,7,0,51,86.275,86.275
16,0.000,Surf Scoter,16-23,0,0,0,0,NaN,NaN
16,0.000,Surf Scoter,23-5,0,0,0,0,NaN,NaN
16,0.000,Pigeon,16-23,51,124,0,175,29.143,29.143
16,0.000,Pigeon,23-5,109,114,0,223,48.879,48.879
16,0.000,Pacific Ocean Water,16-23,0,0,0,0,NaN,NaN
16,0.000,Pacific Ocean Water,23-5,0,0,0,0,NaN,NaN
16,0.000,Cat,16-23,13,18,0,31,41.935,41.935
16,0.000,Cat,23-5,10,14,0,24,41.667,41.667
16,0.000,Horse,16-23,4,9,0,13,30.769,30.769
16,0.000,Horse,23-5,13,38,0,51,25.490,25.490
16,0.000,orangutan,16-23,0,0,0,0,NaN,NaN
16,0.000,orangutan,23-5,0,0,0,0,NaN,NaN
16,0.000,Bat,16-23,36,37,0,73,49.315,49.315
16,0.000,Bat,23-5,37,41,0,78,47.436,47.436
16,0.000,Deer,16-23,10,23,0,33,30.303,30.303
16,0.000,Deer,23-5,14,129,0,143,9.790,9.790
16,0.000,Great Horned Owl,16-23,0,0,0,0,NaN,NaN
16,0.000,Great Horned Owl,23-5,0,0,0,0,NaN,NaN
16,0.000,Freshwater Lagoon,16-23,0,0,0,0,NaN,NaN
16,0.000,Freshwater Lagoon,23-5,0,0,0,0,NaN,NaN
16,0.000,Unknown Avian,16-23,0,0,0,0,NaN,NaN
16,0.000,Unknown Avian,23-5,0,0,0,0,NaN,NaN
16,0.000,Human UTI,16-23,65,66,0,131,49.618,49.618
16,0.000,Human UTI,23-5,91,120,0,211,43.128,43.128
16,0.000,unknown,16-23,0,0,0,0,NaN,NaN
16,0.000,unknown,23-5,0,2,0,2,0.000,0.000
16,0.000,SLO Creek Water,16-23,0,0,0,0,NaN,NaN
16,0.000,SLO Creek Water,23-5,0,0,0,0,NaN,NaN
16,0.000,Pig/Swine,16-23,2,2,0,4,50.000,50.000
16,0.000,Pig/Swine,23-5,8,7,0,15,53.333,53.333
16,0.000,Klebsiella,16-23,0,0,0,0,NaN,NaN
16,0.000,Klebsiella,23-5,0,0,0,0,NaN,NaN
16,0.000,Hu Cw and Dg,16-23,3,7,0,10,30.000,30.000
16,0.000,Hu Cw and Dg,23-5,3,5,0,8,37.500,37.500
16,0.000,Ground Squirrel,16-23,73,41,0,114,64.035,64.035
16,0.000,Ground Squirrel,23-5,76,60,0,136,55.882,55.882
16,0.000,Opossum,16-23,0,0,0,0,NaN,NaN
16,0.000,Opossum,23-5,0,0,0,0,NaN,NaN
16,0.000,Cow,16-23,1570,1256,0,2826,55.556,55.556
16,0.000,Cow,23-5,1530,1635,0,3165,48.341,48.341
16,0.000,Deer Mouse,16-23,0,0,0,0,NaN,NaN
16,0.000,Deer Mouse,23-5,0,0,0,0,NaN,NaN
16,0.000,OVERALL,16-23,3713,2635,0,6348,58.491,58.491
16,0.000,OVERALL,23-5,4354,3256,0,7610,57.214,57.214
16,0.500,Chicken,16-23,0,0,0,0,NaN,NaN
16,0.500,Chicken,23-5,4,2,0,6,66.667,66.667
16,0.500,Sea Lion,16-23,0,0,0,0,NaN,NaN
16,0.500,Sea Lion,23-5,0,6,0,6,0.000,0.000
16,0.500,Hu and Cw,16-23,0,4,0,4,0.000,0.000
16,0.500,Hu and Cw,23-5,10,7,0,17,58.824,58.824
16,0.500,Sheep,16-23,44,48,0,92,47.826,47.826
16,0.500,Sheep,23-5,53,39,0,92,57.609,57.609
16,0.500,Hu and Dg,16-23,7,6,0,13,53.846,53.846
16,0.500,Hu and Dg,23-5,18,24,0,42,42.857,42.857
16,0.500,Common Loon,16-23,0,0,0,0,NaN,NaN
16,0.500,Common Loon,23-5,0,0,0,0,NaN,NaN
16,0.500,Red-Winged Blackbird,16-23,0,0,0,0,NaN,NaN
16,0.500,Red-Winged Blackbird,23-5,0,0,0,0,NaN,NaN
16,0.500,Cw,16-23,4,6,0,10,40.000,40.000
16,0.500,Cw,23-5,6,13,0,19,31.579,31.579
16,0.500,Cliff Sparrow,16-23,0,5,0,5,0.000,0.000
16,0.500,Cliff Sparrow,23-5,0,0,0,0,NaN,NaN
16,0.500,Pig,16-23,2,3,0,5,40.000,40.000
16,0.500,Pig,23-5,0,0,0,0,NaN,NaN
16,0.500,Barn Owl,16-23,0,0,0,0,NaN,NaN
16,0.500,Barn Owl,23-5,0,0,0,0,NaN,NaN
16,0.500,Wild Pig,16-23,0,0,0,0,NaN,NaN
16,0.500,Wild Pig,23-5,0,0,0,0,NaN,NaN
16,0.500,Pennington Creek Water,16-23,0,0,0,0,NaN,NaN
16,0.500,Pennington Creek Water,23-5,0,0,0,0,NaN,NaN
16,0.500,Guinni,16-23,0,0,0,0,NaN,NaN
16,0.500,Guinni,23-5,0,0,0,0,NaN,NaN
16,0.500,Racoon,16-23,0,0,0,0,NaN,NaN
16,0.500,Racoon,23-5,0,0,0,0,NaN,NaN
16,0.500,Hu,16-23,8,6,0,14,57.143,57.143
16,0.500,Hu,23-5,22,21,0,43,51.163,51.163
16,0.500,Cw and Dg,16-23,4,13,0,17,23.529,23.529
16,0.500,Cw and Dg,23-5,14,20,0,34,41.176,41.176
16,0.500,Red Wind Blackbird,16-23,0,0,0,0,NaN,NaN
16,0.500,Red Wind Blackbird,23-5,0,0,0,0,NaN,NaN
16,0.500,Tree Swallow,16-23,0,0,0,0,NaN,NaN
16,0.500,Tree Swallow,23-5,0,0,0,0,NaN,NaN
16,0.500,Turkey Vulture,16-23,0,0,0,0,NaN,NaN
16,0.500,Turkey Vulture,23-5,0,0,0,0,NaN,NaN
16,0.500,Dg,16-23,5,11,0,16,31.250,31.250
16,0.500,Dg,23-5,31,37,0,68,45.588,45.588
16,0.500,Western Kingbird,16-23,0,0,0,0,NaN,NaN
16,0.500,Western Kingbird,23-5,0,0,0,0,NaN,NaN
16,0.500,White Crowned Sparrow,16-23,0,0,0,0,NaN,NaN
16,0.500,White Crowned Sparrow,23-5,0,1,0,1,0.000,0.000
16,0.500,Eared Grebe,16-23,0,0,0,0,NaN,NaN
16,0.500,Eared Grebe,23-5,0,6,0,6,0.000,0.000
16,0.500,cougar,16-23,0,0,0,0,NaN,NaN
16,0.500,cougar,23-5,0,0,0,0,NaN,NaN
16,0.500,Ocean Water,16-23,0,0,0,0,NaN,NaN
16,0.500,Ocean Water,23-5,0,0,0,0,NaN,NaN
16,0.500,Red Tailed Hawk,16-23,0,0,0,0,NaN,NaN
16,0.500,Red Tailed Hawk,23-5,0,0,0,0,NaN,NaN
16,0.500,Dog,16-23,52,70,0,122,42.623,42.623
16,0.500,Dog,23-5,87,145,0,232,37.500,37.500
16,0.500,Human,16-23,1760,879,0,2639,66.692,66.692
16,0.500,Human,23-5,2173,759,0,2932,74.113,74.113
16,0.500,Wild Turkey,16-23,0,1,0,1,0.000,0.000
16,0.500,Wild Turkey,23-5,1,4,0,5,20.000,20.000
16,0.500,Clark Grebe,16-23,0,0,0,0,NaN,NaN
16,0.500,Clark Grebe,23-5,0,0,0,0,NaN,NaN
16,0.500,Seagull,16-23,0,0,0,0,NaN,NaN
16,0.500,Seagull,23-5,44,7,0,51,86.275,86.275
16,0.500,Surf Scoter,16-23,0,0,0,0,NaN,NaN
16,0.500,Surf Scoter,23-5,0,0,0,0,NaN,NaN
16,0.500,Pigeon,16-23,51,124,0,175,29.143,29.143
16,0.500,Pigeon,23-5,109,114,0,223,48.879,48.879
16,0.500,Pacific Ocean Water,16-23,0,0,0,0,NaN,NaN
16,0.500,Pacific Ocean Water,23-5,0,0,0,0,NaN,NaN
16,0.500,Cat,16-23,13,18,0,31,41.935,41.935
16,0.500,Cat,23-5,10,14,0,24,41.667,41.667
16,0.500,Horse,16-23,4,9,0,13,30.769,30.769
16,0.500,Horse,23-5,13,38,0,51,25.490,25.490
16,0.500,orangutan,16-23,0,0,0,0,NaN,NaN
16,0.500,orangutan,23-5,0,0,0,0,NaN,NaN
16,0.500,Bat,16-23,36,37,0,73,49.315,49.315
16,0.500,Bat,23-5,37,41,0,78,47.436,47.436
16,0.500,Deer,16-23,10,23,0,33,30.303,30.303
16,0.500,Deer,23-5,14,129,0,143,9.790,9.790
16,0.500,Great Horned Owl,16-23,0,0,0,0,NaN,NaN
16,0.500,Great Horned Owl,23-5,0,0,0,0,NaN,NaN
16,0.500,Freshwater Lagoon,16-23,0,0,0,0,NaN,NaN
16,0.500,Freshwater Lagoon,23-5,0,0,0,0,NaN,NaN
16,0.500,Unknown Avian,16-23,0,0,0,0,NaN,NaN
16,0.500,Unknown Avian,23-5,0,0,0,0,NaN,NaN
16,0.500,Human UTI,16-23,65,66,0,131,49.618,49.618
16,0.500,Human UTI,23-5,91,120,0,211,43.128,43.128
16,0.500,unknown,16-23,0,0,0,0,NaN,NaN
16,0.500,unknown,23-5,0,2,0,2,0.000,0.000
16,0.500,SLO Creek Water,16-23,0,0,0,0,NaN,NaN
16,0.500,SLO Creek Water,23-5,0,0,0,0,NaN,NaN
16,0.500,Pig/Swine,16-23,2,2,0,4,50.000,50.000
16,0.500,Pig/Swine,23-5,8,7,0,15,53.333,53.333
16,0.500,Klebsiella,16-23,0,0,0,0,NaN,NaN
16,0.500,Klebsiella,23-5,0,0,0,0,NaN,NaN
16,0.500,Hu Cw and Dg,16-23,3,7,0,10,30.000,30.000
16,0.500,Hu Cw and Dg,23-5,3,5,0,8,37.500,37.500
16,0.500,Ground Squirrel,16-23,73,41,0,114,64.035,64.035
16,0.500,Ground Squirrel,23-5,76,60,0,136,55.882,55.882
16,0.500,Opossum,16-23,0,0,0,0,NaN,NaN
16,0.500,Opossum,23-5,0,0,0,0,NaN,NaN
16,0.500,Cow,16-23,1570,1256,0,2826,55.556,55.556
16,0.500,Cow,23-5,1530,1635,0,3165,48.341,48.341
16,0.500,Deer Mouse,16-23,0,0,0,0,NaN,NaN
16,0.500,Deer Mouse,23-5,0,0,0,0,NaN,NaN
16,0.500,OVERALL,16-23,3713,2635,0,6348,58.491,58.491
16,0.500,OVERALL,23-5,4354,3256,0,7610,57.214,57.214
16,0.900,Chicken,16-23,0,0,0,0,NaN,NaN
16,0.900,Chicken,23-5,4,2,0,6,66.667,66.667
16,0.900,Sea Lion,16-23,0,0,0,0,NaN,NaN
16,0.900,Sea Lion,23-5,0,6,0,6,0.000,0.000
16,0.900,Hu and Cw,16-23,0,4,0,4,0.000,0.000
16,0.900,Hu and Cw,23-5,10,7,0,17,58.824,58.824
16,0.900,Sheep,16-23,44,48,0,92,47.826,47.826
16,0.900,Sheep,23-5,53,39,0,92,57.609,57.609
16,0.900,Hu and Dg,16-23,7,6,0,13,53.846,53.846
16,0.900,Hu and Dg,23-5,18,24,0,42,42.857,42.857
16,0.900,Common Loon,16-23,0,0,0,0,NaN,NaN
16,0.900,Common Loon,23-5,0,0,0,0,NaN,NaN
16,0.900,Red-Winged Blackbird,16-23,0,0,0,0,NaN,NaN
16,0.900,Red-Winged Blackbird,23-5,0,0,0,0,NaN,NaN
16,0.900,Cw,16-23,4,6,0,10,40.000,40.000
16,0.900,Cw,23-5,6,13,0,19,31.579,31.579
16,0.900,Cliff Sparrow,16-23,0,5,0,5,0.000,0.000
16,0.900,Cliff Sparrow,23-5,0,0,0,0,NaN,NaN
16,0.900,Pig,16-23,2,3,0,5,40.000,40.000
16,0.900,Pig,23-5,0,0,0,0,NaN,NaN
16,0.900,Barn Owl,16-23,0,0,0,0,NaN,NaN
16,0.900,Barn Owl,23-5,0,0,0,0,NaN,NaN
16,0.900,Wild Pig,16-23,0,0,0,0,NaN,NaN
16,0.900,Wild Pig,23-5,0,0,0,0,NaN,NaN
16,0.900,Pennington Creek Water,16-23,0,0,0,0,NaN,NaN
16,0.900,Pennington Creek Water,23-5,0,0,0,0,NaN,NaN
16,0.900,Guinni,16-23,0,0,0,0,NaN,NaN
16,0.900,Guinni,23-5,0,0,0,0,NaN,NaN
16,0.900,Racoon,16-23,0,0,0,0,NaN,NaN
16,0.900,Racoon,23-5,0,0,0,0,NaN,NaN
16,0.900,Hu,16-23,8,6,0,14,57.143,57.143
16,0.900,Hu,23-5,22,21,0,43,51.163,51.163
16,0.900,Cw and Dg,16-23,4,13,0,17,23.529,23.529
16,0.900,Cw and Dg,23-5,14,20,0,34,41.176,41.176
16,0.900,Red Wind Blackbird,16-23,0,0,0,0,NaN,NaN
16,0.900,Red Wind Blackbird,23-5,0,0,0,0,NaN,NaN
16,0.900,Tree Swallow,16-23,0,0,0,0,NaN,NaN
16,0.900,Tree Swallow,23-5,0,0,0,0,NaN,NaN
16,0.900,Turkey Vulture,16-23,0,0,0,0,NaN,NaN
16,0.900,Turkey Vulture,23-5,0,0,0,0,NaN,NaN
16,0.900,Dg,16-23,5,11,0,16,31.250,31.250
16,0.900,Dg,23-5,31,37,0,68,45.588,45.588
16,0.900,Western Kingbird,16-23,0,0,0,0,NaN,NaN
16,0.900,Western Kingbird,23-5,0,0,0,0,NaN,NaN
16,0.900,White Crowned Sparrow,16-23,0,0,0,0,NaN,NaN
16,0.900,White Crowned Sparrow,23-5,0,1,0,1,0.000,0.000
16,0.900,Eared Grebe,16-23,0,0,0,0,NaN,NaN
16,0.900,Eared Grebe,23-5,0,6,0,6,0.000,0.000
16,0.900,cougar,16-23,0,0,0,0,NaN,NaN
16,0.900,cougar,23-5,0,0,0,0,NaN,NaN
16,0.900,Ocean Water,16-23,0,0,0,0,NaN,NaN
16,0.900,Ocean Water,23-5,0,0,0,0,NaN,NaN
16,0.900,Red Tailed Hawk,16-23,0,0,0,0,NaN,NaN
16,0.900,Red Tailed Hawk,23-5,0,0,0,0,NaN,NaN
16,0.900,Dog,16-23,52,70,0,122,42.623,42.623
16,0.900,Dog,23-5,87,141,0,228,38.158,38.158
16,0.900,Human,16-23,1760,875,0,2635,66.793,66.793
16,0.900,Human,23-5,2173,755,0,2928,74.214,74.214
16,0.900,Wild Turkey,16-23,0,1,0,1,0.000,0.000
16,0.900,Wild Turkey,23-5,1,4,0,5,20.000,20.000
16,0.900,Clark Grebe,16-23,0,0,0,0,NaN,NaN
16,0.900,Clark Grebe,23-5,0,0,0,0,NaN,NaN
16,0.900,Seagull,16-23,0,0,0,0,NaN,NaN
16,0.900,Seagull,23-5,44,8,0,52,84.615,84.615
16,0.900,Surf Scoter,16-23,0,0,0,0,NaN,NaN
16,0.900,Surf Scoter,23-5,0,0,0,0,NaN,NaN
16,0.900,Pigeon,16-23,51,124,0,175,29.143,29.143
16,0.900,Pigeon,23-5,109,114,0,223,48.879,48.879
16,0.900,Pacific Ocean Water,16-23,0,0,0,0,NaN,NaN
16,0.900,Pacific Ocean Water,23-5,0,0,0,0,NaN,NaN
16,0.900,Cat,16-23,13,18,0,31,41.935,41.935
16,0.900,Cat,23-5,10,14,0,24,41.667,41.667
16,0.900,Horse,16-23,4,9,0,13,30.769,30.769
16,0.900,Horse,23-5,13,38,0,51,25.490,25.490
16,0.900,orangutan,16-23,0,0,0,0,NaN,NaN
16,0.900,orangutan,23-5,0,0,0,0,NaN,NaN
16,0.900,Bat,16-23,36,37,0,73,49.315,49.315
16,0.900,Bat,23-5,37,41,0,78,47.436,47.436
16,0.900,Deer,16-23,10,23,0,33,30.303,30.303
16,0.900,Deer,23-5,14,129,0,143,9.790,9.790
16,0.900,Great Horned Owl,16-23,0,0,0,0,NaN,NaN
16,0.900,Great Horned Owl,23-5,0,0,0,0,NaN,NaN
16,0.900,Freshwater Lagoon,16-23,0,0,0,0,NaN,NaN
16,0.900,Freshwater Lagoon,23-5,0,0,0,0,NaN,NaN
16,0.900,Unknown Avian,16-23,0,0,0,0,NaN,NaN
16,0.900,Unknown Avian,23-5,0,0,0,0,NaN,NaN
16,0.900,Human UTI,16-23,65,66,0,131,49.618,49.618
16,0.900,Human UTI,23-5,94,120,0,214,43.925,43.925
16,0.900,unknown,16-23,0,0,0,0,NaN,NaN
16,0.900,unknown,23-5,0,2,0,2,0.000,0.000
16,0.900,SLO Creek Water,16-23,0,0,0,0,NaN,NaN
16,0.900,SLO Creek Water,23-5,0,0,0,0,NaN,NaN
16,0.900,Pig/Swine,16-23,2,2,0,4,50.000,50.000
16,0.900,Pig/Swine,23-5,8,7,0,15,53.333,53.333
16,0.900,Klebsiella,16-23,0,0,0,0,NaN,NaN
16,0.900,Klebsiella,23-5,0,0,0,0,NaN,NaN
16,0.900,Hu Cw and Dg,16-23,3,7,0,10,30.000,30.000
16,0.900,Hu Cw and Dg,23-5,3,5,0,8,37.500,37.500
16,0.900,Ground Squirrel,16-23,73,41,0,114,64.035,64.035
16,0.900,Ground Squirrel,23-5,76,60,0,136,55.882,55.882
16,0.900,Opossum,16-23,0,0,0,0,NaN,NaN
16,0.900,Opossum,23-5,0,0,0,0,NaN,NaN
16,0.900,Cow,16-23,1572,1254,0,2826,55.626,55.626
16,0.900,Cow,23-5,1530,1631,0,3161,48.402,48.402
16,0.900,Deer Mouse,16-23,0,0,0,0,NaN,NaN
16,0.900,Deer Mouse,23-5,0,0,0,0,NaN,NaN
16,0.900,OVERALL,16-23,3715,2629,0,6344,58.559,58.559
16,0.900,OVERALL,23-5,4357,3245,0,7602,57.314,57.314
16,0.950,Chicken,16-23,0,0,0,0,NaN,NaN
16,0.950,Chicken,23-5,4,2,0,6,66.667,66.667
16,0.950,Sea Lion,16-23,0,0,0,0,NaN,NaN
16,0.950,Sea Lion,23-5,0,6,0,6,0.000,0.000
16,0.950,Hu and Cw,16-23,0,4,0,4,0.000,0.000
16,0.950,Hu and Cw,23-5,10,7,0,17,58.824,58.824
16,0.950,Sheep,16-23,44,48,0,92,47.826,47.826
16,0.950,Sheep,23-5,53,39,0,92,57.609,57.609
16,0.950,Hu and Dg,16-23,7,6,0,13,53.846,53.846
16,0.950,Hu and Dg,23-5,18,24,0,42,42.857,42.857
16,0.950,Common Loon,16-23,0,0,0,0,NaN,NaN
16,0.950,Common Loon,23-5,0,0,0,0,NaN,NaN
16,0.950,Red-Winged Blackbird,16-23,0,0,0,0,NaN,NaN
16,0.950,Red-Winged Blackbird,23-5,0,0,0,0,NaN,NaN
16,0.950,Cw,16-23,4,6,0,10,40.000,40.000
16,0.950,Cw,23-5,6,13,0,19,31.579,31.579
16,0.950,Cliff Sparrow,16-23,0,5,0,5,0.000,0.000
16,0.950,Cliff Sparrow,23-5,0,0,0,0,NaN,NaN
16,0.950,Pig,16-23,2,3,0,5,40.000,40.000
16,0.950,Pig,23-5,0,0,0,0,NaN,NaN
16,0.950,Barn Owl,16-23,0,0,0,0,NaN,NaN
16,0.950,Barn Owl,23-5,0,0,0,0,NaN,NaN
16,0.950,Wild Pig,16-23,0,0,0,0,NaN,NaN
16,0.950,Wild Pig,23-5,0,0,0,0,NaN,NaN
16,0.950,Pennington Creek Water,16-23,0,0,0,0,NaN,NaN
16,0.950,Pennington Creek Water,23-5,0,0,0,0,NaN,NaN
16,0.950,Guinni,16-23,0,0,0,0,NaN,NaN
16,0.950,Guinni,23-5,0,0,0,0,NaN,NaN
16,0.950,Racoon,16-23,0,0,0,0,NaN,NaN
16,0.950,Racoon,23-5,0,0,0,0,NaN,NaN
16,0.950,Hu,16-23,8,6,0,14,57.143,57.143
16,0.950,Hu,23-5,22,21,0,43,51.163,51.163
16,0.950,Cw and Dg,16-23,4,13,0,17,23.529,23.529
16,0.950,Cw and Dg,23-5,14,20,0,34,41.176,41.176
16,0.950,Red Wind Blackbird,16-23,0,0,0,0,NaN,NaN
16,0.950,Red Wind Blackbird,23-5,0,0,0,0,NaN,NaN
16,0.950,Tree Swallow,16-23,0,0,0,0,NaN,NaN
16,0.950,Tree Swallow,23-5,0,0,0,0,NaN,NaN
16,0.950,Turkey Vulture,16-23,0,0,0,0,NaN,NaN
16,0.950,Turkey Vulture,23-5,0,0,0,0,NaN,NaN
16,0.950,Dg,16-23,5,11,0,16,31.250,31.250
16,0.950,Dg,23-5,31,36,0,67,46.269,46.269
16,0.950,Western Kingbird,16-23,0,0,0,0,NaN,NaN
16,0.950,Western Kingbird,23-5,0,0,0,0,NaN,NaN
16,0.950,White Crowned Sparrow,16-23,0,0,0,0,NaN,NaN
16,0.950,White Crowned Sparrow,23-5,0,1,0,1,0.000,0.000
16,0.950,Eared Grebe,16-23,0,0,0,0,NaN,NaN
16,0.950,Eared Grebe,23-5,0,6,0,6,0.000,0.000
16,0.950,cougar,16-23,0,0,0,0,NaN,NaN
16,0.950,cougar,23-5,0,0,0,0,NaN,NaN
16,0.950,Ocean Water,16-23,0,0,0,0,NaN,NaN
16,0.950,Ocean Water,23-5,0,0,0,0,NaN,NaN
16,0.950,Red Tailed Hawk,16-23,0,0,0,0,NaN,NaN
16,0.950,Red Tailed Hawk,23-5,0,0,0,0,NaN,NaN
16,0.950,Dog,16-23,52,70,0,122,42.623,42.623
16,0.950,Dog,23-5,87,139,0,226,38.496,38.496
16,0.950,Human,16-23,1760,872,0,2632,66.869,66.869
16,0.950,Human,23-5,2176,748,0,2924,74.419,74.419
16,0.950,Wild Turkey,16-23,0,1,0,1,0.000,0.000
16,0.950,Wild Turkey,23-5,1,3,0,4,25.000,25.000
16,0.950,Clark Grebe,16-23,0,0,0,0,NaN,NaN
16,0.950,Clark Grebe,23-5,0,0,0,0,NaN,NaN
16,0.950,Seagull,16-23,0,0,0,0,NaN,NaN
16,0.950,Seagull,23-5,44,7,0,51,86.275,86.275
16,0.950,Surf Scoter,16-23,0,0,0,0,NaN,NaN
16,0.950,Surf Scoter,23-5,0,0,0,0,NaN,NaN
16,0.950,Pigeon,16-23,52,123,0,175,29.714,29.714
16,0.950,Pigeon,23-5,109,115,0,224,48.661,48.661
16,0.950,Pacific Ocean Water,16-23,0,0,0,0,NaN,NaN
16,0.950,Pacific Ocean Water,23-5,0,0,0,0,NaN,NaN
16,0.950,Cat,16-23,13,18,0,31,41.935,41.935
16,0.950,Cat,23-5,10,15,0,25,40.000,40.000
16,0.950,Horse,16-23,4,9,0,13,30.769,30.769
16,0.950,Horse,23-5,13,38,0,51,25.490,25.490
16,0.950,orangutan,16-23,0,0,0,0,NaN,NaN
16,0.950,orangutan,23-5,0,0,0,0,NaN,NaN
16,0.950,Bat,16-23,36,37,0,73,49.315,49.315
16,0.950,Bat,23-5,37,40,0,77,48.052,48.052
16,0.950,Deer,16-23,10,23,0,33,30.303,30.303
16,0.950,Deer,23-5,14,129,0,143,9.790,9.790
16,0.950,Great Horned Owl,16-23,0,0,0,0,NaN,NaN
16,0.950,Great Horned Owl,23-5,0,0,0,0,NaN,NaN
16,0.950,Freshwater Lagoon,16-23,0,0,0,0,NaN,NaN
16,0.950,Freshwater Lagoon,23-5,0,0,0,0,NaN,NaN
16,0.950,Unknown Avian,16-23,0,0,0,0,NaN,NaN
16,0.950,Unknown Avian,23-5,0,0,0,0,NaN,NaN
16,0.950,Human UTI,16-23,68,67,0,135,50.370,50.370
16,0.950,Human UTI,23-5,93,123,0,216,43.056,43.056
16,0.950,unknown,16-23,0,0,0,0,NaN,NaN
16,0.950,unknown,23-5,0,2,0,2,0.000,0.000
16,0.950,SLO Creek Water,16-23,0,0,0,0,NaN,NaN
16,0.950,SLO Creek Water,23-5,0,0,0,0,NaN,NaN
16,0.950,Pig/Swine,16-23,2,2,0,4,50.000,50.000
16,0.950,Pig/Swine,23-5,8,7,0,15,53.333,53.333
16,0.950,Klebsiella,16-23,0,0,0,0,NaN,NaN
16,0.950,Klebsiella,23-5,0,0,0,0,NaN,NaN
16,0.950,Hu Cw and Dg,16-23,3,7,0,10,30.000,30.000
16,0.950,Hu Cw and Dg,23-5,3,5,0,8,37.500,37.500
16,0.950,Ground Squirrel,16-23,73,41,0,114,64.035,64.035
16,0.950,Ground Squirrel,23-5,76,59,0,135,56.296,56.296
16,0.950,Opossum,16-23,0,0,0,0,NaN,NaN
16,0.950,Opossum,23-5,0,0,0,0,NaN,NaN
16,0.950,Cow,16-23,1575,1233,0,2808,56.090,56.090
16,0.950,Cow,23-5,1530,1626,0,3156,48.479,48.479
16,0.950,Deer Mouse,16-23,0,0,0,0,NaN,NaN
16,0.950,Deer Mouse,23-5,0,0,0,0,NaN,NaN
16,0.950,OVERALL,16-23,3722,2605,0,6327,58.827,58.827
16,0.950,OVERALL,23-5,4359,3231,0,7590,57.431,57.431
16,0.960,Chicken,16-23,0,0,0,0,NaN,NaN
16,0.960,Chicken,23-5,4,2,0,6,66.667,66.667
16,0.960,Sea Lion,16-23,0,0,0,0,NaN,NaN
16,0.960,Sea Lion,23-5,0,6,0,6,0.000,0.000
16,0.960,Hu and Cw,16-23,0,4,0,4,0.000,0.000
16,0.960,Hu and Cw,23-5,10,7,0,17,58.824,58.824
16,0.960,Sheep,16-23,44,48,0,92,47.826,47.826
16,0.960,Sheep,23-5,53,40,0,93,56.989,56.989
16,0.960,Hu and Dg,16-23,7,6,0,13,53.846,53.846
16,0.960,Hu and Dg,23-5,18,24,0,42,42.857,42.857
16,0.960,Common Loon,16-23,0,0,0,0,NaN,NaN
16,0.960,Common Loon,23-5,0,0,0,0,NaN,NaN
16,0.960,Red-Winged Blackbird,16-23,0,0,0,0,NaN,NaN
16,0.960,Red-Winged Blackbird,23-5,0,0,0,0,NaN,NaN
16,0.960,Cw,16-23,4,6,0,10,40.000,40.000
16,0.960,Cw,23-5,6,13,0,19,31.579,31.579
16,0.960,Cliff Sparrow,16-23,0,5,0,5,0.000,0.000
16,0.960,Cliff Sparrow,23-5,0,0,0,0,NaN,NaN
16,0.960,Pig,16-23,2,3,0,5,40.000,40.000
16,0.960,Pig,23-5,0,0,0,0,NaN,NaN
16,0.960,Barn Owl,16-23,0,0,0,0,NaN,NaN
16,0.960,Barn Owl,23-5,0,0,0,0,NaN,NaN
16,0.960,Wild Pig,16-23,0,0,0,0,NaN,NaN
16,0.960,Wild Pig,23-5,1,0,0,1,100.000,100.000
16,0.960,Pennington Creek Water,16-23,0,0,0,0,NaN,NaN
16,0.960,Pennington Creek Water,23-5,0,0,0,0,NaN,NaN
16,0.960,Guinni,16-23,0,0,0,0,NaN,NaN
16,0.960,Guinni,23-5,0,0,0,0,NaN,NaN
16,0.960,Racoon,16-23,0,0,0,0,NaN,NaN
16,0.960,Racoon,23-5,0,0,0,0,NaN,NaN
16,0.960,Hu,16-23,8,6,0,14,57.143,57.143
16,0.960,Hu,23-5,22,21,0,43,51.163,51.163
16,0.960,Cw and Dg,16-23,4,13,0,17,23.529,23.529
16,0.960,Cw and Dg,23-5,14,19,0,33,42.424,42.424
16,0.960,Red Wind Blackbird,16-23,0,0,0,0,NaN,NaN
16,0.960,Red Wind Blackbird,23-5,0,0,0,0,NaN,NaN
16,0.960,Tree Swallow,16-23,0,0,0,0,NaN,NaN
16,0.960,Tree Swallow,23-5,0,0,0,0,NaN,NaN
16,0.960,Turkey Vulture,16-23,0,0,0,0,NaN,NaN
16,0.960,Turkey Vulture,23-5,0,0,0,0,NaN,NaN
16,0.960,Dg,16-23,5,11,0,16,31.250,31.250
16,0.960,Dg,23-5,31,36,0,67,46.269,46.269
16,0.960,Western Kingbird,16-23,0,0,0,0,NaN,NaN
16,0.960,Western Kingbird,23-5,0,0,0,0,NaN,NaN
16,0.960,White Crowned Sparrow,16-23,0,0,0,0,NaN,NaN
16,0.960,White Crowned Sparrow,23-5,0,1,0,1,0.000,0.000
16,0.960,Eared Grebe,16-23,0,0,0,0,NaN,NaN
16,0.960,Eared Grebe,23-5,0,6,0,6,0.000,0.000
16,0.960,cougar,16-23,0,0,0,0,NaN,NaN
16,0.960,cougar,23-5,0,0,0,0,NaN,NaN
16,0.960,Ocean Water,16-23,0,0,0,0,NaN,NaN
16,0.960,Ocean Water,23-5,0,0,0,0,NaN,NaN
16,0.960,Red Tailed Hawk,16-23,0,0,0,0,NaN,NaN
16,0.960,Red Tailed Hawk,23-5,0,0,0,0,NaN,NaN
16,0.960,Dog,16-23,52,70,0,122,42.623,42.623
16,0.960,Dog,23-5,87,134,0,221,39.367,39.367
16,0.960,Human,16-23,1762,871,0,2633,66.920,66.920
16,0.960,Human,23-5,2178,733,0,2911,74.820,74.820
16,0.960,Wild Turkey,16-23,0,1,0,1,0.000,0.000
16,0.960,Wild Turkey,23-5,1,8,0,9,11.111,11.111
16,0.960,Clark Grebe,16-23,0,0,0,0,NaN,NaN
16,0.960,Clark Grebe,23-5,0,0,0,0,NaN,NaN
16,0.960,Seagull,16-23,0,0,0,0,NaN,NaN
16,0.960,Seagull,23-5,44,8,0,52,84.615,84.615
16,0.960,Surf Scoter,16-23,0,0,0,0,NaN,NaN
16,0.960,Surf Scoter,23-5,0,2,0,2,0.000,0.000
16,0.960,Pigeon,16-23,52,123,0,175,29.714,29.714
16,0.960,Pigeon,23-5,110,131,0,241,45.643,45.643
16,0.960,Pacific Ocean Water,16-23,0,0,0,0,NaN,NaN
16,0.960,Pacific Ocean Water,23-5,0,0,0,0,NaN,NaN
16,0.960,Cat,16-23,13,18,0,31,41.935,41.935
16,0.960,Cat,23-5,10,16,0,26,38.462,38.462
16,0.960,Horse,16-23,4,9,0,13,30.769,30.769
16,0.960,Horse,23-5,13,38,0,51,25.490,25.490
16,0.960,orangutan,16-23,0,0,0,0,NaN,NaN
16,0.960,orangutan,23-5,0,0,0,0,NaN,NaN
16,0.960,Bat,16-23,36,37,0,73,49.315,49.315
16,0.960,Bat,23-5,37,40,0,77,48.052,48.052
16,0.960,Deer,16-23,10,23,0,33,30.303,30.303
16,0.960,Deer,23-5,14,129,0,143,9.790,9.790
16,0.960,Great Horned Owl,16-23,0,0,0,0,NaN,NaN
16,0.960,Great Horned Owl,23-5,0,0,0,0,NaN,NaN
16,0.960,Freshwater Lagoon,16-23,0,0,0,0,NaN,NaN
16,0.960,Freshwater Lagoon,23-5,0,0,0,0,NaN,NaN
16,0.960,Unknown Avian,16-23,0,0,0,0,NaN,NaN
16,0.960,Unknown Avian,23-5,0,0,0,0,NaN,NaN
16,0.960,Human UTI,16-23,68,68,0,136,50.000,50.000
16,0.960,Human UTI,23-5,93,122,0,215,43.256,43.256
16,0.960,unknown,16-23,0,0,0,0,NaN,NaN
16,0.960,unknown,23-5,0,2,0,2,0.000,0.000
16,0.960,SLO Creek Water,16-23,0,0,0,0,NaN,NaN
16,0.960,SLO Creek Water,23-5,0,0,0,0,NaN,NaN
16,0.960,Pig/Swine,16-23,2,2,0,4,50.000,50.000
16,0.960,Pig/Swine,23-5,8,7,0,15,53.333,53.333
16,0.960,Klebsiella,16-23,0,0,0,0,NaN,NaN
16,0.960,Klebsiella,23-5,0,0,0,0,NaN,NaN
16,0.960,Hu Cw and Dg,16-23,3,7,0,10,30.000,30.000
16,0.960,Hu Cw and Dg,23-5,3,5,0,8,37.500,37.500
16,0.960,Ground Squirrel,16-23,73,41,0,114,64.035,64.035
16,0.960,Ground Squirrel,23-5,76,61,0,137,55.474,55.474
16,0.960,Opossum,16-23,0,0,0,0,NaN,NaN
16,0.960,Opossum,23-5,0,0,0,0,NaN,NaN
16,0.960,Cow,16-23,1573,1222,0,2795,56.279,56.279
16,0.960,Cow,23-5,1530,1606,0,3136,48.788,48.788
16,0.960,Deer Mouse,16-23,0,0,0,0,NaN,NaN
16,0.960,Deer Mouse,23-5,0,0,0,0,NaN,NaN
16,0.960,OVERALL,16-23,3722,2594,0,6316,58.930,58.930
16,0.960,OVERALL,23-5,4363,3217,0,7580,57.559,57.559
16,0.970,Chicken,16-23,0,0,0,0,NaN,NaN
16,0.970,Chicken,23-5,4,2,0,6,66.667,66.667
16,0.970,Sea Lion,16-23,0,0,0,0,NaN,NaN
16,0.970,Sea Lion,23-5,0,8,0,8,0.000,0.000
16,0.970,Hu and Cw,16-23,0,4,0,4,0.000,0.000
16,0.970,Hu and Cw,23-5,10,7,0,17,58.824,58.824
16,0.970,Sheep,16-23,45,49,0,94,47.872,47.872
16,0.970,Sheep,23-5,53,39,0,92,57.609,57.609
16,0.970,Hu and Dg,16-23,7,6,0,13,53.846,53.846
16,0.970,Hu and Dg,23-5,18,24,0,42,42.857,42.857
16,0.970,Common Loon,16-23,0,0,0,0,NaN,NaN
16,0.970,Common Loon,23-5,0,0,0,0,NaN,NaN
16,0.970,Red-Winged Blackbird,16-23,0,0,0,0,NaN,NaN
16,0.970,Red-Winged Blackbird,23-5,0,0,0,0,NaN,NaN
16,0.970,Cw,16-23,4,7,0,11,36.364,36.364
16,0.970,Cw,23-5,6,13,0,19,31.579,31.579
16,0.970,Cliff Sparrow,16-23,0,5,0,5,0.000,0.000
16,0.970,Cliff Sparrow,23-5,0,0,0,0,NaN,NaN
16,0.970,Pig,16-23,2,3,0,5,40.000,40.000
16,0.970,Pig,23-5,0,0,0,0,NaN,NaN
16,0.970,Barn Owl,16-23,0,0,0,0,NaN,NaN
16,0.970,Barn Owl,23-5,0,0,0,0,NaN,NaN
16,0.970,Wild Pig,16-23,0,0,0,0,NaN,NaN
16,0.970,Wild Pig,23-5,0,0,0,0,NaN,NaN
16,0.970,Pennington Creek Water,16-23,0,0,0,0,NaN,NaN
16,0.970,Pennington Creek Water,23-5,0,0,0,0,NaN,NaN
16,0.970,Guinni,16-23,0,0,0,0,NaN,NaN
16,0.970,Guinni,23-5,0,0,0,0,NaN,NaN
16,0.970,Racoon,16-23,0,0,0,0,NaN,NaN
16,0.970,Racoon,23-5,0,0,0,0,NaN,NaN
16,0.970,Hu,16-23,8,6,0,14,57.143,57.143
16,0.970,Hu,23-5,22,21,0,43,51.163,51.163
16,0.970,Cw and Dg,16-23,4,13,0,17,23.529,23.529
16,0.970,Cw and Dg,23-5,14,19,0,33,42.424,42.424
16,0.970,Red Wind Blackbird,16-23,0,0,0,0,NaN,NaN
16,0.970,Red Wind Blackbird,23-5,0,0,0,0,NaN,NaN
16,0.970,Tree Swallow,16-23,0,0,0,0,NaN,NaN
16,0.970,Tree Swallow,23-5,0,0,0,0,NaN,NaN
16,0.970,Turkey Vulture,16-23,0,0,0,0,NaN,NaN
16,0.970,Turkey Vulture,23-5,0,0,0,0,NaN,NaN
16,0.970,Dg,16-23,5,11,0,16,31.250,31.250
16,0.970,Dg,23-5,31,34,0,65,47.692,47.692
16,0.970,Western Kingbird,16-23,0,0,0,0,NaN,NaN
16,0.970,Western Kingbird,23-5,0,0,0,0,NaN,NaN
16,0.970,White Crowned Sparrow,16-23,0,0,0,0,NaN,NaN
16,0.970,White Crowned Sparrow,23-5,0,1,0,1,0.000,0.000
16,0.970,Eared Grebe,16-23,0,0,0,0,NaN,NaN
16,0.970,Eared Grebe,23-5,0,6,0,6,0.000,0.000
16,0.970,cougar,16-23,0,0,0,0,NaN,NaN
16,0.970,cougar,23-5,0,0,0,0,NaN,NaN
16,0.970,Ocean Water,16-23,0,0,0,0,NaN,NaN
16,0.970,Ocean Water,23-5,0,0,0,0,NaN,NaN
16,0.970,Red Tailed Hawk,16-23,0,0,0,0,NaN,NaN
16,0.970,Red Tailed Hawk,23-5,0,0,0,0,NaN,NaN
16,0.970,Dog,16-23,52,70,0,122,42.623,42.623
16,0.970,Dog,23-5,87,133,0,220,39.545,39.545
16,0.970,Human,16-23,1761,868,0,2629,66.984,66.984
16,0.970,Human,23-5,2177,730,0,2907,74.888,74.888
16,0.970,Wild Turkey,16-23,0,3,0,3,0.000,0.000
16,0.970,Wild Turkey,23-5,3,7,0,10,30.000,30.000
16,0.970,Clark Grebe,16-23,0,0,0,0,NaN,NaN
16,0.970,Clark Grebe,23-5,0,0,0,0,NaN,NaN
16,0.970,Seagull,16-23,0,0,0,0,NaN,NaN
16,0.970,Seagull,23-5,44,9,0,53,83.019,83.019
16,0.970,Surf Scoter,16-23,0,0,0,0,NaN,NaN
16,0.970,Surf Scoter,23-5,0,2,0,2,0.000,0.000
16,0.970,Pigeon,16-23,51,122,0,173,29.480,29.480
16,0.970,Pigeon,23-5,110,147,0,257,42.802,42.802
16,0.970,Pacific Ocean Water,16-23,0,0,0,0,NaN,NaN
16,0.970,Pacific Ocean Water,23-5,0,0,0,0,NaN,NaN
16,0.970,Cat,16-23,13,18,0,31,41.935,41.935
16,0.970,Cat,23-5,10,16,0,26,38.462,38.462
16,0.970,Horse,16-23,4,9,0,13,30.769,30.769
16,0.970,Horse,23-5,13,39,0,52,25.000,25.000
16,0.970,orangutan,16-23,0,0,0,0,NaN,NaN
16,0.970,orangutan,23-5,0,0,0,0,NaN,NaN
16,0.970,Bat,16-23,36,37,0,73,49.315,49.315
16,0.970,Bat,23-5,37,40,0,77,48.052,48.052
16,0.970,Deer,16-23,10,23,0,33,30.303,30.303
16,0.970,Deer,23-5,14,129,0,143,9.790,9.790
16,0.970,Great Horned Owl,16-23,0,0,0,0,NaN,NaN
16,0.970,Great Horned Owl,23-5,0,0,0,0,NaN,NaN
16,0.970,Freshwater Lagoon,16-23,0,0,0,0,NaN,NaN
16,0.970,Freshwater Lagoon,23-5,0,0,0,0,NaN,NaN
16,0.970,Unknown Avian,16-23,0,0,0,0,NaN,NaN
16,0.970,Unknown Avian,23-5,0,0,0,0,NaN,NaN
16,0.970,Human UTI,16-23,68,69,0,137,49.635,49.635
16,0.970,Human UTI,23-5,92,122,0,214,42.991,42.991
16,0.970,unknown,16-23,0,0,0,0,NaN,NaN
16,0.970,unknown,23-5,0,2,0,2,0.000,0.000
16,0.970,SLO Creek Water,16-23,0,0,0,0,NaN,NaN
16,0.970,SLO Creek Water,23-5,0,0,0,0,NaN,NaN
16,0.970,Pig/Swine,16-23,2,2,0,4,50.000,50.000
16,0.970,Pig/Swine,23-5,8,7,0,15,53.333,53.333
16,0.970,Klebsiella,16-23,0,0,0,0,NaN,NaN
16,0.970,Klebsiella,23-5,0,0,0,0,NaN,NaN
16,0.970,Hu Cw and Dg,16-23,3,7,0,10,30.000,30.000
16,0.970,Hu Cw and Dg,23-5,3,5,0,8,37.500,37.500
16,0.970,Ground Squirrel,16-23,73,40,0,113,64.602,64.602
16,0.970,Ground Squirrel,23-5,76,59,0,135,56.296,56.296
16,0.970,Opossum,16-23,0,0,0,0,NaN,NaN
16,0.970,Opossum,23-5,0,0,0,0,NaN,NaN
16,0.970,Cow,16-23,1567,1219,0,2786,56.246,56.246
16,0.970,Cow,23-5,1528,1580,0,3108,49.163,49.163
16,0.970,Deer Mouse,16-23,0,0,0,0,NaN,NaN
16,0.970,Deer Mouse,23-5,0,0,0,0,NaN,NaN
16,0.970,OVERALL,16-23,3715,2591,0,6306,58.912,58.912
16,0.970,OVERALL,23-5,4360,3201,0,7561,57.664,57.664
16,0.980,Chicken,16-23,0,0,0,0,NaN,NaN
16,0.980,Chicken,23-5,5,2,0,7,71.429,71.429
16,0.980,Sea Lion,16-23,0,0,0,0,NaN,NaN
16,0.980,Sea Lion,23-5,0,9,0,9,0.000,0.000
16,0.980,Hu and Cw,16-23,0,4,0,4,0.000,0.000
16,0.980,Hu and Cw,23-5,10,17,0,27,37.037,37.037
16,0.980,Sheep,16-23,48,46,0,94,51.064,51.064
16,0.980,Sheep,23-5,52,38,0,90,57.778,57.778
16,0.980,Hu and Dg,16-23,7,6,0,13,53.846,53.846
16,0.980,Hu and Dg,23-5,18,22,0,40,45.000,45.000
16,0.980,Common Loon,16-23,0,0,0,0,NaN,NaN
16,0.980,Common Loon,23-5,0,0,0,0,NaN,NaN
16,0.980,Red-Winged Blackbird,16-23,0,0,0,0,NaN,NaN
16,0.980,Red-Winged Blackbird,23-5,0,0,0,0,NaN,NaN
16,0.980,Cw,16-23,4,6,0,10,40.000,40.000
16,0.980,Cw,23-5,6,15,0,21,28.571,28.571
16,0.980,Cliff Sparrow,16-23,0,5,0,5,0.000,0.000
16,0.980,Cliff Sparrow,23-5,0,0,0,0,NaN,NaN
16,0.980,Pig,16-23,2,3,0,5,40.000,40.000
16,0.980,Pig,23-5,0,0,0,0,NaN,NaN
16,0.980,Barn Owl,16-23,0,0,0,0,NaN,NaN
16,0.980,Barn Owl,23-5,0,0,0,0,NaN,NaN
16,0.980,Wild Pig,16-23,0,0,0,0,NaN,NaN
16,0.980,Wild Pig,23-5,0,0,0,0,NaN,NaN
16,0.980,Pennington Creek Water,16-23,0,0,0,0,NaN,NaN
16,0.980,Pennington Creek Water,23-5,0,0,0,0,NaN,NaN
16,0.980,Guinni,16-23,0,0,0,0,NaN,NaN
16,0.980,Guinni,23-5,0,0,0,0,NaN,NaN
16,0.980,Racoon,16-23,0,0,0,0,NaN,NaN
16,0.980,Racoon,23-5,0,0,0,0,NaN,NaN
16,0.980,Hu,16-23,8,6,0,14,57.143,57.143
16,0.980,Hu,23-5,22,22,0,44,50.000,50.000
16,0.980,Cw and Dg,16-23,4,13,0,17,23.529,23.529
16,0.980,Cw and Dg,23-5,14,21,0,35,40.000,40.000
16,0.980,Red Wind Blackbird,16-23,0,0,0,0,NaN,NaN
16,0.980,Red Wind Blackbird,23-5,0,0,0,0,NaN,NaN
16,0.980,Tree Swallow,16-23,0,0,0,0,NaN,NaN
16,0.980,Tree Swallow,23-5,0,0,0,0,NaN,NaN
16,0.980,Turkey Vulture,16-23,0,0,0,0,NaN,NaN
16,0.980,Turkey Vulture,23-5,0,0,0,0,NaN,NaN
16,0.980,Dg,16-23,5,11,0,16,31.250,31.250
16,0.980,Dg,23-5,31,26,0,57,54.386,54.386
16,0.980,Western Kingbird,16-23,0,0,0,0,NaN,NaN
16,0.980,Western Kingbird,23-5,0,0,0,0,NaN,NaN
16,0.980,White Crowned Sparrow,16-23,0,0,0,0,NaN,NaN
16,0.980,White Crowned Sparrow,23-5,0,3,0,3,0.000,0.000
16,0.980,Eared Grebe,16-23,0,0,0,0,NaN,NaN
16,0.980,Eared Grebe,23-5,0,6,0,6,0.000,0.000
16,0.980,cougar,16-23,0,0,0,0,NaN,NaN
16,0.980,cougar,23-5,0,0,0,0,NaN,NaN
16,0.980,Ocean Water,16-23,0,0,0,0,NaN,NaN
16,0.980,Ocean Water,23-5,0,0,0,0,NaN,NaN
16,0.980,Red Tailed Hawk,16-23,0,0,0,0,NaN,NaN
16,0.980,Red Tailed Hawk,23-5,0,0,0,0,NaN,NaN
16,0.980,Dog,16-23,51,75,0,126,40.476,40.476
16,0.980,Dog,23-5,87,127,0,214,40.654,40.654
16,0.980,Human,16-23,1764,852,0,2616,67.431,67.431
16,0.980,Human,23-5,2179,712,0,2891,75.372,75.372
16,0.980,Wild Turkey,16-23,1,3,0,4,25.000,25.000
16,0.980,Wild Turkey,23-5,5,17,0,22,22.727,22.727
16,0.980,Clark Grebe,16-23,0,0,0,0,NaN,NaN
16,0.980,Clark Grebe,23-5,0,0,0,0,NaN,NaN
16,0.980,Seagull,16-23,0,0,0,0,NaN,NaN
16,0.980,Seagull,23-5,46,7,0,53,86.792,86.792
16,0.980,Surf Scoter,16-23,0,0,0,0,NaN,NaN
16,0.980,Surf Scoter,23-5,2,0,0,2,100.000,100.000
16,0.980,Pigeon,16-23,52,123,0,175,29.714,29.714
16,0.980,Pigeon,23-5,109,157,0,266,40.977,40.977
16,0.980,Pacific Ocean Water,16-23,0,0,0,0,NaN,NaN
16,0.980,Pacific Ocean Water,23-5,0,0,0,0,NaN,NaN
16,0.980,Cat,16-23,13,18,0,31,41.935,41.935
16,0.980,Cat,23-5,12,14,0,26,46.154,46.154
16,0.980,Horse,16-23,4,9,0,13,30.769,30.769
16,0.980,Horse,23-5,13,37,0,50,26.000,26.000
16,0.980,orangutan,16-23,0,0,0,0,NaN,NaN
16,0.980,orangutan,23-5,0,0,0,0,NaN,NaN
16,0.980,Bat,16-23,36,36,0,72,50.000,50.000
16,0.980,Bat,23-5,37,40,0,77,48.052,48.052
16,0.980,Deer,16-23,10,23,0,33,30.303,30.303
16,0.980,Deer,23-5,14,129,0,143,9.790,9.790
16,0.980,Great Horned Owl,16-23,0,0,0,0,NaN,NaN
16,0.980,Great Horned Owl,23-5,0,0,0,0,NaN,NaN
16,0.980,Freshwater Lagoon,16-23,0,0,0,0,NaN,NaN
16,0.980,Freshwater Lagoon,23-5,0,0,0,0,NaN,NaN
16,0.980,Unknown Avian,16-23,0,0,0,0,NaN,NaN
16,0.980,Unknown Avian,23-5,0,0,0,0,NaN,NaN
16,0.980,Human UTI,16-23,69,71,0,140,49.286,49.286
16,0.980,Human UTI,23-5,93,121,0,214,43.458,43.458
16,0.980,unknown,16-23,0,0,0,0,NaN,NaN
16,0.980,unknown,23-5,0,3,0,3,0.000,0.000
16,0.980,SLO Creek Water,16-23,0,0,0,0,NaN,NaN
16,0.980,SLO Creek Water,23-5,0,0,0,0,NaN,NaN
16,0.980,Pig/Swine,16-23,2,2,0,4,50.000,50.000
16,0.980,Pig/Swine,23-5,8,7,0,15,53.333,53.333
16,0.980,Klebsiella,16-23,0,0,0,0,NaN,NaN
16,0.980,Klebsiella,23-5,0,0,0,0,NaN,NaN
16,0.980,Hu Cw and Dg,16-23,3,7,0,10,30.000,30.000
16,0.980,Hu Cw and Dg,23-5,3,4,0,7,42.857,42.857
16,0.980,Ground Squirrel,16-23,76,41,0,117,64.957,64.957
16,0.980,Ground Squirrel,23-5,77,58,0,135,57.037,57.037
16,0.980,Opossum,16-23,0,0,0,0,NaN,NaN
16,0.980,Opossum,23-5,0,0,0,0,NaN,NaN
16,0.980,Cow,16-23,1559,1200,0,2759,56.506,56.506
16,0.980,Cow,23-5,1521,1544,0,3065,49.625,49.625
16,0.980,Deer Mouse,16-23,0,0,0,0,NaN,NaN
16,0.980,Deer Mouse,23-5,0,0,0,0,NaN,NaN
16,0.980,OVERALL,16-23,3718,2560,0,6278,59.223,59.223
16,0.980,OVERALL,23-5,4364,3158,0,7522,58.016,58.016
16,0.990,Chicken,16-23,2,5,0,7,28.571,28.571
16,0.990,Chicken,23-5,6,2,0,8,75.000,75.000
16,0.990,Sea Lion,16-23,0,0,0,0,NaN,NaN
16,0.990,Sea Lion,23-5,4,6,0,10,40.000,40.000
16,0.990,Hu and Cw,16-23,1,4,0,5,20.000,20.000
16,0.990,Hu and Cw,23-5,11,24,0,35,31.429,31.429
16,0.990,Sheep,16-23,47,47,0,94,50.000,50.000
16,0.990,Sheep,23-5,53,38,0,91,58.242,58.242
16,0.990,Hu and Dg,16-23,7,8,0,15,46.667,46.667
16,0.990,Hu and Dg,23-5,18,20,0,38,47.368,47.368
16,0.990,Common Loon,16-23,0,0,0,0,NaN,NaN
16,0.990,Common Loon,23-5,0,2,0,2,0.000,0.000
16,0.990,Red-Winged Blackbird,16-23,0,2,0,2,0.000,0.000
16,0.990,Red-Winged Blackbird,23-5,0,0,0,0,NaN,NaN
16,0.990,Cw,16-23,5,6,0,11,45.455,45.455
16,0.990,Cw,23-5,12,18,0,30,40.000,40.000
16,0.990,Cliff Sparrow,16-23,0,7,0,7,0.000,0.000
16,0.990,Cliff Sparrow,23-5,0,4,0,4,0.000,0.000
16,0.990,Pig,16-23,2,4,0,6,33.333,33.333
16,0.990,Pig,23-5,7,6,0,13,53.846,53.846
16,0.990,Barn Owl,16-23,0,0,0,0,NaN,NaN
16,0.990,Barn Owl,23-5,0,0,0,0,NaN,NaN
16,0.990,Wild Pig,16-23,0,1,0,1,0.000,0.000
16,0.990,Wild Pig,23-5,0,1,0,1,0.000,0.000
16,0.990,Pennington Creek Water,16-23,0,0,0,0,NaN,NaN
16,0.990,Pennington Creek Water,23-5,0,0,0,0,NaN,NaN
16,0.990,Guinni,16-23,0,0,0,0,NaN,NaN
16,0.990,Guinni,23-5,0,0,0,0,NaN,NaN
16,0.990,Racoon,16-23,0,0,0,0,NaN,NaN
16,0.990,Racoon,23-5,0,1,0,1,0.000,0.000
16,0.990,Hu,16-23,8,6,0,14,57.143,57.143
16,0.990,Hu,23-5,22,16,0,38,57.895,57.895
16,0.990,Cw and Dg,16-23,4,13,0,17,23.529,23.529
16,0.990,Cw and Dg,23-5,15,14,0,29,51.724,51.724
16,0.990,Red Wind Blackbird,16-23,0,0,0,0,NaN,NaN
16,0.990,Red Wind Blackbird,23-5,0,0,0,0,NaN,NaN
16,0.990,Tree Swallow,16-23,0,0,0,0,NaN,NaN
16,0.990,Tree Swallow,23-5,0,0,0,0,NaN,NaN
16,0.990,Turkey Vulture,16-23,0,0,0,0,NaN,NaN
16,0.990,Turkey Vulture,23-5,0,0,0,0,NaN,NaN
16,0.990,Dg,16-23,5,11,0,16,31.250,31.250
16,0.990,Dg,23-5,31,20,0,51,60.784,60.784
16,0.990,Western Kingbird,16-23,0,0,0,0,NaN,NaN
16,0.990,Western Kingbird,23-5,0,0,0,0,NaN,NaN
16,0.990,White Crowned Sparrow,16-23,0,0,0,0,NaN,NaN
16,0.990,White Crowned Sparrow,23-5,0,4,0,4,0.000,0.000
16,0.990,Eared Grebe,16-23,0,0,0,0,NaN,NaN
16,0.990,Eared Grebe,23-5,0,8,0,8,0.000,0.000
16,0.990,cougar,16-23,0,1,0,1,0.000,0.000
16,0.990,cougar,23-5,0,0,0,0,NaN,NaN
16,0.990,Ocean Water,16-23,0,0,0,0,NaN,NaN
16,0.990,Ocean Water,23-5,0,0,0,0,NaN,NaN
16,0.990,Red Tailed Hawk,16-23,0,0,0,0,NaN,NaN
16,0.990,Red Tailed Hawk,23-5,0,1,0,1,0.000,0.000
16,0.990,Dog,16-23,54,72,0,126,42.857,42.857
16,0.990,Dog,23-5,91,122,0,213,42.723,42.723
16,0.990,Human,16-23,1754,813,0,2567,68.329,68.329
16,0.990,Human,23-5,2174,643,0,2817,77.174,77.174
16,0.990,Wild Turkey,16-23,3,9,0,12,25.000,25.000
16,0.990,Wild Turkey,23-5,5,18,0,23,21.739,21.739
16,0.990,Clark Grebe,16-23,0,0,0,0,NaN,NaN
16,0.990,Clark Grebe,23-5,2,3,0,5,40.000,40.000
16,0.990,Seagull,16-23,0,0,0,0,NaN,NaN
16,0.990,Seagull,23-5,48,6,0,54,88.889,88.889
16,0.990,Surf Scoter,16-23,0,0,0,0,NaN,NaN
16,0.990,Surf Scoter,23-5,2,0,0,2,100.000,100.000
16,0.990,Pigeon,16-23,63,121,0,184,34.239,34.239
16,0.990,Pigeon,23-5,119,177,0,296,40.203,40.203
16,0.990,Pacific Ocean Water,16-23,0,0,0,0,NaN,NaN
16,0.990,Pacific Ocean Water,23-5,0,0,0,0,NaN,NaN
16,0.990,Cat,16-23,19,21,0,40,47.500,47.500
16,0.990,Cat,23-5,13,19,0,32,40.625,40.625
16,0.990,Horse,16-23,7,10,0,17,41.176,41.176
16,0.990,Horse,23-5,15,58,0,73,20.548,20.548
16,0.990,orangutan,16-23,0,0,0,0,NaN,NaN
16,0.990,orangutan,23-5,0,0,0,0,NaN,NaN
16,0.990,Bat,16-23,36,33,0,69,52.174,52.174
16,0.990,Bat,23-5,37,38,0,75,49.333,49.333
16,0.990,Deer,16-23,10,24,0,34,29.412,29.412
16,0.990,Deer,23-5,14,116,0,130,10.769,10.769
16,0.990,Great Horned Owl,16-23,0,0,0,0,NaN,NaN
16,0.990,Great Horned Owl,23-5,0,0,0,0,NaN,NaN
16,0.990,Freshwater Lagoon,16-23,0,0,0,0,NaN,NaN
16,0.990,Freshwater Lagoon,23-5,0,0,0,0,NaN,NaN
16,0.990,Unknown Avian,16-23,0,0,0,0,NaN,NaN
16,0.990,Unknown Avian,23-5,0,0,0,0,NaN,NaN
16,0.990,Human UTI,16-23,72,58,0,130,55.385,55.385
16,0.990,Human UTI,23-5,95,98,0,193,49.223,49.223
16,0.990,unknown,16-23,0,0,0,0,NaN,NaN
16,0.990,unknown,23-5,0,5,0,5,0.000,0.000
16,0.990,SLO Creek Water,16-23,0,0,0,0,NaN,NaN
16,0.990,SLO Creek Water,23-5,0,0,0,0,NaN,NaN
16,0.990,Pig/Swine,16-23,3,3,0,6,50.000,50.000
16,0.990,Pig/Swine,23-5,8,7,0,15,53.333,53.333
16,0.990,Klebsiella,16-23,0,0,0,0,NaN,NaN
16,0.990,Klebsiella,23-5,0,0,0,0,NaN,NaN
16,0.990,Hu Cw and Dg,16-23,3,7,0,10,30.000,30.000
16,0.990,Hu Cw and Dg,23-5,3,6,0,9,33.333,33.333
16,0.990,Ground Squirrel,16-23,79,42,0,121,65.289,65.289
16,0.990,Ground Squirrel,23-5,79,63,0,142,55.634,55.634
16,0.990,Opossum,16-23,1,0,0,1,100.000,100.000
16,0.990,Opossum,23-5,2,0,0,2,100.000,100.000
16,0.990,Cow,16-23,1525,1087,0,2612,58.384,58.384
16,0.990,Cow,23-5,1481,1395,0,2876,51.495,51.495
16,0.990,Deer Mouse,16-23,0,0,0,0,NaN,NaN
16,0.990,Deer Mouse,23-5,0,0,0,0,NaN,NaN
16,0.990,OVERALL,16-23,3710,2415,0,6125,60.571,60.571
16,0.990,OVERALL,23-5,4367,2959,0,7326,59.610,59.610
16,1.000,Chicken,16-23,0,0,0,0,NaN,NaN
16,1.000,Chicken,23-5,0,0,0,0,NaN,NaN
16,1.000,Sea Lion,16-23,0,0,0,0,NaN,NaN
16,1.000,Sea Lion,23-5,0,0,0,0,NaN,NaN
16,1.000,Hu and Cw,16-23,0,0,0,0,NaN,NaN
16,1.000,Hu and Cw,23-5,0,0,0,0,NaN,NaN
16,1.000,Sheep,16-23,0,0,0,0,NaN,NaN
16,1.000,Sheep,23-5,0,0,0,0,NaN,NaN
16,1.000,Hu and Dg,16-23,0,0,0,0,NaN,NaN
16,1.000,Hu and Dg,23-5,0,0,0,0,NaN,NaN
16,1.000,Common Loon,16-23,0,0,0,0,NaN,NaN
16,1.000,Common Loon,23-5,0,0,0,0,NaN,NaN
16,1.000,Red-Winged Blackbird,16-23,0,0,0,0,NaN,NaN
16,1.000,Red-Winged Blackbird,23-5,0,0,0,0,NaN,NaN
16,1.000,Cw,16-23,0,0,0,0,NaN,NaN
16,1.000,Cw,23-5,0,0,0,0,NaN,NaN
16,1.000,Cliff Sparrow,16-23,0,0,0,0,NaN,NaN
16,1.000,Cliff Sparrow,23-5,0,0,0,0,NaN,NaN
16,1.000,Pig,16-23,0,0,0,0,NaN,NaN
16,1.000,Pig,23-5,0,0,0,0,NaN,NaN
16,1.000,Barn Owl,16-23,0,0,0,0,NaN,NaN
16,1.000,Barn Owl,23-5,0,0,0,0,NaN,NaN
16,1.000,Wild Pig,16-23,0,0,0,0,NaN,NaN
16,1.000,Wild Pig,23-5,0,0,0,0,NaN,NaN
16,1.000,Pennington Creek Water,16-23,0,0,0,0,NaN,NaN
16,1.000,Pennington Creek Water,23-5,0,0,0,0,NaN,NaN
16,1.000,Guinni,16-23,0,0,0,0,NaN,NaN
16,1.000,Guinni,23-5,0,0,0,0,NaN,NaN
16,1.000,Racoon,16-23,0,0,0,0,NaN,NaN
16,1.000,Racoon,23-5,0,0,0,0,NaN,NaN
16,1.000,Hu,16-23,0,0,0,0,NaN,NaN
16,1.000,Hu,23-5,0,0,0,0,NaN,NaN
16,1.000,Cw and Dg,16-23,0,0,0,0,NaN,NaN
16,1.000,Cw and Dg,23-5,0,0,0,0,NaN,NaN
16,1.000,Red Wind Blackbird,16-23,0,0,0,0,NaN,NaN
16,1.000,Red Wind Blackbird,23-5,0,0,0,0,NaN,NaN
16,1.000,Tree Swallow,16-23,0,0,0,0,NaN,NaN
16,1.000,Tree Swallow,23-5,0,0,0,0,NaN,NaN
16,1.000,Turkey Vulture,16-23,0,0,0,0,NaN,NaN
16,1.000,Turkey Vulture,23-5,0,0,0,0,NaN,NaN
16,1.000,Dg,16-23,0,0,0,0,NaN,NaN
16,1.000,Dg,23-5,0,0,0,0,NaN,NaN
16,1.000,Western Kingbird,16-23,0,0,0,0,NaN,NaN
16,1.000,Western Kingbird,23-5,0,0,0,0,NaN,NaN
16,1.000,White Crowned Sparrow,16-23,0,0,0,0,NaN,NaN
16,1.000,White Crowned Sparrow,23-5,0,0,0,0,NaN,NaN
16,1.000,Eared Grebe,16-23,0,0,0,0,NaN,NaN
16,1.000,Eared Grebe,23-5,0,0,0,0,NaN,NaN
16,1.000,cougar,16-23,0,0,0,0,NaN,NaN
16,1.000,cougar,23-5,0,0,0,0,NaN,NaN
16,1.000,Ocean Water,16-23,0,0,0,0,NaN,NaN
16,1.000,Ocean Water,23-5,0,0,0,0,NaN,NaN
16,1.000,Red Tailed Hawk,16-23,0,0,0,0,NaN,NaN
16,1.000,Red Tailed Hawk,23-5,0,0,0,0,NaN,NaN
16,1.000,Dog,16-23,0,0,0,0,NaN,NaN
16,1.000,Dog,23-5,0,0,0,0,NaN,NaN
16,1.000,Human,16-23,68,0,0,68,100.000,100.000
16,1.000,Human,23-5,90,0,0,90,100.000,100.000
16,1.000,Wild Turkey,16-23,0,0,0,0,NaN,NaN
16,1.000,Wild Turkey,23-5,0,0,0,0,NaN,NaN
16,1.000,Clark Grebe,16-23,0,0,0,0,NaN,NaN
16,1.000,Clark Grebe,23-5,0,0,0,0,NaN,NaN
16,1.000,Seagull,16-23,0,0,0,0,NaN,NaN
16,1.000,Seagull,23-5,0,0,0,0,NaN,NaN
16,1.000,Surf Scoter,16-23,0,0,0,0,NaN,NaN
16,1.000,Surf Scoter,23-5,0,0,0,0,NaN,NaN
16,1.000,Pigeon,16-23,0,0,0,0,NaN,NaN
16,1.000,Pigeon,23-5,0,0,0,0,NaN,NaN
16,1.000,Pacific Ocean Water,16-23,0,0,0,0,NaN,NaN
16,1.000,Pacific Ocean Water,23-5,0,0,0,0,NaN,NaN
16,1.000,Cat,16-23,0,0,0,0,NaN,NaN
16,1.000,Cat,23-5,0,0,0,0,NaN,NaN
16,1.000,Horse,16-23,0,0,0,0,NaN,NaN
16,1.000,Horse,23-5,0,0,0,0,NaN,NaN
16,1.000,orangutan,16-23,0,0,0,0,NaN,NaN
16,1.000,orangutan,23-5,0,0,0,0,NaN,NaN
16,1.000,Bat,16-23,0,0,0,0,NaN,NaN
16,1.000,Bat,23-5,0,0,0,0,NaN,NaN
16,1.000,Deer,16-23,0,0,0,0,NaN,NaN
16,1.000,Deer,23-5,0,0,0,0,NaN,NaN
16,1.000,Great Horned Owl,16-23,0,0,0,0,NaN,NaN
16,1.000,Great Horned Owl,23-5,0,0,0,0,NaN,NaN
16,1.000,Freshwater Lagoon,16-23,0,0,0,0,NaN,NaN
16,1.000,Freshwater Lagoon,23-5,0,0,0,0,NaN,NaN
16,1.000,Unknown Avian,16-23,0,0,0,0,NaN,NaN
16,1.000,Unknown Avian,23-5,0,0,0,0,NaN,NaN
16,1.000,Human UTI,16-23,0,0,0,0,NaN,NaN
16,1.000,Human UTI,23-5,0,0,0,0,NaN,NaN
16,1.000,unknown,16-23,0,0,0,0,NaN,NaN
16,1.000,unknown,23-5,0,0,0,0,NaN,NaN
16,1.000,SLO Creek Water,16-23,0,0,0,0,NaN,NaN
16,1.000,SLO Creek Water,23-5,0,0,0,0,NaN,NaN
16,1.000,Pig/Swine,16-23,0,0,0,0,NaN,NaN
16,1.000,Pig/Swine,23-5,0,0,0,0,NaN,NaN
16,1.000,Klebsiella,16-23,0,0,0,0,NaN,NaN
16,1.000,Klebsiella,23-5,0,0,0,0,NaN,NaN
16,1.000,Hu Cw and Dg,16-23,0,0,0,0,NaN,NaN
16,1.000,Hu Cw and Dg,23-5,0,0,0,0,NaN,NaN
16,1.000,Ground Squirrel,16-23,0,0,0,0,NaN,NaN
16,1.000,Ground Squirrel,23-5,0,0,0,0,NaN,NaN
16,1.000,Opossum,16-23,0,0,0,0,NaN,NaN
16,1.000,Opossum,23-5,0,0,0,0,NaN,NaN
16,1.000,Cow,16-23,0,0,0,0,NaN,NaN
16,1.000,Cow,23-5,0,0,0,0,NaN,NaN
16,1.000,Deer Mouse,16-23,0,0,0,0,NaN,NaN
16,1.000,Deer Mouse,23-5,0,0,0,0,NaN,NaN
16,1.000,OVERALL,16-23,68,0,0,68,100.000,100.000
16,1.000,OVERALL,23-5,90,0,0,90,100.000,100.000
17,0.000,Chicken,16-23,0,0,0,0,NaN,NaN
17,0.000,Chicken,23-5,4,2,0,6,66.667,66.667
17,0.000,Sea Lion,16-23,0,0,0,0,NaN,NaN
17,0.000,Sea Lion,23-5,0,5,0,5,0.000,0.000
17,0.000,Hu and Cw,16-23,0,3,0,3,0.000,0.000
17,0.000,Hu and Cw,23-5,10,7,0,17,58.824,58.824
17,0.000,Sheep,16-23,44,47,0,91,48.352,48.352
17,0.000,Sheep,23-5,52,40,0,92,56.522,56.522
17,0.000,Hu and Dg,16-23,7,5,0,12,58.333,58.333
17,0.000,Hu and Dg,23-5,16,23,0,39,41.026,41.026
17,0.000,Common Loon,16-23,0,0,0,0,NaN,NaN
17,0.000,Common Loon,23-5,0,0,0,0,NaN,NaN
17,0.000,Red-Winged Blackbird,16-23,0,0,0,0,NaN,NaN
17,0.000,Red-Winged Blackbird,23-5,0,0,0,0,NaN,NaN
17,0.000,Cw,16-23,2,6,0,8,25.000,25.000
17,0.000,Cw,23-5,6,13,0,19,31.579,31.579
17,0.000,Cliff Sparrow,16-23,0,3,0,3,0.000,0.000
17,0.000,Cliff Sparrow,23-5,0,0,0,0,NaN,NaN
17,0.000,Pig,16-23,2,3,0,5,40.000,40.000
17,0.000,Pig,23-5,0,0,0,0,NaN,NaN
17,0.000,Barn Owl,16-23,0,0,0,0,NaN,NaN
17,0.000,Barn Owl,23-5,0,0,0,0,NaN,NaN
17,0.000,Wild Pig,16-23,0,0,0,0,NaN,NaN
17,0.000,Wild Pig,23-5,0,1,0,1,0.000,0.000
17,0.000,Pennington Creek Water,16-23,0,0,0,0,NaN,NaN
17,0.000,Pennington Creek Water,23-5,0,0,0,0,NaN,NaN
17,0.000,Guinni,16-23,0,0,0,0,NaN,NaN
17,0.000,Guinni,23-5,0,0,0,0,NaN,NaN
17,0.000,Racoon,16-23,0,0,0,0,NaN,NaN
17,0.000,Racoon,23-5,0,0,0,0,NaN,NaN
17,0.000,Hu,16-23,8,6,0,14,57.143,57.143
17,0.000,Hu,23-5,23,20,0,43,53.488,53.488
17,0.000,Cw and Dg,16-23,3,14,0,17,17.647,17.647
17,0.000,Cw and Dg,23-5,11,19,0,30,36.667,36.667
17,0.000,Red Wind Blackbird,16-23,0,0,0,0,NaN,NaN
17,0.000,Red Wind Blackbird,23-5,0,0,0,0,NaN,NaN
17,0.000,Tree Swallow,16-23,0,0,0,0,NaN,NaN
17,0.000,Tree Swallow,23-5,0,0,0,0,NaN,NaN
17,0.000,Turkey Vulture,16-23,0,0,0,0,NaN,NaN
17,0.000,Turkey Vulture,23-5,0,0,0,0,NaN,NaN
17,0.000,Dg,16-23,6,9,0,15,40.000,40.000
17,0.000,Dg,23-5,31,39,0,70,44.286,44.286
17,0.000,Western Kingbird,16-23,0,0,0,0,NaN,NaN
17,0.000,Western Kingbird,23-5,0,0,0,0,NaN,NaN
17,0.000,White Crowned Sparrow,16-23,0,0,0,0,NaN,NaN
17,0.000,White Crowned Sparrow,23-5,0,0,0,0,NaN,NaN
17,0.000,Eared Grebe,16-23,0,0,0,0,NaN,NaN
17,0.000,Eared Grebe,23-5,0,4,0,4,0.000,0.000
17,0.000,cougar,16-23,0,0,0,0,NaN,NaN
17,0.000,cougar,23-5,0,0,0,0,NaN,NaN
17,0.000,Ocean Water,16-23,0,0,0,0,NaN,NaN
17,0.000,Ocean Water,23-5,0,0,0,0,NaN,NaN
17,0.000,Red Tailed Hawk,16-23,0,0,0,0,NaN,NaN
17,0.000,Red Tailed Hawk,23-5,0,0,0,0,NaN,NaN
17,0.000,Dog,16-23,51,66,0,117,43.590,43.590
17,0.000,Dog,23-5,85,140,0,225,37.778,37.778
17,0.000,Human,16-23,1764,884,0,2648,66.616,66.616
17,0.000,Human,23-5,2172,774,0,2946,73.727,73.727
17,0.000,Wild Turkey,16-23,0,1,0,1,0.000,0.000
17,0.000,Wild Turkey,23-5,0,3,0,3,0.000,0.000
17,0.000,Clark Grebe,16-23,0,0,0,0,NaN,NaN
17,0.000,Clark Grebe,23-5,0,0,0,0,NaN,NaN
17,0.000,Seagull,16-23,0,0,0,0,NaN,NaN
17,0.000,Seagull,23-5,44,7,0,51,86.275,86.275
17,0.000,Surf Scoter,16-23,0,0,0,0,NaN,NaN
17,0.000,Surf Scoter,23-5,0,0,0,0,NaN,NaN
17,0.000,Pigeon,16-23,53,124,0,177,29.944,29.944
17,0.000,Pigeon,23-5,103,103,0,206,50.000,50.000
17,0.000,Pacific Ocean Water,16-23,0,0,0,0,NaN,NaN
17,0.000,Pacific Ocean Water,23-5,0,0,0,0,NaN,NaN
17,0.000,Cat,16-23,7,14,0,21,33.333,33.333
17,0.000,Cat,23-5,10,17,0,27,37.037,37.037
17,0.000,Horse,16-23,3,8,0,11,27.273,27.273
17,0.000,Horse,23-5,11,36,0,47,23.404,23.404
17,0.000,orangutan,16-23,0,0,0,0,NaN,NaN
17,0.000,orangutan,23-5,0,0,0,0,NaN,NaN
17,0.000,Bat,16-23,36,38,0,74,48.649,48.649
17,0.000,Bat,23-5,37,41,0,78,47.436,47.436
17,0.000,Deer,16-23,10,23,0,33,30.303,30.303
17,0.000,Deer,23-5,12,124,0,136,8.824,8.824
17,0.000,Great Horned Owl,16-23,0,0,0,0,NaN,NaN
17,0.000,Great Horned Owl,23-5,0,0,0,0,NaN,NaN
17,0.000,Freshwater Lagoon,16-23,0,0,0,0,NaN,NaN
17,0.000,Freshwater Lagoon,23-5,0,0,0,0,NaN,NaN
17,0.000,Unknown Avian,16-23,0,0,0,0,NaN,NaN
17,0.000,Unknown Avian,23-5,0,0,0,0,NaN,NaN
17,0.000,Human UTI,16-23,68,63,0,131,51.908,51.908
17,0.000,Human UTI,23-5,92,122,0,214,42.991,42.991
17,0.000,unknown,16-23,0,0,0,0,NaN,NaN
17,0.000,unknown,23-5,0,0,0,0,NaN,NaN
17,0.000,SLO Creek Water,16-23,0,0,0,0,NaN,NaN
17,0.000,SLO Creek Water,23-5,0,0,0,0,NaN,NaN
17,0.000,Pig/Swine,16-23,2,2,0,4,50.000,50.000
17,0.000,Pig/Swine,23-5,8,7,0,15,53.333,53.333
17,0.000,Klebsiella,16-23,0,0,0,0,NaN,NaN
17,0.000,Klebsiella,23-5,0,0,0,0,NaN,NaN
17,0.000,Hu Cw and Dg,16-23,2,7,0,9,22.222,22.222
17,0.000,Hu Cw and Dg,23-5,3,7,0,10,30.000,30.000
17,0.000,Ground Squirrel,16-23,74,41,0,115,64.348,64.348
17,0.000,Ground Squirrel,23-5,73,59,0,132,55.303,55.303
17,0.000,Opossum,16-23,0,0,0,0,NaN,NaN
17,0.000,Opossum,23-5,0,0,0,0,NaN,NaN
17,0.000,Cow,16-23,1567,1272,0,2839,55.195,55.195
17,0.000,Cow,23-5,1536,1658,0,3194,48.090,48.090
17,0.000,Deer Mouse,16-23,0,0,0,0,NaN,NaN
17,0.000,Deer Mouse,23-5,0,0,0,0,NaN,NaN
17,0.000,OVERALL,16-23,3709,2639,0,6348,58.428,58.428
17,0.000,OVERALL,23-5,4339,3271,0,7610,57.017,57.017
17,0.500,Chicken,16-23,0,0,0,0,NaN,NaN
17,0.500,Chicken,23-5,4,2,0,6,66.667,66.667
17,0.500,Sea Lion,16-23,0,0,0,0,NaN,NaN
17,0.500,Sea Lion,23-5,0,5,0,5,0.000,0.000
17,0.500,Hu and Cw,16-23,0,3,0,3,0.000,0.000
17,0.500,Hu and Cw,23-5,10,7,0,17,58.824,58.824
17,0.500,Sheep,16-23,44,47,0,91,48.352,48.352
17,0.500,Sheep,23-5,52,40,0,92,56.522,56.522
17,0.500,Hu and Dg,16-23,7,5,0,12,58.333,58.333
17,0.500,Hu and Dg,23-5,16,23,0,39,41.026,41.026
17,0.500,Common Loon,16-23,0,0,0,0,NaN,NaN
17,0.500,Common Loon,23-5,0,0,0,0,NaN,NaN
17,0.500,Red-Winged Blackbird,16-23,0,0,0,0,NaN,NaN
17,0.500,Red-Winged Blackbird,23-5,0,0,0,0,NaN,NaN
17,0.500,Cw,16-23,2,6,0,8,25.000,25.000
17,0.500,Cw,23-5,6,13,0,19,31.579,31.579
17,0.500,Cliff Sparrow,16-23,0,3,0,3,0.000,0.000
17,0.500,Cliff Sparrow,23-5,0,0,0,0,NaN,NaN
17,0.500,Pig,16-23,2,3,0,5,40.000,40.000
17,0.500,Pig,23-5,0,0,0,0,NaN,NaN
17,0.500,Barn Owl,16-23,0,0,0,0,NaN,NaN
17,0.500,Barn Owl,23-5,0,0,0,0,NaN,NaN
17,0.500,Wild Pig,16-23,0,0,0,0,NaN,NaN
17,0.500,Wild Pig,23-5,0,1,0,1,0.000,0.000
17,0.500,Pennington Creek Water,16-23,0,0,0,0,NaN,NaN
17,0.500,Pennington Creek Water,23-5,0,0,0,0,NaN,NaN
17,0.500,Guinni,16-23,0,0,0,0,NaN,NaN
17,0.500,Guinni,23-5,0,0,0,0,NaN,NaN
17,0.500,Racoon,16-23,0,0,0,0,NaN,NaN
17,0.500,Racoon,23-5,0,0,0,0,NaN,NaN
17,0.500,Hu,16-23,8,6,0,14,57.143,57.143
17,0.500,Hu,23-5,23,20,0,43,53.488,53.488
17,0.500,Cw and Dg,16-23,3,14,0,17,17.647,17.647
17,0.500,Cw and Dg,23-5,11,19,0,30,36.667,36.667
17,0.500,Red Wind Blackbird,16-23,0,0,0,0,NaN,NaN
17,0.500,Red Wind Blackbird,23-5,0,0,0,0,NaN,NaN
17,0.500,Tree Swallow,16-23,0,0,0,0,NaN,NaN
17,0.500,Tree Swallow,23-5,0,0,0,0,NaN,NaN
17,0.500,Turkey Vulture,16-23,0,0,0,0,NaN,NaN
17,0.500,Turkey Vulture,23-5,0,0,0,0,NaN,NaN
17,0.500,Dg,16-23,6,9,0,15,40.000,40.000
17,0.500,Dg,23-5,31,39,0,70,44.286,44.286
17,0.500,Western Kingbird,16-23,0,0,0,0,NaN,NaN
17,0.500,Western Kingbird,23-5,0,0,0,0,NaN,NaN
17,0.500,White Crowned Sparrow,16-23,0,0,0,0,NaN,NaN
17,0.500,White Crowned Sparrow,23-5,0,0,0,0,NaN,NaN
17,0.500,Eared Grebe,16-23,0,0,0,0,NaN,NaN
17,0.500,Eared Grebe,23-5,0,4,0,4,0.000,0.000
17,0.500,cougar,16-23,0,0,0,0,NaN,NaN
17,0.500,cougar,23-5,0,0,0,0,NaN,NaN
17,0.500,Ocean Water,16-23,0,0,0,0,NaN,NaN
17,0.500,Ocean Water,23-5,0,0,0,0,NaN,NaN
17,0.500,Red Tailed Hawk,16-23,0,0,0,0,NaN,NaN
17,0.500,Red Tailed Hawk,23-5,0,0,0,0,NaN,NaN
17,0.500,Dog,16-23,51,66,0,117,43.590,43.590
17,0.500,Dog,23-5,85,140,0,225,37.778,37.778
17,0.500,Human,16-23,1764,884,0,2648,66.616,66.616
17,0.500,Human,23-5,2172,774,0,2946,73.727,73.727
17,0.500,Wild Turkey,16-23,0,1,0,1,0.000,0.000
17,0.500,Wild Turkey,23-5,0,3,0,3,0.000,0.000
17,0.500,Clark Grebe,16-23,0,0,0,0,NaN,NaN
17,0.500,Clark Grebe,23-5,0,0,0,0,NaN,NaN
17,0.500,Seagull,16-23,0,0,0,0,NaN,NaN
17,0.500,Seagull,23-5,44,7,0,51,86.275,86.275
17,0.500,Surf Scoter,16-23,0,0,0,0,NaN,NaN
17,0.500,Surf Scoter,23-5,0,0,0,0,NaN,NaN
17,0.500,Pigeon,16-23,53,124,0,177,29.944,29.944
17,0.500,Pigeon,23-5,103,103,0,206,50.000,50.000
17,0.500,Pacific Ocean Water,16-23,0,0,0,0,NaN,NaN
17,0.500,Pacific Ocean Water,23-5,0,0,0,0,NaN,NaN
17,0.500,Cat,16-23,7,14,0,21,33.333,33.333
17,0.500,Cat,23-5,10,17,0,27,37.037,37.037
17,0.500,Horse,16-23,3,8,0,11,27.273,27.273
17,0.500,Horse,23-5,11,36,0,47,23.404,23.404
17,0.500,orangutan,16-23,0,0,0,0,NaN,NaN
17,0.500,orangutan,23-5,0,0,0,0,NaN,NaN
17,0.500,Bat,16-23,36,38,0,74,48.649,48.649
17,0.500,Bat,23-5,37,41,0,78,47.436,47.436
17,0.500,Deer,16-23,10,23,0,33,30.303,30.303
17,0.500,Deer,23-5,12,124,0,136,8.824,8.824
17,0.500,Great Horned Owl,16-23,0,0,0,0,NaN,NaN
17,0.500,Great Horned Owl,23-5,0,0,0,0,NaN,NaN
17,0.500,Freshwater Lagoon,16-23,0,0,0,0,NaN,NaN
17,0.500,Freshwater Lagoon,23-5,0,0,0,0,NaN,NaN
17,0.500,Unknown Avian,16-23,0,0,0,0,NaN,NaN
17,0.500,Unknown Avian,23-5,0,0,0,0,NaN,NaN
17,0.500,Human UTI,16-23,68,63,0,131,51.908,51.908
17,0.500,Human UTI,23-5,92,122,0,214,42.991,42.991
17,0.500,unknown,16-23,0,0,0,0,NaN,NaN
17,0.500,unknown,23-5,0,0,0,0,NaN,NaN
17,0.500,SLO Creek Water,16-23,0,0,0,0,NaN,NaN
17,0.500,SLO Creek Water,23-5,0,0,0,0,NaN,NaN
17,0.500,Pig/Swine,16-23,2,2,0,4,50.000,50.000
17,0.500,Pig/Swine,23-5,8,7,0,15,53.333,53.333
17,0.500,Klebsiella,16-23,0,0,0,0,NaN,NaN
17,0.500,Klebsiella,23-5,0,0,0,0,NaN,NaN
17,0.500,Hu Cw and Dg,16-23,2,7,0,9,22.222,22.222
17,0.500,Hu Cw and Dg,23-5,3,7,0,10,30.000,30.000
17,0.500,Ground Squirrel,16-23,74,41,0,115,64.348,64.348
17,0.500,Ground Squirrel,23-5,73,59,0,132,55.303,55.303
17,0.500,Opossum,16-23,0,0,0,0,NaN,NaN
17,0.500,Opossum,23-5,0,0,0,0,NaN,NaN
17,0.500,Cow,16-23,1567,1272,0,2839,55.195,55.195
17,0.500,Cow,23-5,1536,1658,0,3194,48.090,48.090
17,0.500,Deer Mouse,16-23,0,0,0,0,NaN,NaN
17,0.500,Deer Mouse,23-5,0,0,0,0,NaN,NaN
17,0.500,OVERALL,16-23,3709,2639,0,6348,58.428,58.428
17,0.500,OVERALL,23-5,4339,3271,0,7610,57.017,57.017
17,0.900,Chicken,16-23,0,0,0,0,NaN,NaN
17,0.900,Chicken,23-5,4,2,0,6,66.667,66.667
17,0.900,Sea Lion,16-23,0,0,0,0,NaN,NaN
17,0.900,Sea Lion,23-5,0,5,0,5,0.000,0.000
17,0.900,Hu and Cw,16-23,0,3,0,3,0.000,0.000
17,0.900,Hu and Cw,23-5,10,7,0,17,58.824,58.824
17,0.900,Sheep,16-23,44,47,0,91,48.352,48.352
17,0.900,Sheep,23-5,52,40,0,92,56.522,56.522
17,0.900,Hu and Dg,16-23,7,5,0,12,58.333,58.333
17,0.900,Hu and Dg,23-5,16,23,0,39,41.026,41.026
17,0.900,Common Loon,16-23,0,0,0,0,NaN,NaN
17,0.900,Common Loon,23-5,0,0,0,0,NaN,NaN
17,0.900,Red-Winged Blackbird,16-23,0,0,0,0,NaN,NaN
17,0.900,Red-Winged Blackbird,23-5,0,0,0,0,NaN,NaN
17,0.900,Cw,16-23,2,6,0,8,25.000,25.000
17,0.900,Cw,23-5,6,13,0,19,31.579,31.579
17,0.900,Cliff Sparrow,16-23,0,3,0,3,0.000,0.000
17,0.900,Cliff Sparrow,23-5,0,0,0,0,NaN,NaN
17,0.900,Pig,16-23,2,3,0,5,40.000,40.000
17,0.900,Pig,23-5,0,0,0,0,NaN,NaN
17,0.900,Barn Owl,16-23,0,0,0,0,NaN,NaN
17,0.900,Barn Owl,23-5,0,0,0,0,NaN,NaN
17,0.900,Wild Pig,16-23,0,0,0,0,NaN,NaN
17,0.900,Wild Pig,23-5,0,1,0,1,0.000,0.000
17,0.900,Pennington Creek Water,16-23,0,0,0,0,NaN,NaN
17,0.900,Pennington Creek Water,23-5,0,0,0,0,NaN,NaN
17,0.900,Guinni,16-23,0,0,0,0,NaN,NaN
17,0.900,Guinni,23-5,0,0,0,0,NaN,NaN
17,0.900,Racoon,16-23,0,0,0,0,NaN,NaN
17,0.900,Racoon,23-5,0,0,0,0,NaN,NaN
17,0.900,Hu,16-23,8,6,0,14,57.143,57.143
17,0.900,Hu,23-5,23,20,0,43,53.488,53.488
17,0.900,Cw and Dg,16-23,3,14,0,17,17.647,17.647
17,0.900,Cw and Dg,23-5,11,19,0,30,36.667,36.667
17,0.900,Red Wind Blackbird,16-23,0,0,0,0,NaN,NaN
17,0.900,Red Wind Blackbird,23-5,0,0,0,0,NaN,NaN
17,0.900,Tree Swallow,16-23,0,0,0,0,NaN,NaN
17,0.900,Tree Swallow,23-5,0,0,0,0,NaN,NaN
17,0.900,Turkey Vulture,16-23,0,0,0,0,NaN,NaN
17,0.900,Turkey Vulture,23-5,0,0,0,0,NaN,NaN
17,0.900,Dg,16-23,6,9,0,15,40.000,40.000
17,0.900,Dg,23-5,31,39,0,70,44.286,44.286
17,0.900,Western Kingbird,16-23,0,0,0,0,NaN,NaN
17,0.900,Western Kingbird,23-5,0,0,0,0,NaN,NaN
17,0.900,White Crowned Sparrow,16-23,0,0,0,0,NaN,NaN
17,0.900,White Crowned Sparrow,23-5,0,0,0,0,NaN,NaN
17,0.900,Eared Grebe,16-23,0,0,0,0,NaN,NaN
17,0.900,Eared Grebe,23-5,0,4,0,4,0.000,0.000
17,0.900,cougar,16-23,0,0,0,0,NaN,NaN
17,0.900,cougar,23-5,0,0,0,0,NaN,NaN
17,0.900,Ocean Water,16-23,0,0,0,0,NaN,NaN
17,0.900,Ocean Water,23-5,0,0,0,0,NaN,NaN
17,0.900,Red Tailed Hawk,16-23,0,0,0,0,NaN,NaN
17,0.900,Red Tailed Hawk,23-5,0,0,0,0,NaN,NaN
17,0.900,Dog,16-23,51,66,0,117,43.590,43.590
17,0.900,Dog,23-5,85,136,0,221,38.462,38.462
17,0.900,Human,16-23,1764,881,0,2645,66.692,66.692
17,0.900,Human,23-5,2172,770,0,2942,73.827,73.827
17,0.900,Wild Turkey,16-23,0,1,0,1,0.000,0.000
17,0.900,Wild Turkey,23-5,0,3,0,3,0.000,0.000
17,0.900,Clark Grebe,16-23,0,0,0,0,NaN,NaN
17,0.900,Clark Grebe,23-5,0,0,0,0,NaN,NaN
17,0.900,Seagull,16-23,0,0,0,0,NaN,NaN
17,0.900,Seagull,23-5,44,8,0,52,84.615,84.615
17,0.900,Surf Scoter,16-23,0,0,0,0,NaN,NaN
17,0.900,Surf Scoter,23-5,0,0,0,0,NaN,NaN
17,0.900,Pigeon,16-23,53,125,0,178,29.775,29.775
17,0.900,Pigeon,23-5,103,103,0,206,50.000,50.000
17,0.900,Pacific Ocean Water,16-23,0,0,0,0,NaN,NaN
17,0.900,Pacific Ocean Water,23-5,0,0,0,0,NaN,NaN
17,0.900,Cat,16-23,7,14,0,21,33.333,33.333
17,0.900,Cat,23-5,10,17,0,27,37.037,37.037
17,0.900,Horse,16-23,3,8,0,11,27.273,27.273
17,0.900,Horse,23-5,11,36,0,47,23.404,23.404
17,0.900,orangutan,16-23,0,0,0,0,NaN,NaN
17,0.900,orangutan,23-5,0,0,0,0,NaN,NaN
17,0.900,Bat,16-23,36,38,0,74,48.649,48.649
17,0.900,Bat,23-5,37,41,0,78,47.436,47.436
17,0.900,Deer,16-23,10,23,0,33,30.303,30.303
17,0.900,Deer,23-5,12,124,0,136,8.824,8.824
17,0.900,Great Horned Owl,16-23,0,0,0,0,NaN,NaN
17,0.900,Great Horned Owl,23-5,0,0,0,0,NaN,NaN
17,0.900,Freshwater Lagoon,16-23,0,0,0,0,NaN,NaN
17,0.900,Freshwater Lagoon,23-5,0,0,0,0,NaN,NaN
17,0.900,Unknown Avian,16-23,0,0,0,0,NaN,NaN
17,0.900,Unknown Avian,23-5,0,0,0,0,NaN,NaN
17,0.900,Human UTI,16-23,68,63,0,131,51.908,51.908
17,0.900,Human UTI,23-5,95,122,0,217,43.779,43.779
17,0.900,unknown,16-23,0,0,0,0,NaN,NaN
17,0.900,unknown,23-5,0,0,0,0,NaN,NaN
17,0.900,SLO Creek Water,16-23,0,0,0,0,NaN,NaN
17,0.900,SLO Creek Water,23-5,0,0,0,0,NaN,NaN
17,0.900,Pig/Swine,16-23,2,2,0,4,50.000,50.000
17,0.900,Pig/Swine,23-5,8,7,0,15,53.333,53.333
17,0.900,Klebsiella,16-23,0,0,0,0,NaN,NaN
17,0.900,Klebsiella,23-5,0,0,0,0,NaN,NaN
17,0.900,Hu Cw and Dg,16-23,2,7,0,9,22.222,22.222
17,0.900,Hu Cw and Dg,23-5,3,7,0,10,30.000,30.000
17,0.900,Ground Squirrel,16-23,74,41,0,115,64.348,64.348
17,0.900,Ground Squirrel,23-5,73,59,0,132,55.303,55.303
17,0.900,Opossum,16-23,0,0,0,0,NaN,NaN
17,0.900,Opossum,23-5,0,0,0,0,NaN,NaN
17,0.900,Cow,16-23,1568,1269,0,2837,55.270,55.270
17,0.900,Cow,23-5,1536,1654,0,3190,48.150,48.150
17,0.900,Deer Mouse,16-23,0,0,0,0,NaN,NaN
17,0.900,Deer Mouse,23-5,0,0,0,0,NaN,NaN
17,0.900,OVERALL,16-23,3710,2634,0,6344,58.480,58.480
17,0.900,OVERALL,23-5,4342,3260,0,7602,57.117,57.117
17,0.950,Chicken,16-23,0,0,0,0,NaN,NaN
17,0.950,Chicken,23-5,4,2,0,6,66.667,66.667
17,0.950,Sea Lion,16-23,0,0,0,0,NaN,NaN
17,0.950,Sea Lion,23-5,0,5,0,5,0.000,0.000
17,0.950,Hu and Cw,16-23,0,3,0,3,0.000,0.000
17,0.950,Hu and Cw,23-5,10,7,0,17,58.824,58.824
17,0.950,Sheep,16-23,44,47,0,91,48.352,48.352
17,0.950,Sheep,23-5,52,40,0,92,56.522,56.522
17,0.950,Hu and Dg,16-23,7,5,0,12,58.333,58.333
17,0.950,Hu and Dg,23-5,16,23,0,39,41.026,41.026
17,0.950,Common Loon,16-23,0,0,0,0,NaN,NaN
17,0.950,Common Loon,23-5,0,0,0,0,NaN,NaN
17,0.950,Red-Winged Blackbird,16-23,0,0,0,0,NaN,NaN
17,0.950,Red-Winged Blackbird,23-5,0,0,0,0,NaN,NaN
17,0.950,Cw,16-23,2,6,0,8,25.000,25.000
17,0.950,Cw,23-5,6,13,0,19,31.579,31.579
17,0.950,Cliff Sparrow,16-23,0,3,0,3,0.000,0.000
17,0.950,Cliff Sparrow,23-5,0,0,0,0,NaN,NaN
17,0.950,Pig,16-23,2,3,0,5,40.000,40.000
17,0.950,Pig,23-5,0,0,0,0,NaN,NaN
17,0.950,Barn Owl,16-23,0,0,0,0,NaN,NaN
17,0.950,Barn Owl,23-5,0,0,0,0,NaN,NaN
17,0.950,Wild Pig,16-23,0,0,0,0,NaN,NaN
17,0.950,Wild Pig,23-5,0,1,0,1,0.000,0.000
17,0.950,Pennington Creek Water,16-23,0,0,0,0,NaN,NaN
17,0.950,Pennington Creek Water,23-5,0,0,0,0,NaN,NaN
17,0.950,Guinni,16-23,0,0,0,0,NaN,NaN
17,0.950,Guinni,23-5,0,0,0,0,NaN,NaN
17,0.950,Racoon,16-23,0,0,0,0,NaN,NaN
17,0.950,Racoon,23-5,0,0,0,0,NaN,NaN
17,0.950,Hu,16-23,8,6,0,14,57.143,57.143
17,0.950,Hu,23-5,23,20,0,43,53.488,53.488
17,0.950,Cw and Dg,16-23,3,14,0,17,17.647,17.647
17,0.950,Cw and Dg,23-5,11,19,0,30,36.667,36.667
17,0.950,Red Wind Blackbird,16-23,0,0,0,0,NaN,NaN
17,0.950,Red Wind Blackbird,23-5,0,0,0,0,NaN,NaN
17,0.950,Tree Swallow,16-23,0,0,0,0,NaN,NaN
17,0.950,Tree Swallow,23-5,0,0,0,0,NaN,NaN
17,0.950,Turkey Vulture,16-23,0,0,0,0,NaN,NaN
17,0.950,Turkey Vulture,23-5,0,0,0,0,NaN,NaN
17,0.950,Dg,16-23,6,9,0,15,40.000,40.000
17,0.950,Dg,23-5,31,38,0,69,44.928,44.928
17,0.950,Western Kingbird,16-23,0,0,0,0,NaN,NaN
17,0.950,Western Kingbird,23-5,0,0,0,0,NaN,NaN
17,0.950,White Crowned Sparrow,16-23,0,0,0,0,NaN,NaN
17,0.950,White Crowned Sparrow,23-5,0,0,0,0,NaN,NaN
17,0.950,Eared Grebe,16-23,0,0,0,0,NaN,NaN
17,0.950,Eared Grebe,23-5,0,4,0,4,0.000,0.000
17,0.950,cougar,16-23,0,0,0,0,NaN,NaN
17,0.950,cougar,23-5,0,0,0,0,NaN,NaN
17,0.950,Ocean Water,16-23,0,0,0,0,NaN,NaN
17,0.950,Ocean Water,23-5,0,0,0,0,NaN,NaN
17,0.950,Red Tailed Hawk,16-23,0,0,0,0,NaN,NaN
17,0.950,Red Tailed Hawk,23-5,0,0,0,0,NaN,NaN
17,0.950,Dog,16-23,51,66,0,117,43.590,43.590
17,0.950,Dog,23-5,85,135,0,220,38.636,38.636
17,0.950,Human,16-23,1764,877,0,2641,66.793,66.793
17,0.950,Human,23-5,2175,763,0,2938,74.030,74.030
17,0.950,Wild Turkey,16-23,0,1,0,1,0.000,0.000
17,0.950,Wild Turkey,23-5,0,2,0,2,0.000,0.000
17,0.950,Clark Grebe,16-23,0,0,0,0,NaN,NaN
17,0.950,Clark Grebe,23-5,0,0,0,0,NaN,NaN
17,0.950,Seagull,16-23,0,0,0,0,NaN,NaN
17,0.950,Seagull,23-5,44,7,0,51,86.275,86.275
17,0.950,Surf Scoter,16-23,0,0,0,0,NaN,NaN
17,0.950,Surf Scoter,23-5,0,0,0,0,NaN,NaN
17,0.950,Pigeon,16-23,54,124,0,178,30.337,30.337
17,0.950,Pigeon,23-5,103,104,0,207,49.758,49.758
17,0.950,Pacific Ocean Water,16-23,0,0,0,0,NaN,NaN
17,0.950,Pacific Ocean Water,23-5,0,0,0,0,NaN,NaN
17,0.950,Cat,16-23,7,14,0,21,33.333,33.333
17,0.950,Cat,23-5,10,18,0,28,35.714,35.714
17,0.950,Horse,16-23,3,8,0,11,27.273,27.273
17,0.950,Horse,23-5,11,36,0,47,23.404,23.404
17,0.950,orangutan,16-23,0,0,0,0,NaN,NaN
17,0.950,orangutan,23-5,0,0,0,0,NaN,NaN
17,0.950,Bat,16-23,36,38,0,74,48.649,48.649
17,0.950,Bat,23-5,37,40,0,77,48.052,48.052
17,0.950,Deer,16-23,10,23,0,33,30.303,30.303
17,0.950,Deer,23-5,12,124,0,136,8.824,8.824
17,0.950,Great Horned Owl,16-23,0,0,0,0,NaN,NaN
17,0.950,Great Horned Owl,23-5,0,0,0,0,NaN,NaN
17,0.950,Freshwater Lagoon,16-23,0,0,0,0,NaN,NaN
17,0.950,Freshwater Lagoon,23-5,0,0,0,0,NaN,NaN
17,0.950,Unknown Avian,16-23,0,0,0,0,NaN,NaN
17,0.950,Unknown Avian,23-5,0,0,0,0,NaN,NaN
17,0.950,Human UTI,16-23,71,64,0,135,52.593,52.593
17,0.950,Human UTI,23-5,94,125,0,219,42.922,42.922
17,0.950,unknown,16-23,0,0,0,0,NaN,NaN
17,0.950,unknown,23-5,0,0,0,0,NaN,NaN
17,0.950,SLO Creek Water,16-23,0,0,0,0,NaN,NaN
17,0.950,SLO Creek Water,23-5,0,0,0,0,NaN,NaN
17,0.950,Pig/Swine,16-23,2,2,0,4,50.000,50.000
17,0.950,Pig/Swine,23-5,8,7,0,15,53.333,53.333
17,0.950,Klebsiella,16-23,0,0,0,0,NaN,NaN
17,0.950,Klebsiella,23-5,0,0,0,0,NaN,NaN
17,0.950,Hu Cw and Dg,16-23,2,7,0,9,22.222,22.222
17,0.950,Hu Cw and Dg,23-5,3,7,0,10,30.000,30.000
17,0.950,Ground Squirrel,16-23,74,41,0,115,64.348,64.348
17,0.950,Ground Squirrel,23-5,73,58,0,131,55.725,55.725
17,0.950,Opossum,16-23,0,0,0,0,NaN,NaN
17,0.950,Opossum,23-5,0,0,0,0,NaN,NaN
17,0.950,Cow,16-23,1572,1248,0,2820,55.745,55.745
17,0.950,Cow,23-5,1536,1648,0,3184,48.241,48.241
17,0.950,Deer Mouse,16-23,0,0,0,0,NaN,NaN
17,0.950,Deer Mouse,23-5,0,0,0,0,NaN,NaN
17,0.950,OVERALL,16-23,3718,2609,0,6327,58.764,58.764
17,0.950,OVERALL,23-5,4344,3246,0,7590,57.233,57.233
17,0.960,Chicken,16-23,0,0,0,0,NaN,NaN
17,0.960,Chicken,23-5,4,2,0,6,66.667,66.667
17,0.960,Sea Lion,16-23,0,0,0,0,NaN,NaN
17,0.960,Sea Lion,23-5,0,5,0,5,0.000,0.000
17,0.960,Hu and Cw,16-23,0,3,0,3,0.000,0.000
17,0.960,Hu and Cw,23-5,10,7,0,17,58.824,58.824
17,0.960,Sheep,16-23,44,47,0,91,48.352,48.352
17,0.960,Sheep,23-5,52,41,0,93,55.914,55.914
17,0.960,Hu and Dg,16-23,7,5,0,12,58.333,58.333
17,0.960,Hu and Dg,23-5,16,23,0,39,41.026,41.026
17,0.960,Common Loon,16-23,0,0,0,0,NaN,NaN
17,0.960,Common Loon,23-5,0,0,0,0,NaN,NaN
17,0.960,Red-Winged Blackbird,16-23,0,0,0,0,NaN,NaN
17,0.960,Red-Winged Blackbird,23-5,0,0,0,0,NaN,NaN
17,0.960,Cw,16-23,2,6,0,8,25.000,25.000
17,0.960,Cw,23-5,6,13,0,19,31.579,31.579
17,0.960,Cliff Sparrow,16-23,0,3,0,3,0.000,0.000
17,0.960,Cliff Sparrow,23-5,0,0,0,0,NaN,NaN
17,0.960,Pig,16-23,2,3,0,5,40.000,40.000
17,0.960,Pig,23-5,0,0,0,0,NaN,NaN
17,0.960,Barn Owl,16-23,0,0,0,0,NaN,NaN
17,0.960,Barn Owl,23-5,0,0,0,0,NaN,NaN
17,0.960,Wild Pig,16-23,0,0,0,0,NaN,NaN
17,0.960,Wild Pig,23-5,1,1,0,2,50.000,50.000
17,0.960,Pennington Creek Water,16-23,0,0,0,0,NaN,NaN
17,0.960,Pennington Creek Water,23-5,0,0,0,0,NaN,NaN
17,0.960,Guinni,16-23,0,0,0,0,NaN,NaN
17,0.960,Guinni,23-5,0,0,0,0,NaN,NaN
17,0.960,Racoon,16-23,0,0,0,0,NaN,NaN
17,0.960,Racoon,23-5,0,0,0,0,NaN,NaN
17,0.960,Hu,16-23,8,6,0,14,57.143,57.143
17,0.960,Hu,23-5,23,20,0,43,53.488,53.488
17,0.960,Cw and Dg,16-23,3,14,0,17,17.647,17.647
17,0.960,Cw and Dg,23-5,11,19,0,30,36.667,36.667
17,0.960,Red Wind Blackbird,16-23,0,0,0,0,NaN,NaN
17,0.960,Red Wind Blackbird,23-5,0,0,0,0,NaN,NaN
17,0.960,Tree Swallow,16-23,0,0,0,0,NaN,NaN
17,0.960,Tree Swallow,23-5,0,0,0,0,NaN,NaN
17,0.960,Turkey Vulture,16-23,0,0,0,0,NaN,NaN
17,0.960,Turkey Vulture,23-5,0,0,0,0,NaN,NaN
17,0.960,Dg,16-23,6,9,0,15,40.000,40.000
17,0.960,Dg,23-5,31,38,0,69,44.928,44.928
17,0.960,Western Kingbird,16-23,0,0,0,0,NaN,NaN
17,0.960,Western Kingbird,23-5,0,0,0,0,NaN,NaN
17,0.960,White Crowned Sparrow,16-23,0,0,0,0,NaN,NaN
17,0.960,White Crowned Sparrow,23-5,0,0,0,0,NaN,NaN
17,0.960,Eared Grebe,16-23,0,0,0,0,NaN,NaN
17,0.960,Eared Grebe,23-5,0,4,0,4,0.000,0.000
17,0.960,cougar,16-23,0,0,0,0,NaN,NaN
17,0.960,cougar,23-5,0,0,0,0,NaN,NaN
17,0.960,Ocean Water,16-23,0,0,0,0,NaN,NaN
17,0.960,Ocean Water,23-5,0,0,0,0,NaN,NaN
17,0.960,Red Tailed Hawk,16-23,0,0,0,0,NaN,NaN
17,0.960,Red Tailed Hawk,23-5,0,0,0,0,NaN,NaN
17,0.960,Dog,16-23,51,66,0,117,43.590,43.590
17,0.960,Dog,23-5,85,130,0,215,39.535,39.535
17,0.960,Human,16-23,1766,875,0,2641,66.869,66.869
17,0.960,Human,23-5,2176,748,0,2924,74.419,74.419
17,0.960,Wild Turkey,16-23,0,1,0,1,0.000,0.000
17,0.960,Wild Turkey,23-5,0,7,0,7,0.000,0.000
17,0.960,Clark Grebe,16-23,0,0,0,0,NaN,NaN
17,0.960,Clark Grebe,23-5,0,0,0,0,NaN,NaN
17,0.960,Seagull,16-23,0,0,0,0,NaN,NaN
17,0.960,Seagull,23-5,44,8,0,52,84.615,84.615
17,0.960,Surf Scoter,16-23,0,0,0,0,NaN,NaN
17,0.960,Surf Scoter,23-5,0,2,0,2,0.000,0.000
17,0.960,Pigeon,16-23,54,124,0,178,30.337,30.337
17,0.960,Pigeon,23-5,104,121,0,225,46.222,46.222
17,0.960,Pacific Ocean Water,16-23,0,0,0,0,NaN,NaN
17,0.960,Pacific Ocean Water,23-5,0,0,0,0,NaN,NaN
17,0.960,Cat,16-23,7,14,0,21,33.333,33.333
17,0.960,Cat,23-5,10,19,0,29,34.483,34.483
17,0.960,Horse,16-23,3,8,0,11,27.273,27.273
17,0.960,Horse,23-5,11,36,0,47,23.404,23.404
17,0.960,orangutan,16-23,0,0,0,0,NaN,NaN
17,0.960,orangutan,23-5,0,0,0,0,NaN,NaN
17,0.960,Bat,16-23,36,38,0,74,48.649,48.649
17,0.960,Bat,23-5,37,40,0,77,48.052,48.052
17,0.960,Deer,16-23,10,23,0,33,30.303,30.303
17,0.960,Deer,23-5,12,124,0,136,8.824,8.824
17,0.960,Great Horned Owl,16-23,0,0,0,0,NaN,NaN
17,0.960,Great Horned Owl,23-5,0,0,0,0,NaN,NaN
17,0.960,Freshwater Lagoon,16-23,0,0,0,0,NaN,NaN
17,0.960,Freshwater Lagoon,23-5,0,0,0,0,NaN,NaN
17,0.960,Unknown Avian,16-23,0,0,0,0,NaN,NaN
17,0.960,Unknown Avian,23-5,0,0,0,0,NaN,NaN
17,0.960,Human UTI,16-23,71,65,0,136,52.206,52.206
17,0.960,Human UTI,23-5,94,124,0,218,43.119,43.119
17,0.960,unknown,16-23,0,0,0,0,NaN,NaN
17,0.960,unknown,23-5,0,0,0,0,NaN,NaN
17,0.960,SLO Creek Water,16-23,0,0,0,0,NaN,NaN
17,0.960,SLO Creek Water,23-5,0,0,0,0,NaN,NaN
17,0.960,Pig/Swine,16-23,2,2,0,4,50.000,50.000
17,0.960,Pig/Swine,23-5,8,7,0,15,53.333,53.333
17,0.960,Klebsiella,16-23,0,0,0,0,NaN,NaN
17,0.960,Klebsiella,23-5,0,0,0,0,NaN,NaN
17,0.960,Hu Cw and Dg,16-23,2,7,0,9,22.222,22.222
17,0.960,Hu Cw and Dg,23-5,3,7,0,10,30.000,30.000
17,0.960,Ground Squirrel,16-23,74,41,0,115,64.348,64.348
17,0.960,Ground Squirrel,23-5,73,60,0,133,54.887,54.887
17,0.960,Opossum,16-23,0,0,0,0,NaN,NaN
17,0.960,Opossum,23-5,0,0,0,0,NaN,NaN
17,0.960,Cow,16-23,1570,1238,0,2808,55.912,55.912
17,0.960,Cow,23-5,1536,1627,0,3163,48.561,48.561
17,0.960,Deer Mouse,16-23,0,0,0,0,NaN,NaN
17,0.960,Deer Mouse,23-5,0,0,0,0,NaN,NaN
17,0.960,OVERALL,16-23,3718,2598,0,6316,58.866,58.866
17,0.960,OVERALL,23-5,4347,3233,0,7580,57.348,57.348
17,0.970,Chicken,16-23,0,0,0,0,NaN,NaN
17,0.970,Chicken,23-5,4,2,0,6,66.667,66.667
17,0.970,Sea Lion,16-23,0,0,0,0,NaN,NaN
17,0.970,Sea Lion,23-5,0,7,0,7,0.000,0.000
17,0.970,Hu and Cw,16-23,0,3,0,3,0.000,0.000
17,0.970,Hu and Cw,23-5,10,7,0,17,58.824,58.824
17,0.970,Sheep,16-23,45,48,0,93,48.387,48.387
17,0.970,Sheep,23-5,52,40,0,92,56.522,56.522
17,0.970,Hu and Dg,16-23,7,5,0,12,58.333,58.333
17,0.970,Hu and Dg,23-5,16,23,0,39,41.026,41.026
17,0.970,Common Loon,16-23,0,0,0,0,NaN,NaN
17,0.970,Common Loon,23-5,0,0,0,0,NaN,NaN
17,0.970,Red-Winged Blackbird,16-23,0,0,0,0,NaN,NaN
17,0.970,Red-Winged Blackbird,23-5,0,0,0,0,NaN,NaN
17,0.970,Cw,16-23,2,7,0,9,22.222,22.222
17,0.970,Cw,23-5,6,13,0,19,31.579,31.579
17,0.970,Cliff Sparrow,16-23,0,3,0,3,0.000,0.000
17,0.970,Cliff Sparrow,23-5,0,0,0,0,NaN,NaN
17,0.970,Pig,16-23,2,3,0,5,40.000,40.000
17,0.970,Pig,23-5,0,0,0,0,NaN,NaN
17,0.970,Barn Owl,16-23,0,0,0,0,NaN,NaN
17,0.970,Barn Owl,23-5,0,0,0,0,NaN,NaN
17,0.970,Wild Pig,16-23,0,0,0,0,NaN,NaN
17,0.970,Wild Pig,23-5,0,1,0,1,0.000,0.000
17,0.970,Pennington Creek Water,16-23,0,0,0,0,NaN,NaN
17,0.970,Pennington Creek Water,23-5,0,0,0,0,NaN,NaN
17,0.970,Guinni,16-23,0,0,0,0,NaN,NaN
17,0.970,Guinni,23-5,0,0,0,0,NaN,NaN
17,0.970,Racoon,16-23,0,0,0,0,NaN,NaN
17,0.970,Racoon,23-5,0,0,0,0,NaN,NaN
17,0.970,Hu,16-23,8,6,0,14,57.143,57.143
17,0.970,Hu,23-5,23,20,0,43,53.488,53.488
17,0.970,Cw and Dg,16-23,3,14,0,17,17.647,17.647
17,0.970,Cw and Dg,23-5,11,19,0,30,36.667,36.667
17,0.970,Red Wind Blackbird,16-23,0,0,0,0,NaN,NaN
17,0.970,Red Wind Blackbird,23-5,0,0,0,0,NaN,NaN
17,0.970,Tree Swallow,16-23,0,0,0,0,NaN,NaN
17,0.970,Tree Swallow,23-5,0,0,0,0,NaN,NaN
17,0.970,Turkey Vulture,16-23,0,0,0,0,NaN,NaN
17,0.970,Turkey Vulture,23-5,0,0,0,0,NaN,NaN
17,0.970,Dg,16-23,6,9,0,15,40.000,40.000
17,0.970,Dg,23-5,31,35,0,66,46.970,46.970
17,0.970,Western Kingbird,16-23,0,0,0,0,NaN,NaN
17,0.970,Western Kingbird,23-5,0,0,0,0,NaN,NaN
17,0.970,White Crowned Sparrow,16-23,0,0,0,0,NaN,NaN
17,0.970,White Crowned Sparrow,23-5,0,0,0,0,NaN,NaN
17,0.970,Eared Grebe,16-23,0,0,0,0,NaN,NaN
17,0.970,Eared Grebe,23-5,0,4,0,4,0.000,0.000
17,0.970,cougar,16-23,0,0,0,0,NaN,NaN
17,0.970,cougar,23-5,0,0,0,0,NaN,NaN
17,0.970,Ocean Water,16-23,0,0,0,0,NaN,NaN
17,0.970,Ocean Water,23-5,0,0,0,0,NaN,NaN
17,0.970,Red Tailed Hawk,16-23,0,0,0,0,NaN,NaN
17,0.970,Red Tailed Hawk,23-5,0,0,0,0,NaN,NaN
17,0.970,Dog,16-23,51,66,0,117,43.590,43.590
17,0.970,Dog,23-5,85,129,0,214,39.720,39.720
17,0.970,Human,16-23,1765,872,0,2637,66.932,66.932
17,0.970,Human,23-5,2175,745,0,2920,74.486,74.486
17,0.970,Wild Turkey,16-23,0,3,0,3,0.000,0.000
17,0.970,Wild Turkey,23-5,2,6,0,8,25.000,25.000
17,0.970,Clark Grebe,16-23,0,0,0,0,NaN,NaN
17,0.970,Clark Grebe,23-5,0,0,0,0,NaN,NaN
17,0.970,Seagull,16-23,0,0,0,0,NaN,NaN
17,0.970,Seagull,23-5,44,9,0,53,83.019,83.019
17,0.970,Surf Scoter,16-23,0,0,0,0,NaN,NaN
17,0.970,Surf Scoter,23-5,0,2,0,2,0.000,0.000
17,0.970,Pigeon,16-23,53,123,0,176,30.114,30.114
17,0.970,Pigeon,23-5,104,137,0,241,43.154,43.154
17,0.970,Pacific Ocean Water,16-23,0,0,0,0,NaN,NaN
17,0.970,Pacific Ocean Water,23-5,0,0,0,0,NaN,NaN
17,0.970,Cat,16-23,7,14,0,21,33.333,33.333
17,0.970,Cat,23-5,10,19,0,29,34.483,34.483
17,0.970,Horse,16-23,3,8,0,11,27.273,27.273
17,0.970,Horse,23-5,11,37,0,48,22.917,22.917
17,0.970,orangutan,16-23,0,0,0,0,NaN,NaN
17,0.970,orangutan,23-5,0,0,0,0,NaN,NaN
17,0.970,Bat,16-23,36,38,0,74,48.649,48.649
17,0.970,Bat,23-5,37,40,0,77,48.052,48.052
17,0.970,Deer,16-23,10,23,0,33,30.303,30.303
17,0.970,Deer,23-5,12,124,0,136,8.824,8.824
17,0.970,Great Horned Owl,16-23,0,0,0,0,NaN,NaN
17,0.970,Great Horned Owl,23-5,0,0,0,0,NaN,NaN
17,0.970,Freshwater Lagoon,16-23,0,0,0,0,NaN,NaN
17,0.970,Freshwater Lagoon,23-5,0,0,0,0,NaN,NaN
17,0.970,Unknown Avian,16-23,0,0,0,0,NaN,NaN
17,0.970,Unknown Avian,23-5,0,0,0,0,NaN,NaN
17,0.970,Human UTI,16-23,71,66,0,137,51.825,51.825
17,0.970,Human UTI,23-5,93,124,0,217,42.857,42.857
17,0.970,unknown,16-23,0,0,0,0,NaN,NaN
17,0.970,unknown,23-5,0,0,0,0,NaN,NaN
17,0.970,SLO Creek Water,16-23,0,0,0,0,NaN,NaN
17,0.970,SLO Creek Water,23-5,0,0,0,0,NaN,NaN
17,0.970,Pig/Swine,16-23,2,2,0,4,50.000,50.000
17,0.970,Pig/Swine,23-5,8,7,0,15,53.333,53.333
17,0.970,Klebsiella,16-23,0,0,0,0,NaN,NaN
17,0.970,Klebsiella,23-5,0,0,0,0,NaN,NaN
17,0.970,Hu Cw and Dg,16-23,2,7,0,9,22.222,22.222
17,0.970,Hu Cw and Dg,23-5,3,7,0,10,30.000,30.000
17,0.970,Ground Squirrel,16-23,74,40,0,114,64.912,64.912
17,0.970,Ground Squirrel,23-5,73,58,0,131,55.725,55.725
17,0.970,Opossum,16-23,0,0,0,0,NaN,NaN
17,0.970,Opossum,23-5,0,0,0,0,NaN,NaN
17,0.970,Cow,16-23,1564,1235,0,2799,55.877,55.877
17,0.970,Cow,23-5,1535,1601,0,3136,48.948,48.948
17,0.970,Deer Mouse,16-23,0,0,0,0,NaN,NaN
17,0.970,Deer Mouse,23-5,0,0,0,0,NaN,NaN
17,0.970,OVERALL,16-23,3711,2595,0,6306,58.849,58.849
17,0.970,OVERALL,23-5,4345,3216,0,7561,57.466,57.466
17,0.980,Chicken,16-23,0,0,0,0,NaN,NaN
17,0.980,Chicken,23-5,5,2,0,7,71.429,71.429
17,0.980,Sea Lion,16-23,0,0,0,0,NaN,NaN
17,0.980,Sea Lion,23-5,0,8,0,8,0.000,0.000
17,0.980,Hu and Cw,16-23,0,3,0,3,0.000,0.000
17,0.980,Hu and Cw,23-5,10,17,0,27,37.037,37.037
17,0.980,Sheep,16-23,48,45,0,93,51.613,51.613
17,0.980,Sheep,23-5,51,38,0,89,57.303,57.303
17,0.980,Hu and Dg,16-23,7,5,0,12,58.333,58.333
17,0.980,Hu and Dg,23-5,16,21,0,37,43.243,43.243
17,0.980,Common Loon,16-23,0,0,0,0,NaN,NaN
17,0.980,Common Loon,23-5,0,0,0,0,NaN,NaN
17,0.980,Red-Winged Blackbird,16-23,0,0,0,0,NaN,NaN
17,0.980,Red-Winged Blackbird,23-5,0,0,0,0,NaN,NaN
17,0.980,Cw,16-23,2,6,0,8,25.000,25.000
17,0.980,Cw,23-5,6,15,0,21,28.571,28.571
17,0.980,Cliff Sparrow,16-23,0,3,0,3,0.000,0.000
17,0.980,Cliff Sparrow,23-5,0,0,0,0,NaN,NaN
17,0.980,Pig,16-23,2,3,0,5,40.000,40.000
17,0.980,Pig,23-5,0,0,0,0,NaN,NaN
17,0.980,Barn Owl,16-23,0,0,0,0,NaN,NaN
17,0.980,Barn Owl,23-5,0,0,0,0,NaN,NaN
17,0.980,Wild Pig,16-23,0,0,0,0,NaN,NaN
17,0.980,Wild Pig,23-5,0,1,0,1,0.000,0.000
17,0.980,Pennington Creek Water,16-23,0,0,0,0,NaN,NaN
17,0.980,Pennington Creek Water,23-5,0,0,0,0,NaN,NaN
17,0.980,Guinni,16-23,0,0,0,0,NaN,NaN
17,0.980,Guinni,23-5,0,0,0,0,NaN,NaN
17,0.980,Racoon,16-23,0,0,0,0,NaN,NaN
17,0.980,Racoon,23-5,0,0,0,0,NaN,NaN
17,0.980,Hu,16-23,8,6,0,14,57.143,57.143
17,0.980,Hu,23-5,23,21,0,44,52.273,52.273
17,0.980,Cw and Dg,16-23,3,14,0,17,17.647,17.647
17,0.980,Cw and Dg,23-5,11,21,0,32,34.375,34.375
17,0.980,Red Wind Blackbird,16-23,0,0,0,0,NaN,NaN
17,0.980,Red Wind Blackbird,23-5,0,0,0,0,NaN,NaN
17,0.980,Tree Swallow,16-23,0,0,0,0,NaN,NaN
17,0.980,Tree Swallow,23-5,0,0,0,0,NaN,NaN
17,0.980,Turkey Vulture,16-23,0,0,0,0,NaN,NaN
17,0.980,Turkey Vulture,23-5,0,0,0,0,NaN,NaN
17,0.980,Dg,16-23,6,9,0,15,40.000,40.000
17,0.980,Dg,23-5,31,27,0,58,53.448,53.448
17,0.980,Western Kingbird,16-23,0,0,0,0,NaN,NaN
17,0.980,Western Kingbird,23-5,0,0,0,0,NaN,NaN
17,0.980,White Crowned Sparrow,16-23,0,0,0,0,NaN,NaN
17,0.980,White Crowned Sparrow,23-5,0,2,0,2,0.000,0.000
17,0.980,Eared Grebe,16-23,0,0,0,0,NaN,NaN
17,0.980,Eared Grebe,23-5,0,4,0,4,0.000,0.000
17,0.980,cougar,16-23,0,0,0,0,NaN,NaN
17,0.980,cougar,23-5,0,0,0,0,NaN,NaN
17,0.980,Ocean Water,16-23,0,0,0,0,NaN,NaN
17,0.980,Ocean Water,23-5,0,0,0,0,NaN,NaN
17,0.980,Red Tailed Hawk,16-23,0,0,0,0,NaN,NaN
17,0.980,Red Tailed Hawk,23-5,0,0,0,0,NaN,NaN
17,0.980,Dog,16-23,50,71,0,121,41.322,41.322
17,0.980,Dog,23-5,85,124,0,209,40.670,40.670
17,0.980,Human,16-23,1768,859,0,2627,67.301,67.301
17,0.980,Human,23-5,2177,727,0,2904,74.966,74.966
17,0.980,Wild Turkey,16-23,1,3,0,4,25.000,25.000
17,0.980,Wild Turkey,23-5,4,16,0,20,20.000,20.000
17,0.980,Clark Grebe,16-23,0,0,0,0,NaN,NaN
17,0.980,Clark Grebe,23-5,0,0,0,0,NaN,NaN
17,0.980,Seagull,16-23,0,0,0,0,NaN,NaN
17,0.980,Seagull,23-5,46,7,0,53,86.792,86.792
17,0.980,Surf Scoter,16-23,0,0,0,0,NaN,NaN
17,0.980,Surf Scoter,23-5,2,0,0,2,100.000,100.000
17,0.980,Pigeon,16-23,54,123,0,177,30.508,30.508
17,0.980,Pigeon,23-5,103,147,0,250,41.200,41.200
17,0.980,Pacific Ocean Water,16-23,0,0,0,0,NaN,NaN
17,0.980,Pacific Ocean Water,23-5,0,0,0,0,NaN,NaN
17,0.980,Cat,16-23,7,14,0,21,33.333,33.333
17,0.980,Cat,23-5,12,17,0,29,41.379,41.379
17,0.980,Horse,16-23,3,8,0,11,27.273,27.273
17,0.980,Horse,23-5,11,35,0,46,23.913,23.913
17,0.980,orangutan,16-23,0,0,0,0,NaN,NaN
17,0.980,orangutan,23-5,0,0,0,0,NaN,NaN
17,0.980,Bat,16-23,36,37,0,73,49.315,49.315
17,0.980,Bat,23-5,37,40,0,77,48.052,48.052
17,0.980,Deer,16-23,10,23,0,33,30.303,30.303
17,0.980,Deer,23-5,12,124,0,136,8.824,8.824
17,0.980,Great Horned Owl,16-23,0,0,0,0,NaN,NaN
17,0.980,Great Horned Owl,23-5,0,0,0,0,NaN,NaN
17,0.980,Freshwater Lagoon,16-23,0,0,0,0,NaN,NaN
17,0.980,Freshwater Lagoon,23-5,0,0,0,0,NaN,NaN
17,0.980,Unknown Avian,16-23,0,0,0,0,NaN,NaN
17,0.980,Unknown Avian,23-5,0,0,0,0,NaN,NaN
17,0.980,Human UTI,16-23,72,68,0,140,51.429,51.429
17,0.980,Human UTI,23-5,94,123,0,217,43.318,43.318
17,0.980,unknown,16-23,0,0,0,0,NaN,NaN
17,0.980,unknown,23-5,0,1,0,1,0.000,0.000
17,0.980,SLO Creek Water,16-23,0,0,0,0,NaN,NaN
17,0.980,SLO Creek Water,23-5,0,0,0,0,NaN,NaN
17,0.980,Pig/Swine,16-23,2,2,0,4,50.000,50.000
17,0.980,Pig/Swine,23-5,8,7,0,15,53.333,53.333
17,0.980,Klebsiella,16-23,0,0,0,0,NaN,NaN
17,0.980,Klebsiella,23-5,0,0,0,0,NaN,NaN
17,0.980,Hu Cw and Dg,16-23,2,7,0,9,22.222,22.222
17,0.980,Hu Cw and Dg,23-5,3,6,0,9,33.333,33.333
17,0.980,Ground Squirrel,16-23,77,42,0,119,64.706,64.706
17,0.980,Ground Squirrel,23-5,74,58,0,132,56.061,56.061
17,0.980,Opossum,16-23,0,0,0,0,NaN,NaN
17,0.980,Opossum,23-5,0,0,0,0,NaN,NaN
17,0.980,Cow,16-23,1555,1214,0,2769,56.157,56.157
17,0.980,Cow,23-5,1528,1564,0,3092,49.418,49.418
17,0.980,Deer Mouse,16-23,0,0,0,0,NaN,NaN
17,0.980,Deer Mouse,23-5,0,0,0,0,NaN,NaN
17,0.980,OVERALL,16-23,3713,2565,0,6278,59.143,59.143
17,0.980,OVERALL,23-5,4349,3173,0,7522,57.817,57.817
17,0.990,Chicken,16-23,2,5,0,7,28.571,28.571
17,0.990,Chicken,23-5,6,2,0,8,75.000,75.000
17,0.990,Sea Lion,16-23,0,0,0,0,NaN,NaN
17,0.990,Sea Lion,23-5,4,6,0,10,40.000,40.000
17,0.990,Hu and Cw,16-23,1,3,0,4,25.000,25.000
17,0.990,Hu and Cw,23-5,11,24,0,35,31.429,31.429
17,0.990,Sheep,16-23,47,47,0,94,50.000,50.000
17,0.990,Sheep,23-5,52,38,0,90,57.778,57.778
17,0.990,Hu and Dg,16-23,7,7,0,14,50.000,50.000
17,0.990,Hu and Dg,23-5,16,19,0,35,45.714,45.714
17,0.990,Common Loon,16-23,0,0,0,0,NaN,NaN
17,0.990,Common Loon,23-5,0,2,0,2,0.000,0.000
17,0.990,Red-Winged Blackbird,16-23,0,2,0,2,0.000,0.000
17,0.990,Red-Winged Blackbird,23-5,0,0,0,0,NaN,NaN
17,0.990,Cw,16-23,3,6,0,9,33.333,33.333
17,0.990,Cw,23-5,12,18,0,30,40.000,40.000
17,0.990,Cliff Sparrow,16-23,0,5,0,5,0.000,0.000
17,0.990,Cliff Sparrow,23-5,0,4,0,4,0.000,0.000
17,0.990,Pig,16-23,2,4,0,6,33.333,33.333
17,0.990,Pig,23-5,7,6,0,13,53.846,53.846
17,0.990,Barn Owl,16-23,0,0,0,0,NaN,NaN
17,0.990,Barn Owl,23-5,0,0,0,0,NaN,NaN
17,0.990,Wild Pig,16-23,0,1,0,1,0.000,0.000
17,0.990,Wild Pig,23-5,0,1,0,1,0.000,0.000
17,0.990,Pennington Creek Water,16-23,0,0,0,0,NaN,NaN
17,0.990,Pennington Creek Water,23-5,0,0,0,0,NaN,NaN
17,0.990,Guinni,16-23,0,0,0,0,NaN,NaN
17,0.990,Guinni,23-5,0,0,0,0,NaN,NaN
17,0.990,Racoon,16-23,0,0,0,0,NaN,NaN
17,0.990,Racoon,23-5,0,1,0,1,0.000,0.000
17,0.990,Hu,16-23,8,6,0,14,57.143,57.143
17,0.990,Hu,23-5,23,17,0,40,57.500,57.500
17,0.990,Cw and Dg,16-23,3,14,0,17,17.647,17.647
17,0.990,Cw and Dg,23-5,12,14,0,26,46.154,46.154
17,0.990,Red Wind Blackbird,16-23,0,0,0,0,NaN,NaN
17,0.990,Red Wind Blackbird,23-5,0,0,0,0,NaN,NaN
17,0.990,Tree Swallow,16-23,0,0,0,0,NaN,NaN
17,0.990,Tree Swallow,23-5,0,0,0,0,NaN,NaN
17,0.990,Turkey Vulture,16-23,0,0,0,0,NaN,NaN
17,0.990,Turkey Vulture,23-5,0,0,0,0,NaN,NaN
17,0.990,Dg,16-23,6,10,0,16,37.500,37.500
17,0.990,Dg,23-5,31,20,0,51,60.784,60.784
17,0.990,Western Kingbird,16-23,0,0,0,0,NaN,NaN
17,0.990,Western Kingbird,23-5,0,0,0,0,NaN,NaN
17,0.990,White Crowned Sparrow,16-23,0,0,0,0,NaN,NaN
17,0.990,White Crowned Sparrow,23-5,0,3,0,3,0.000,0.000
17,0.990,Eared Grebe,16-23,0,0,0,0,NaN,NaN
17,0.990,Eared Grebe,23-5,0,8,0,8,0.000,0.000
17,0.990,cougar,16-23,0,1,0,1,0.000,0.000
17,0.990,cougar,23-5,0,0,0,0,NaN,NaN
17,0.990,Ocean Water,16-23,0,0,0,0,NaN,NaN
17,0.990,Ocean Water,23-5,0,0,0,0,NaN,NaN
17,0.990,Red Tailed Hawk,16-23,0,0,0,0,NaN,NaN
17,0.990,Red Tailed Hawk,23-5,0,1,0,1,0.000,0.000
17,0.990,Dog,16-23,53,70,0,123,43.089,43.089
17,0.990,Dog,23-5,91,120,0,211,43.128,43.128
17,0.990,Human,16-23,1757,812,0,2569,68.392,68.392
17,0.990,Human,23-5,2172,656,0,2828,76.803,76.803
17,0.990,Wild Turkey,16-23,3,9,0,12,25.000,25.000
17,0.990,Wild Turkey,23-5,4,18,0,22,18.182,18.182
17,0.990,Clark Grebe,16-23,0,0,0,0,NaN,NaN
17,0.990,Clark Grebe,23-5,2,3,0,5,40.000,40.000
17,0.990,Seagull,16-23,0,0,0,0,NaN,NaN
17,0.990,Seagull,23-5,48,6,0,54,88.889,88.889
17,0.990,Surf Scoter,16-23,0,0,0,0,NaN,NaN
17,0.990,Surf Scoter,23-5,2,0,0,2,100.000,100.000
17,0.990,Pigeon,16-23,65,124,0,189,34.392,34.392
17,0.990,Pigeon,23-5,113,169,0,282,40.071,40.071
17,0.990,Pacific Ocean Water,16-23,0,0,0,0,NaN,NaN
17,0.990,Pacific Ocean Water,23-5,0,0,0,0,NaN,NaN
17,0.990,Cat,16-23,18,17,0,35,51.429,51.429
17,0.990,Cat,23-5,13,22,0,35,37.143,37.143
17,0.990,Horse,16-23,6,9,0,15,40.000,40.000
17,0.990,Horse,23-5,13,57,0,70,18.571,18.571
17,0.990,orangutan,16-23,0,0,0,0,NaN,NaN
17,0.990,orangutan,23-5,0,0,0,0,NaN,NaN
17,0.990,Bat,16-23,36,34,0,70,51.429,51.429
17,0.990,Bat,23-5,37,39,0,76,48.684,48.684
17,0.990,Deer,16-23,10,24,0,34,29.412,29.412
17,0.990,Deer,23-5,12,112,0,124,9.677,9.677
17,0.990,Great Horned Owl,16-23,0,0,0,0,NaN,NaN
17,0.990,Great Horned Owl,23-5,0,0,0,0,NaN,NaN
17,0.990,Freshwater Lagoon,16-23,0,0,0,0,NaN,NaN
17,0.990,Freshwater Lagoon,23-5,0,0,0,0,NaN,NaN
17,0.990,Unknown Avian,16-23,0,0,0,0,NaN,NaN
17,0.990,Unknown Avian,23-5,0,0,0,0,NaN,NaN
17,0.990,Human UTI,16-23,75,56,0,131,57.252,57.252
17,0.990,Human UTI,23-5,95,97,0,192,49.479,49.479
17,0.990,unknown,16-23,0,0,0,0,NaN,NaN
17,0.990,unknown,23-5,0,3,0,3,0.000,0.000
17,0.990,SLO Creek Water,16-23,0,0,0,0,NaN,NaN
17,0.990,SLO Creek Water,23-5,0,0,0,0,NaN,NaN
17,0.990,Pig/Swine,16-23,3,3,0,6,50.000,50.000
17,0.990,Pig/Swine,23-5,8,7,0,15,53.333,53.333
17,0.990,Klebsiella,16-23,0,0,0,0,NaN,NaN
17,0.990,Klebsiella,23-5,0,0,0,0,NaN,NaN
17,0.990,Hu Cw and Dg,16-23,2,7,0,9,22.222,22.222
17,0.990,Hu Cw and Dg,23-5,3,8,0,11,27.273,27.273
17,0.990,Ground Squirrel,16-23,80,43,0,123,65.041,65.041
17,0.990,Ground Squirrel,23-5,77,62,0,139,55.396,55.396
17,0.990,Opossum,16-23,1,0,0,1,100.000,100.000
17,0.990,Opossum,23-5,2,0,0,2,100.000,100.000
17,0.990,Cow,16-23,1523,1095,0,2618,58.174,58.174
17,0.990,Cow,23-5,1489,1408,0,2897,51.398,51.398
17,0.990,Deer Mouse,16-23,0,0,0,0,NaN,NaN
17,0.990,Deer Mouse,23-5,0,0,0,0,NaN,NaN
17,0.990,OVERALL,16-23,3711,2414,0,6125,60.588,60.588
17,0.990,OVERALL,23-5,4355,2971,0,7326,59.446,59.446
17,1.000,Chicken,16-23,0,0,0,0,NaN,NaN
17,1.000,Chicken,23-5,0,0,0,0,NaN,NaN
17,1.000,Sea Lion,16-23,0,0,0,0,NaN,NaN
17,1.000,Sea Lion,23-5,0,0,0,0,NaN,NaN
17,1.000,Hu and Cw,16-23,0,0,0,0,NaN,NaN
17,1.000,Hu and Cw,23-5,0,0,0,0,NaN,NaN
17,1.000,Sheep,16-23,0,0,0,0,NaN,NaN
17,1.000,Sheep,23-5,0,0,0,0,NaN,NaN
17,1.000,Hu and Dg,16-23,0,0,0,0,NaN,NaN
17,1.000,Hu and Dg,23-5,0,0,0,0,NaN,NaN
17,1.000,Common Loon,16-23,0,0,0,0,NaN,NaN
17,1.000,Common Loon,23-5,0,0,0,0,NaN,NaN
17,1.000,Red-Winged Blackbird,16-23,0,0,0,0,NaN,NaN
17,1.000,Red-Winged Blackbird,23-5,0,0,0,0,NaN,NaN
17,1.000,Cw,16-23,0,0,0,0,NaN,NaN
17,1.000,Cw,23-5,0,0,0,0,NaN,NaN
17,1.000,Cliff Sparrow,16-23,0,0,0,0,NaN,NaN
17,1.000,Cliff Sparrow,23-5,0,0,0,0,NaN,NaN
17,1.000,Pig,16-23,0,0,0,0,NaN,NaN
17,1.000,Pig,23-5,0,0,0,0,NaN,NaN
17,1.000,Barn Owl,16-23,0,0,0,0,NaN,NaN
17,1.000,Barn Owl,23-5,0,0,0,0,NaN,NaN
17,1.000,Wild Pig,16-23,0,0,0,0,NaN,NaN
17,1.000,Wild Pig,23-5,0,0,0,0,NaN,NaN
17,1.000,Pennington Creek Water,16-23,0,0,0,0,NaN,NaN
17,1.000,Pennington Creek Water,23-5,0,0,0,0,NaN,NaN
17,1.000,Guinni,16-23,0,0,0,0,NaN,NaN
17,1.000,Guinni,23-5,0,0,0,0,NaN,NaN
17,1.000,Racoon,16-23,0,0,0,0,NaN,NaN
17,1.000,Racoon,23-5,0,0,0,0,NaN,NaN
17,1.000,Hu,16-23,0,0,0,0,NaN,NaN
17,1.000,Hu,23-5,0,0,0,0,NaN,NaN
17,1.000,Cw and Dg,16-23,0,0,0,0,NaN,NaN
17,1.000,Cw and Dg,23-5,0,0,0,0,NaN,NaN
17,1.000,Red Wind Blackbird,16-23,0,0,0,0,NaN,NaN
17,1.000,Red Wind Blackbird,23-5,0,0,0,0,NaN,NaN
17,1.000,Tree Swallow,16-23,0,0,0,0,NaN,NaN
17,1.000,Tree Swallow,23-5,0,0,0,0,NaN,NaN
17,1.000,Turkey Vulture,16-23,0,0,0,0,NaN,NaN
17,1.000,Turkey Vulture,23-5,0,0,0,0,NaN,NaN
17,1.000,Dg,16-23,0,0,0,0,NaN,NaN
17,1.000,Dg,23-5,0,0,0,0,NaN,NaN
17,1.000,Western Kingbird,16-23,0,0,0,0,NaN,NaN
17,1.000,Western Kingbird,23-5,0,0,0,0,NaN,NaN
17,1.000,White Crowned Sparrow,16-23,0,0,0,0,NaN,NaN
17,1.000,White Crowned Sparrow,23-5,0,0,0,0,NaN,NaN
17,1.000,Eared Grebe,16-23,0,0,0,0,NaN,NaN
17,1.000,Eared Grebe,23-5,0,0,0,0,NaN,NaN
17,1.000,cougar,16-23,0,0,0,0,NaN,NaN
17,1.000,cougar,23-5,0,0,0,0,NaN,NaN
17,1.000,Ocean Water,16-23,0,0,0,0,NaN,NaN
17,1.000,Ocean Water,23-5,0,0,0,0,NaN,NaN
17,1.000,Red Tailed Hawk,16-23,0,0,0,0,NaN,NaN
17,1.000,Red Tailed Hawk,23-5,0,0,0,0,NaN,NaN
17,1.000,Dog,16-23,0,0,0,0,NaN,NaN
17,1.000,Dog,23-5,0,0,0,0,NaN,NaN
17,1.000,Human,16-23,68,0,0,68,100.000,100.000
17,1.000,Human,23-5,90,0,0,90,100.000,100.000
17,1.000,Wild Turkey,16-23,0,0,0,0,NaN,NaN
17,1.000,Wild Turkey,23-5,0,0,0,0,NaN,NaN
17,1.000,Clark Grebe,16-23,0,0,0,0,NaN,NaN
17,1.000,Clark Grebe,23-5,0,0,0,0,NaN,NaN
17,1.000,Seagull,16-23,0,0,0,0,NaN,NaN
17,1.000,Seagull,23-5,0,0,0,0,NaN,NaN
17,1.000,Surf Scoter,16-23,0,0,0,0,NaN,NaN
17,1.000,Surf Scoter,23-5,0,0,0,0,NaN,NaN
17,1.000,Pigeon,16-23,0,0,0,0,NaN,NaN
17,1.000,Pigeon,23-5,0,0,0,0,NaN,NaN
17,1.000,Pacific Ocean Water,16-23,0,0,0,0,NaN,NaN
17,1.000,Pacific Ocean Water,23-5,0,0,0,0,NaN,NaN
17,1.000,Cat,16-23,0,0,0,0,NaN,NaN
17,1.000,Cat,23-5,0,0,0,0,NaN,NaN
17,1.000,Horse,16-23,0,0,0,0,NaN,NaN
17,1.000,Horse,23-5,0,0,0,0,NaN,NaN
17,1.000,orangutan,16-23,0,0,0,0,NaN,NaN
17,1.000,orangutan,23-5,0,0,0,0,NaN,NaN
17,1.000,Bat,16-23,0,0,0,0,NaN,NaN
17,1.000,Bat,23-5,0,0,0,0,NaN,NaN
17,1.000,Deer,16-23,0,0,0,0,NaN,NaN
17,1.000,Deer,23-5,0,0,0,0,NaN,NaN
17,1.000,Great Horned Owl,16-23,0,0,0,0,NaN,NaN
17,1.000,Great Horned Owl,23-5,0,0,0,0,NaN,NaN
17,1.000,Freshwater Lagoon,16-23,0,0,0,0,NaN,NaN
17,1.000,Freshwater Lagoon,23-5,0,0,0,0,NaN,NaN
17,1.000,Unknown Avian,16-23,0,0,0,0,NaN,NaN
17,1.000,Unknown Avian,23-5,0,0,0,0,NaN,NaN
17,1.000,Human UTI,16-23,0,0,0,0,NaN,NaN
17,1.000,Human UTI,23-5,0,0,0,0,NaN,NaN
17,1.000,unknown,16-23,0,0,0,0,NaN,NaN
17,1.000,unknown,23-5,0,0,0,0,NaN,NaN
17,1.000,SLO Creek Water,16-23,0,0,0,0,NaN,NaN
17,1.000,SLO Creek Water,23-5,0,0,0,0,NaN,NaN
17,1.000,Pig/Swine,16-23,0,0,0,0,NaN,NaN
17,1.000,Pig/Swine,23-5,0,0,0,0,NaN,NaN
17,1.000,Klebsiella,16-23,0,0,0,0,NaN,NaN
17,1.000,Klebsiella,23-5,0,0,0,0,NaN,NaN
17,1.000,Hu Cw and Dg,16-23,0,0,0,0,NaN,NaN
17,1.000,Hu Cw and Dg,23-5,0,0,0,0,NaN,NaN
17,1.000,Ground Squirrel,16-23,0,0,0,0,NaN,NaN
17,1.000,Ground Squirrel,23-5,0,0,0,0,NaN,NaN
17,1.000,Opossum,16-23,0,0,0,0,NaN,NaN
17,1.000,Opossum,23-5,0,0,0,0,NaN,NaN
17,1.000,Cow,16-23,0,0,0,0,NaN,NaN
17,1.000,Cow,23-5,0,0,0,0,NaN,NaN
17,1.000,Deer Mouse,16-23,0,0,0,0,NaN,NaN
17,1.000,Deer Mouse,23-5,0,0,0,0,NaN,NaN
17,1.000,OVERALL,16-23,68,0,0,68,100.000,100.000
17,1.000,OVERALL,23-5,90,0,0,90,100.000,100.000
